"year","state","district","democrat_votes","republican_votes","totalvotes","democrat_candidate","republican_candidate","winner","winner_percentage","excess_dem_votes","total_demrep_votes","dem_margin"
1976,"ALABAMA",1,58906,98257,157170,"BILL DAVENPORT","JACK EDWARDS","Republican",0.625163835337533,-39351,157163,-0.250383359951134
1976,"ALABAMA",2,66288,90069,156362,"J CAROLE KEAHEY","WILLIAM L ""BILL"" DICKINSON","Republican",0.576028702625958,-23781,156357,-0.152094245860435
1976,"ALABAMA",4,141490,34531,176022,"TOM BEVILL","LEONARD WILSON","Democrat",0.803819977048324,106959,176021,0.607649087324808
1976,"ALABAMA",6,69384,92113,162518,"MEL BAILEY","JOHN H BUCHANAN JR","Republican",0.566786448270345,-22729,161497,-0.140739456460492
1976,"ALASKA",0,34194,83722,118208,"EBEN HOPSON","DON YOUNG","Republican",0.708260016242556,-49528,117916,-0.420027816411683
1976,"ARIZONA",1,68404,96397,168119,"PATRICIA M FULLINWIDER","JOHN J RHODES","Republican",0.573385518590998,-27993,164801,-0.169859406192924
1976,"ARIZONA",2,106054,71765,182128,"MORRIS K UDALL","LAIRD GUTTERSEN","Democrat",0.582304752701397,34289,177819,0.192830912332203
1976,"ARIZONA",3,88854,79162,187165,"BOB STUMP","FRED KOORY JR","Democrat",0.474736195335666,9692,168016,0.0576849823826302
1976,"ARIZONA",4,92435,93154,191590,"TONY MASON","ELDON RUDD","Republican",0.4862153557075,-719,185589,-0.00387415202409626
1976,"ARKANSAS",1,116217,52565,168782,"BILL ALEXANDER","HARLAN ""BO"" HOLLEMAN","Democrat",0.688562761431906,63652,168782,0.377125522863813
1976,"ARKANSAS",2,144780,22819,167607,"JIM GUY TUCKER","JAMES J KELLY","Democrat",0.863806404267125,121961,167599,0.727695272644825
1976,"CALIFORNIA",1,160477,56539,217016,"HAROLD T ""BIZZ"" JOHNSON","JAMES E TAYLOR","Democrat",0.739470822427839,103938,217016,0.478941644855679
1976,"CALIFORNIA",2,88829,121290,216563,"OSCAR KLEE","DON H CLAUSEN","Republican",0.56006797098304,-32461,210119,-0.154488646909608
1976,"CALIFORNIA",3,139779,52075,191854,"JOHN E MOSS","GEORGE R MARSH JR","Democrat",0.728569641498223,87704,191854,0.457139282996445
1976,"CALIFORNIA",4,75844,75193,151037,"ROBERT L LEGGETT","ALBERT DEHR","Democrat",0.50215510106795,651,151037,0.00431020213590047
1976,"CALIFORNIA",5,103746,64008,167754,"JOHN L BURTON","BRANWELL FANNING","Democrat",0.618441289030366,39738,167754,0.236882578060732
1976,"CALIFORNIA",6,86493,35359,130916,"PHILLIP BURTON","TOM SPINOSA","Democrat",0.660675547679428,51134,121852,0.419640219282408
1976,"CALIFORNIA",7,147064,45863,196816,"GEORGE MILLER","ROBERT L VICKERS","Democrat",0.747215673522478,101201,192927,0.524555920114862
1976,"CALIFORNIA",8,122342,68374,196954,"RONALD V DELLUMS","PHILIP STILES BRECK JR","Democrat",0.621170425581608,53968,190716,0.282975733551459
1976,"CALIFORNIA",9,116398,44607,164391,"FORTNEY H ""PETE"" STARK","JAMES K MILLS","Democrat",0.708055793808663,71791,161005,0.445892984689916
1976,"CALIFORNIA",10,111992,38088,155443,"DON EDWARDS","HERB SMITH","Democrat",0.720469882850949,73904,150080,0.492430703624733
1976,"CALIFORNIA",11,107618,62435,176194,"LEO J RYAN","BOB JONES","Democrat",0.610792649011885,45183,170053,0.265699517209341
1976,"CALIFORNIA",12,61526,130332,196857,"DAVID HARRIS","PAUL N ""PETE"" MCCLOSKEY JR","Republican",0.662064341120712,-68806,191858,-0.35862981997102
1976,"CALIFORNIA",13,135291,63130,202611,"NORMAN Y MINETA","ERNEST L KONNYU","Democrat",0.667737684528481,72161,198421,0.363676223786797
1976,"CALIFORNIA",14,123285,46674,169959,"JOHN J MCFALL","ROGER A BLAIN","Democrat",0.725380827140663,76611,169959,0.450761654281327
1976,"CALIFORNIA",15,92735,35700,128435,"B F SISK","CAROL HARNER","Democrat",0.722038385175381,57035,128435,0.444076770350761
1976,"CALIFORNIA",16,104545,91160,195705,"LEON E PANETTA","BURT TALCOTT","Democrat",0.534196877954064,13385,195705,0.068393755908127
1976,"CALIFORNIA",17,103898,54270,158168,"JOHN KREBS","HENRY J ANDREAS","Democrat",0.656883819735977,49628,158168,0.313767639471954
1976,"CALIFORNIA",18,56683,101658,158341,"DEAN CLOSE","WILLIAM M KETCHUM","Republican",0.64201943905874,-44975,158341,-0.284038878117481
1976,"CALIFORNIA",19,68722,124201,192923,"DAN SISSON","ROBERT J LAGOMARSINO","Republican",0.643785344412019,-55479,192923,-0.287570688824039
1976,"CALIFORNIA",20,71193,146158,217351,"PATTI LEAR CORMAN","BARRY GOLDWATER JR","Republican",0.672451472503002,-74965,217351,-0.344902945006004
1976,"CALIFORNIA",21,101837,44094,153109,"JAMES C CORMAN","ERWIN ""ED"" HOGAN","Democrat",0.665127458216042,57743,145931,0.395687002761579
1976,"CALIFORNIA",22,68543,114769,183312,"ROBERT L SALLEY","CARLOS J MOORHEAD","Republican",0.626085580867592,-46226,183312,-0.252171161735184
1976,"CALIFORNIA",23,130619,86434,217053,"ANTHONY C BEILENSON","THOMAS F BARTMAN","Democrat",0.601783896099109,44185,217053,0.203567792198219
1976,"CALIFORNIA",24,108296,51478,159774,"HENY A WAXMAN","DAVID IRVING SIMMONS","Democrat",0.677807402956676,56818,159774,0.355614805913353
1976,"CALIFORNIA",25,57966,17737,80625,"EDWARD R ROYBAL","JIM MADRID","Democrat",0.718958139534884,40229,75703,0.53140562461197
1976,"CALIFORNIA",26,59093,112619,171712,"BRUCE LATTA","JOHN H ROUSSELOT","Republican",0.655859811777861,-53526,171712,-0.311719623555721
1976,"CALIFORNIA",27,94988,114623,209611,"GARY FAMILIAN","ROBERT K DORNAN","Republican",0.546836759521208,-19635,209611,-0.0936735190424167
1976,"CALIFORNIA",28,114612,28303,142915,"YVONNE BRATHWAITE BURKE","EDWARD S SKINNER","Democrat",0.801959206521359,86309,142915,0.603918413042718
1976,"CALIFORNIA",29,82515,10852,96602,"AUGUSTUS F ""GUS"" HAWKINS","MICHAEL D GERMONPREZ","Democrat",0.854174861804103,71663,93367,0.767540994141399
1976,"CALIFORNIA",30,82767,28503,111270,"GEORG E DANIELSON","HARRY COUCH","Democrat",0.743839309787005,54264,111270,0.487678619574009
1976,"CALIFORNIA",32,92034,35394,127428,"GLENN M ANDERSON","CLIFFORD O YOUNG","Democrat",0.722243149072417,56640,127428,0.444486298144835
1976,"CALIFORNIA",33,77807,95398,173205,"TED SNYDER","DEL CLAWSON","Republican",0.550780866603158,-17591,173205,-0.101561733206316
1976,"CALIFORNIA",34,100988,98147,199135,"MARK W HANNAFORD","DANIEL E LUNGREN","Democrat",0.507133351746303,2841,199135,0.0142667034926055
1976,"CALIFORNIA",35,87472,76765,164237,"JIM LLOYD","LOUIS BRUTOCAO","Democrat",0.532596187217253,10707,164237,0.0651923744345062
1976,"CALIFORNIA",36,90830,49368,147556,"GEORGE E BROWN JR","GRANT CARNER","Democrat",0.615562904931009,41462,140198,0.295738883578938
1976,"CALIFORNIA",37,49021,133634,188007,"DOUGLAS C NILSON JR","SHIRLEY N PETTIS","Republican",0.710792683251156,-84613,182655,-0.463239440475213
1976,"CALIFORNIA",38,103317,59092,162409,"JERRY PATTERSON","JAMES ""JIM"" COMBS","Democrat",0.63615316885148,44225,162409,0.27230633770296
1976,"CALIFORNIA",39,86745,122657,209402,"WILLIAM E ""BILL"" FARRIS","CHARLES E WIGGINS","Republican",0.585748942225958,-35912,209402,-0.171497884451915
1976,"CALIFORNIA",40,102132,148512,250644,"VIVIAN HALL","ROBERT E BADHAM","Republican",0.592521664193039,-46380,250644,-0.185043328386077
1976,"CALIFORNIA",41,94590,128784,223374,"KING GOLDEN JR","BOB C WILSON","Republican",0.576539794246421,-34194,223374,-0.153079588492842
1976,"CALIFORNIA",42,103062,32565,135627,"LIONEL VAN DEERLIN","WES MARDEN","Democrat",0.759892941670906,70497,135627,0.519785883341812
1976,"CALIFORNIA",43,93475,173576,267051,"PAT KELLY","CLAIR W BURGENER","Republican",0.649973226087901,-80101,267051,-0.299946452175802
1976,"COLORADO",1,103037,89384,193610,"PATRICIA SCHROEDER","DON FRIEDMAN","Democrat",0.532188420019627,13653,192421,0.0709537940245607
1976,"COLORADO",2,121340,118938,240278,"TIMOTHY E WIRTH","ED SCOTT","Democrat",0.504998376880114,2402,240278,0.00999675376022774
1976,"COLORADO",3,89302,82315,175232,"FRANK E EVANS","MELVIN H TAKAKI","Democrat",0.509621530314098,6987,171617,0.0407127499023989
1976,"COLORADO",4,76995,119458,221018,"DANIEL M OGDEN JR","JAMES P ""JIM"" JOHNSON","Republican",0.540489914848564,-42463,196453,-0.216148391727283
1976,"COLORADO",5,64067,126784,190851,"DOROTHY HORES","WILLIAM L ARMSTRONG","Republican",0.664308806346312,-62717,190851,-0.328617612692624
1976,"CONNECTICUT",1,128479,94106,225076,"WILLIAM R COTTER","LUCIEN P DI FAZIO JR","Democrat",0.570824965789333,34373,222585,0.15442639890379
1976,"CONNECTICUT",2,142684,74743,219308,"CHRISTOPHER J DODD","RICHARD M JACKSON","Democrat",0.650610100862714,67941,217427,0.31247729122878
1976,"CONNECTICUT",3,121623,96714,222643,"ROBERT N GIAIMO","JOHN G PUCCIANO","Democrat",0.546269139384575,24909,218337,0.114085106967669
1976,"CONNECTICUT",4,76722,126314,207058,"GEOFFREY G PETERSON","STEWART B MCKINNEY","Republican",0.610041630847395,-49592,203036,-0.244252250832365
1976,"CONNECTICUT",5,77308,157009,236087,"MICHAEL J ADANTI","RONALD A SARASIN","Republican",0.665047207173627,-79701,234317,-0.340141773750944
1976,"CONNECTICUT",6,134914,102364,238300,"ANTHONY TOBY MOFFETT","THOMAS F UPSON","Democrat",0.566151909357952,32550,237278,0.137180859582431
1976,"DELAWARE",0,102411,110636,215085,"SAMUEL L SHIPLEY","THOMAS B EVANS JR","Republican",0.514382685914871,-8225,213047,-0.0386065046679841
1976,"FLORIDA",5,96260,138371,234631,"JO ANN SAUNDERS","RICHARD KELLY","Republican",0.589738781320456,-42111,234631,-0.179477562640913
1976,"FLORIDA",6,80821,151371,232218,"GABRIEL CAZARES","C W BILL YOUNG","Republican",0.651848693899698,-70550,232192,-0.303843371003308
1976,"FLORIDA",7,102739,53599,156338,"SAM GIBBONS","DUSTY OWENS","Democrat",0.657159487776484,49140,156338,0.314318975552969
1976,"FLORIDA",8,103360,74794,178154,"ANDY IRELAND","BOB JOHNSON","Democrat",0.580172210559404,28566,178154,0.160344421118807
1976,"FLORIDA",9,36630,130509,167139,"JOSEPH A ROSIER","LOUIS FREY JR","Republican",0.780841096332992,-93879,167139,-0.561682192665985
1976,"FLORIDA",10,83413,164273,247686,"BILL SIKES","L A ""SKIP"" BAFALIS","Republican",0.663230864885379,-80860,247686,-0.326461729770758
1976,"FLORIDA",12,91749,107268,199076,"CHARLIE FRIEDMAN","J HERBERT BURKE","Republican",0.53882939179007,-15519,199017,-0.0779782631634483
1976,"FLORIDA",13,127822,35357,163179,"WILLIAM LEHMAN","LEE ARNOLD SPIEGELMAN","Democrat",0.783323834562045,92465,163179,0.566647669124091
1976,"FLORIDA",14,82665,30774,113439,"CLAUDE PEPPER","EVELIO S ESTRELLA","Democrat",0.72871763679158,51891,113439,0.457435273583159
1976,"FLORIDA",15,121292,50941,172233,"DANTE B FASCELL","PAUL R COBB","Democrat",0.704232057735742,70351,172233,0.408464115471483
1976,"GEORGIA",3,93174,11829,105004,"JACK BRINKLEY","STEVEN DUGAN","Democrat",0.887337625233324,81345,105003,0.77469215165281
1976,"GEORGIA",4,110261,51140,161412,"ELLIOTT H LEVITAS","GEORGE T WARREN II","Democrat",0.683102867196987,59121,161401,0.366298845732059
1976,"GEORGIA",5,96056,47998,144063,"ANDREW YOUNG","EDWARD W GADRIX","Democrat",0.666763846372767,48058,144054,0.333611006983492
1976,"GEORGIA",6,77532,72400,149944,"JOHN J FLYNT JR","NEWT GINGRICH","Democrat",0.517073040601825,5132,149932,0.0342288504121869
1976,"GEORGIA",7,84587,68947,153554,"LARRY P MCDONALD","QUINCY COLLINS","Democrat",0.550861586152103,15640,153534,0.101866687508956
1976,"GEORGIA",8,90559,39623,130186,"BILL LEE EVANS","BILLY ADAMS","Democrat",0.695612431444241,50936,130182,0.391267609961439
1976,"GEORGIA",9,113245,29954,143357,"ED JENKINS","LOUISE WOFFORD","Democrat",0.789950961585413,83291,143199,0.581645123220134
1976,"HAWAII",1,60050,53745,137602,"CECIL L HEFTEL","FREDERICK ROHLFING","Democrat",0.436403540646212,6305,113795,0.0554066523133705
1976,"HAWAII",2,124116,23917,156099,"DANIEL K AKAKA","HANK INOUYE","Democrat",0.795110795072358,100199,148033,0.676869346699722
1976,"IDAHO",1,79662,95833,175495,"KEN PURSLEY","STEVEN D SYMMS","Republican",0.546072537679136,-16171,175495,-0.0921450753582723
1976,"IDAHO",2,82237,84175,166412,"STAN KRESS","GEORGE HANSEN","Republican",0.505822897387208,-1938,166412,-0.0116457947744153
1976,"ILLINOIS",1,126632,10147,137193,"RALPH H METCALFE","A A RAYNER JR","Democrat",0.92302085383365,116485,136779,0.851629270575161
1976,"ILLINOIS",2,127297,23037,150335,"MORGAN F MURPHY","SPENCER LEAK","Democrat",0.846755579206439,104260,150334,0.693522423403887
1976,"ILLINOIS",3,115591,79434,196365,"MARTIN A RUSSO","RONALD BUIKEMA","Democrat",0.588653782496881,36157,195025,0.185396744007179
1976,"ILLINOIS",4,64924,124847,189772,"RONALD A RODGER","EDWARD DERWINSKI","Republican",0.657878928398288,-59923,189771,-0.315764790194498
1976,"ILLINOIS",5,119336,35756,155092,"JOHN G FARY","VINCENT KROK","Democrat",0.769452969850153,83580,155092,0.538905939700307
1976,"ILLINOIS",6,69359,106667,176027,"MARILYN D CLANCY","HENRYJ HYDE","Republican",0.60596953876394,-37308,176026,-0.211945962528263
1976,"ILLINOIS",7,88239,15854,104094,"CARDISS COLLINS","NEWELL WARD","Democrat",0.847685745576114,72385,104093,0.695387778236769
1976,"ILLINOIS",8,105595,25512,131107,"DANIEL D ROSTENKOWSKI","JOHN F URBASZEWSKI","Democrat",0.805410847628273,80083,131107,0.610821695256546
1976,"ILLINOIS",9,121915,47054,168983,"SIDNEY R YATES","THOMAS J WAJERSKI","Democrat",0.7214631057562,74861,168969,0.443045765791358
1976,"ILLINOIS",10,106804,106603,213414,"ABNER J MIKVA","SAMUEL H YOUNG","Democrat",0.500454515636275,201,213407,0.000941862263187243
1976,"ILLINOIS",11,135755,65680,201440,"FRANK ANNUNZIO","DANIEL C REBER","Democrat",0.673922756155679,70075,201435,0.347878968401718
1976,"ILLINOIS",12,56644,151899,208553,"EDWIN L FRANK","PHILIP M CRANE","Republican",0.728347230679971,-95255,208543,-0.456764312396005
1976,"ILLINOIS",13,49777,109726,164266,"JAMES J CUMMINGS","ROBERT MCCLORY","Republican",0.667977548610181,-59949,159503,-0.375848730117929
1976,"ILLINOIS",14,60505,176076,236588,"MARIE AGNES FESE","JOHN ERLENBORN","Republican",0.744230476609126,-115571,236581,-0.488504994061231
1976,"ILLINOIS",15,87676,102555,190231,"TIM L HALL","TOM CORCORAN","Republican",0.539107716407946,-14879,190231,-0.0782154328158923
1976,"ILLINOIS",16,54002,114324,168328,"STEPHEN EYTALIS","JOHN B ANDERSON","Republican",0.679173993631481,-60322,168326,-0.358364126754037
1976,"ILLINOIS",17,81220,113145,194365,"MERLIN KARLOCK","GEORGE M O'BRIEN","Republican",0.582126411648188,-31925,194365,-0.164252823296375
1976,"ILLINOIS",18,79102,108028,187130,"MATTHEW RYAN","ROBERT H MICHEL","Republican",0.577288516004916,-28926,187130,-0.154577032009833
1976,"ILLINOIS",19,60967,132571,193539,"JOHN CRAVER","TOM RAILSBACK","Republican",0.684983388361002,-71604,193538,-0.369973855263566
1976,"ILLINOIS",20,78634,137223,215857,"PETER MACK","PAUL FINDLEY","Republican",0.635712531907698,-58589,215857,-0.271425063815396
1976,"ILLINOIS",21,46996,137037,184035,"ANNA WALL SCOTT","EDWARD R MADIGAN","Republican",0.74462466378678,-90041,184033,-0.489265512163579
1976,"ILLINOIS",22,129187,81102,210289,"GEORGE E SHIPLEY","RALPH Y MCGINNIS","Democrat",0.614330754342833,48085,210289,0.228661508685666
1976,"ILLINOIS",23,128113,34825,162938,"MELVIN PRICE","SAM P DRENOVAC","Democrat",0.78626839656802,93288,162938,0.572536793136039
1976,"ILLINOIS",24,152344,73766,226110,"PAUL SIMON","PETER G PRINEAS","Democrat",0.673760559019946,78578,226110,0.347521118039892
1976,"INDIANA",1,121155,48756,169911,"ADAM BENJAMIN JR","ROBERT J BILLINGS","Democrat",0.713049773116514,72399,169911,0.426099546233028
1976,"INDIANA",2,117617,95605,214845,"FLOYD J FITHIAN","WILLIAM W ERWIN","Democrat",0.5474504875608,22012,213222,0.103235125831293
1976,"INDIANA",3,101777,77094,178871,"JOHN BRADEMAS","THOMAS L THORSON","Democrat",0.568996651217917,24683,178871,0.137993302435834
1976,"INDIANA",4,88361,107762,198183,"J EDWARD ROUSH","J DANFORTH QUAYLE","Republican",0.543749968463491,-19401,196123,-0.0989226148896356
1976,"INDIANA",5,78807,127194,206001,"WILLIAM C STOUT","ELWOOD HILLIS","Republican",0.617443604642696,-48387,206001,-0.234887209285392
1976,"INDIANA",6,105773,86854,192627,"DAVID W EVANS","DAVID G CRANE","Democrat",0.549107861307086,18919,192627,0.0982157226141714
1976,"INDIANA",7,77355,130005,207360,"JOHN E TIPTON","JOHN T MYERS","Republican",0.626953125,-52650,207360,-0.25390625
1976,"INDIANA",8,109013,107013,216026,"DAVID L CORNWELL","BELDEN BELL","Democrat",0.504629072426467,2000,216026,0.00925814485293437
1976,"INDIANA",10,114559,76890,191449,"PHILIP R SHARP","WILLIAM G FRAZIER","Democrat",0.598378680484098,37669,191449,0.196757360968195
1976,"INDIANA",11,115895,74829,191859,"ANDREW JACOBS JR","LAWRENCE L BUELL","Democrat",0.604063400726575,41066,190724,0.215316373398209
1976,"IOWA",1,101024,109694,211204,"EDWARD MEZVINSKY","JAMES A S LEACH","Republican",0.519374633056192,-8670,210718,-0.0411450374434078
1976,"IOWA",2,102980,100344,204550,"MICHAEL T BLOUIN","TOM RILEY","Democrat",0.503446590075776,2636,203324,0.0129645295193878
1976,"IOWA",3,90981,117957,208938,"STEPHEN J RAPP","CHARLES E GRASSLEY","Republican",0.564555035465066,-26976,208938,-0.129110070930132
1976,"IOWA",4,145343,65013,210356,"NEAL SMITH","CHARLES E MINOR","Democrat",0.690938219019187,80330,210356,0.381876438038373
1976,"IOWA",5,135600,71377,209052,"TOM HARKIN","KENNETH R FULK","Democrat",0.648642443028529,64223,206977,0.310290515371273
1976,"IOWA",6,133507,62292,198002,"BERKLEY BEDELL","JOANNE D SOPER","Democrat",0.67427096695993,71215,195799,0.363714830004239
1976,"KANSAS",1,52459,142311,194772,"RANDY YOWELL","KEITH G SEBELIUS","Republican",0.730654303493315,-89852,194770,-0.461323612465986
1976,"KANSAS",2,88645,82946,174861,"MARTHA KEYS","ROSS FREEMAN","Democrat",0.506945516724713,5699,171591,0.0332126976356569
1976,"KANSAS",3,52110,123578,179865,"PHILIP S RHOADS","LARRY WINN JR","Republican",0.687059739248881,-71468,175688,-0.406789308319293
1976,"KANSAS",4,90067,86832,179168,"DAN GLICKMAN","GARNER E SHRIVER","Democrat",0.502695793891766,3235,176899,0.0182872712677856
1976,"KANSAS",5,65340,109573,180625,"VIRGIL LEON OLSON","JOE SKUBITZ","Republican",0.606632525951557,-44233,174913,-0.252885720329535
1976,"KENTUCKY",1,118886,26089,144985,"CARROLL HUBBARD JR","BOB BERSKY","Democrat",0.819988274649102,92797,144975,0.640089670632868
1976,"KENTUCKY",2,79016,51900,130920,"WILLIAM H NATCHER","WALTER A BAKER","Democrat",0.603544149098686,27116,130916,0.207125179504415
1976,"KENTUCKY",3,80496,58019,140744,"ROMANO L MAZZOLI","DENZIL J RAMSEY","Democrat",0.571932018416416,22477,138515,0.162271234162365
1976,"KENTUCKY",4,77009,97493,174502,"EDWARD J WINTERBERG","GENE SNYDER","Republican",0.558692737045994,-20484,174502,-0.117385474091987
1976,"KENTUCKY",5,49128,100204,150473,"CHARLES C SMITH","TIM LEE CARTER","Republican",0.665926777561423,-51076,149332,-0.342029839552139
1976,"KENTUCKY",7,110450,40381,150831,"CARL D PERKINS","GRANVILLE THOMAS","Democrat",0.732276521404751,70069,150831,0.464553042809502
1976,"LOUISIANA",1,61652,56679,130558,"RICHARD A TONRY","ROBERT L LIVINGSTON","Democrat",0.472219243554589,4973,118331,0.0420261807979312
1976,"LOUISIANA",3,39728,109135,148863,"DAVID H ""PRO"" SCHEUERMANN JR","DAVID C TREEN","Republican",0.733123744651122,-69407,148863,-0.466247489302244
1976,"LOUISIANA",5,83696,75574,159270,"JERRY HUCKABY","FRANK SPOONER","Democrat",0.525497582721165,8122,159270,0.0509951654423306
1976,"LOUISIANA",6,53212,99780,152992,"J D DE BLIEUX","W HENSON MOORE","Republican",0.652190964233424,-46568,152992,-0.304381928466848
1976,"LOUISIANA",7,117196,23414,140610,"JOHN B BREAUX","CHARLES F ""CHUCK"" HUFF","Democrat",0.833482682597255,93782,140610,0.66696536519451
1976,"MAINE",1,108105,145523,253628,"FREDERICK D BARTON","DAVID F EMERY","Republican",0.573765514848518,-37418,253628,-0.147531029697037
1976,"MAINE",2,43150,169292,219547,"LEIGHTON COONEY","WILLIAM S COHEN","Republican",0.771096849421764,-126142,212442,-0.593771476450043
1976,"MARYLAND",1,72993,85919,158912,"ROY DYSON","ROBERT E BAUMAN","Republican",0.540670308095046,-12926,158912,-0.0813406161900926
1976,"MARYLAND",2,139196,35258,196303,"CLARENCE D LONG","JOHN M SENEY","Democrat",0.709087482106743,103938,174454,0.595790294289612
1976,"MARYLAND",3,107014,36447,143461,"BARBARA A MIKULSKI","SAMUEL A CULOTTA","Democrat",0.745944890945971,70567,143461,0.491889781891943
1976,"MARYLAND",4,69855,95158,165013,"WERNER FORNOS","MARJORIE S HOLT","Republican",0.576669716931393,-25303,165013,-0.153339433862787
1976,"MARYLAND",5,77836,57057,134893,"GLADYS NOON SPELLMAN","JOHN BURCHAM","Democrat",0.577020304982468,20779,134893,0.154040609964935
1976,"MARYLAND",6,126801,52203,179004,"GOODLOE E BYRON","ARTHUR T BOND","Democrat",0.708369645371053,74598,179004,0.416739290742106
1976,"MARYLAND",8,100343,111274,237652,"LANNY DAVIS","NEWTON I STEERS JR","Republican",0.468222442899702,-10931,211617,-0.0516546402226664
1976,"MASSACHUSETTS",1,78181,137652,215870,"EDWARD A MCCOLGAN","SILVIO O CONTE","Republican",0.63766155556585,-59471,215833,-0.275541738288399
1976,"MASSACHUSETTS",2,134408,41563,185755,"EDWARD P BOLAND","THOMAS P SWANK","Democrat",0.723576754326936,92845,175971,0.527615345710373
1976,"MASSACHUSETTS",4,109268,100562,209835,"ROBERT F DRINAN","ARTHUR D MASON","Democrat",0.520732956847046,8706,209830,0.0414907305914312
1976,"MASSACHUSETTS",5,144217,70036,214263,"PAUL E TSONGAS","ROGER P DURKIN","Democrat",0.673084013572105,74181,214253,0.346230857910974
1976,"MASSACHUSETTS",6,121562,91655,221813,"MICHAEL HARRINGTON","WILLIAM E BRONSON","Democrat",0.548038212368076,29907,213217,0.140265551058311
1976,"MASSACHUSETTS",7,162126,37063,210809,"EDWARD J MARKEY","RICHARD W DALY","Democrat",0.769065836847573,125063,199189,0.627860976258729
1976,"MASSACHUSETTS",8,133131,33437,178850,"THOMAS P O'NEIL JR","WILLIAM A BARNSTEAD","Democrat",0.744372379088622,99694,166568,0.598518322847125
1976,"MASSACHUSETTS",9,103901,34547,149371,"JOE MOAKLEY","ROBERT G CUNNINGHAM","Democrat",0.69559017479966,69354,138448,0.500938980700335
1976,"MICHIGAN",1,126161,8927,136582,"JOHN CONYERS JR","ISSAC HOOD","Democrat",0.923701512644419,117234,135088,0.867834300604051
1976,"MICHIGAN",2,95053,95397,191738,"EDWARD C PIERCE","CARL D PURSELL","Republican",0.497538307482085,-344,190450,-0.00180624835914938
1976,"MICHIGAN",3,95261,99231,196158,"HOWARD WOLPE","GARRY BROWN","Republican",0.505872816810938,-3970,194492,-0.0204121506283035
1976,"MICHIGAN",4,69655,107881,179737,"RICHARD E DAUGHERTY","DAVE STOCKMAN","Republican",0.600215870967024,-38226,177536,-0.215314077144917
1976,"MICHIGAN",5,94973,109589,205438,"RICHARD F VANDER VEEN","HAROLD S SAWYER","Republican",0.533440746113183,-14616,204562,-0.0714502204710552
1976,"MICHIGAN",6,108909,96008,206504,"BOB CARR","CLIFFORD W TAYLOR","Democrat",0.527394142486344,12901,204917,0.0629571973042744
1976,"MICHIGAN",7,124260,50301,177582,"DALE E KILDEE","ROBIN WIDGERY","Democrat",0.699733081055512,73959,174561,0.423685702992077
1976,"MICHIGAN",8,110127,75323,186632,"BOB TRAXLER","E BRADY DENTON","Democrat",0.590075656907711,34804,185450,0.187673227284982
1976,"MICHIGAN",9,61641,146712,209701,"STEPHEN E FAWLEY","GUY A VANDER JAGT","Republican",0.699624703744856,-85071,208353,-0.408302256267008
1976,"MICHIGAN",10,89980,118726,210184,"DONALD J ALBOSTA","ELFORD A CEDERBERG","Republican",0.564866973699235,-28746,208706,-0.137734420668309
1976,"MICHIGAN",11,97325,118871,217115,"FRANCIS BROUILLETTE","PHILIP E RUPPE","Republican",0.547502475646547,-21546,216196,-0.0996595681696239
1976,"MICHIGAN",12,94815,85326,180867,"DAVID E BONIOR","DAVID M SEROTKIN","Democrat",0.524224982998557,9489,180141,0.0526754042666578
1976,"MICHIGAN",13,83387,9002,93687,"CHARLES C DIGGS JR","RICHARD A GOLDEN","Democrat",0.890059453285941,74385,92389,0.805128316141532
1976,"MICHIGAN",14,107503,52995,161666,"LUCIEN N NEDZI","JOHN EDWARD GETZ","Democrat",0.664969752452587,54508,160498,0.339617939164351
1976,"MICHIGAN",15,117313,39177,158550,"WILLIAM D FORD","JAMES D WALASKAY","Democrat",0.739911699779249,78136,156490,0.499303469870279
1976,"MICHIGAN",16,121682,36378,160344,"JOHN D DINGELL","WILLIAM E ROSTRON","Democrat",0.758880906051988,85304,158060,0.539693787169429
1976,"MICHIGAN",17,112746,60476,175573,"WILLIAM M BRODHEAD","JAMES W BURDICK","Democrat",0.64216024103934,52270,173222,0.301751509623489
1976,"MICHIGAN",18,123113,60995,186195,"JAMES J BLANCHARD","JOHN E OLSEN","Democrat",0.66120465103789,62118,184108,0.337399787081496
1976,"MICHIGAN",19,64337,131799,197645,"DORTHEA BECKER","WILLIAM S BROOMFIELD","Republican",0.666847124895646,-67462,196136,-0.34395521474895
1976,"MINNESOTA",1,70630,158177,231773,"ROBERT C ""BOB"" OLSON JR","ALBERT H QUIC","Republican",0.682465170662674,-87547,228807,-0.382623783363271
1976,"MINNESOTA",2,97488,148322,245810,"GLORIA GRIFFIN","TOM HAGEDORN","Republican",0.603401000772955,-50834,245810,-0.206802001545909
1976,"MINNESOTA",3,72044,149013,225459,"JEROME W COUGHLIN","BILL FRENZEL","Republican",0.66093169933336,-76969,221057,-0.348186214415287
1976,"MINNESOTA",4,133282,59767,200599,"BRUCE F VENTO","ANDREW ENGEBRETSON","Democrat",0.664420061914566,73515,193049,0.38081005340613
1976,"MINNESOTA",5,138213,50764,195596,"DONALD M FRASER","RICHARD M ERDALL","Democrat",0.706624879854394,87449,188977,0.462749435116443
1976,"MINNESOTA",6,147507,99201,246708,"RICHARD NOLAN","JAMES ""JIM"" ANDERSON","Democrat",0.597901162507904,48306,246708,0.195802325015808
1976,"MINNESOTA",7,174080,64333,241627,"BOB BERGLAND","BOB LEISETH","Democrat",0.72044928753823,109747,238413,0.460323052853661
1976,"MISSISSIPPI",2,75092,42601,119173,"DAVID R BOWEN","ROLAND BYRD","Democrat",0.630109169023185,32491,117693,0.276065696345577
1976,"MISSISSIPPI",3,129088,8321,137409,"G V ""SONNY"" MONTGOMERY","DOROTHY COLBY CLEVELAND","Democrat",0.939443559009963,120767,137409,0.878887118019926
1976,"MISSISSIPPI",4,28737,101132,132991,"STERLING P DAVIS","THAD COCHRAN","Republican",0.760442435954313,-72395,129869,-0.557446349783243
1976,"MISSISSIPPI",5,48724,104554,153278,"GERALD BLESSEY","TRENT LOTT","Republican",0.682120069416355,-55830,153278,-0.364240138832709
1976,"MISSOURI",1,87310,45874,133184,"WILLIAM ""BILL"" CLAY","ROBERT L WITHERSPOON","Democrat",0.655559226333494,41436,133184,0.311118452666987
1976,"MISSOURI",2,111568,106811,218379,"ROBERT A YOUNG","ROBERT O SNYDER","Democrat",0.510891615036244,4757,218379,0.0217832300724887
1976,"MISSOURI",3,115109,65623,180732,"RICHARD A GEPHARDT","JOSEPH L BADARACCO","Democrat",0.636904366686586,49486,180732,0.273808733373171
1976,"MISSOURI",4,115955,91605,207560,"IKE SKELTON","RICHARD A KING","Democrat",0.55865773752168,24350,207560,0.117315475043361
1976,"MISSOURI",5,100876,41681,148302,"RICHARD BOLLING","JOANNE M COLLINS","Democrat",0.68020660544025,59195,142557,0.415237413806407
1976,"MISSOURI",6,83755,120969,206661,"MORGAN MAXFIELD","E THOMAS COLEMAN","Republican",0.585349920884928,-37214,204724,-0.181776440475958
1976,"MISSOURI",7,81848,133656,215504,"DOLAN G HAWKINS","GENE TAYLOR","Republican",0.620201945207514,-51808,215504,-0.240403890415027
1976,"MISSOURI",8,132386,60179,196647,"RICHARD H ICHORD","CHARLES R LEICK","Democrat",0.673216474189792,72207,192565,0.374974683872978
1976,"MISSOURI",9,120325,94816,215141,"HAROLD L VOLKMER","JOE FRAPPIER","Democrat",0.559284376292757,25509,215141,0.118568752585514
1976,"MISSOURI",10,131675,51024,182699,"BILL D BURLISON","JOE CARRON","Democrat",0.720720967274041,80651,182699,0.441441934548082
1976,"MONTANA",1,111487,56297,167784,"MAX BAUCUS","W D ""BILL"" DIEHL","Democrat",0.664467410480141,55190,167784,0.328934820960282
1976,"MONTANA",2,68972,84149,153121,"THOMAS E ""TOM"" TOWE","RON MARLENCE","Republican",0.549558845618824,-15177,153121,-0.0991176912376487
1976,"NEBRASKA",1,53699,146558,200268,"PAULINE F ANDERSON","CHARLES THONE","Republican",0.731809375436914,-92859,200257,-0.463699146596623
1976,"NEBRASKA",2,106296,88352,194775,"JOHN J CAVANAUGH","LEE TERRY","Democrat",0.545737389295341,17944,194648,0.0921869220336197
1976,"NEBRASKA",3,51012,150720,206765,"JAMES THOMAS HANSEN","VIRGINIA SMITH","Republican",0.728943486566875,-99708,201732,-0.494259710903575
1976,"NEVADA",0,153996,24124,199863,"JIM SANTINI","WALDEN CHARLES EARHART","Democrat",0.770507797841521,129872,178120,0.729126431619133
1976,"NEW HAMPSHIRE",1,107806,48087,158242,"NORMAN E D'AMOURS","JOHN ADAMS","Democrat",0.681272986944048,59719,155893,0.38307685399601
1976,"NEW HAMPSHIRE",2,65792,100911,166703,"J JOSEPH GRANDMAISON","JAMES C CLEVELAND","Republican",0.605334037179895,-35119,166703,-0.21066807435979
1976,"NEW JERSEY",1,136624,56363,194898,"JAMES J FLORIO","JOSEPH I MCCULLOUGH JR","Democrat",0.701002575706267,80261,192987,0.415888116816159
1976,"NEW JERSEY",2,141753,87915,229668,"WILLIAM J HUGHES","JAMES R HURLEY","Democrat",0.617208318093944,53838,229668,0.234416636187889
1976,"NEW JERSEY",3,127164,75934,204739,"JAMES J HOWARD","RALPH A SICILIANO","Democrat",0.62110296523867,51230,203098,0.252242759652975
1976,"NEW JERSEY",4,113281,54789,170868,"FRANK THOMPSON JR","JOSEPH S INDYK","Democrat",0.662973757520425,58492,168070,0.348021657642649
1976,"NEW JERSEY",5,64598,137803,206106,"FRANK R NERO","MILLICENT II FENWICK","Republican",0.668602563729343,-73205,202401,-0.361682995637373
1976,"NEW JERSEY",6,85053,125920,214304,"CATHERINE A COSTA","EDWIN B FORSYTHE","Republican",0.587576526803046,-40867,210973,-0.193707251638835
1976,"NEW JERSEY",7,120526,92624,213150,"ANDREW MAGUIRE","JAMES J SHEEHAN","Democrat",0.565451559934319,27902,213150,0.130903119868637
1976,"NEW JERSEY",8,108841,44775,154196,"ROBERT A ROE","BESSIE DOTY","Democrat",0.705861371241796,64066,153616,0.417052911155088
1976,"NEW JERSEY",9,89723,107454,202344,"HENRY HELSTOSKI","HAROLD C HOLLENBECK","Republican",0.531046139248013,-17731,197177,-0.0899242812295552
1976,"NEW JERSEY",10,88245,17129,106775,"PETER W RODINO JR","TONY GRANDISON","Democrat",0.826457504097401,71116,105374,0.674891339419591
1976,"NEW JERSEY",11,129026,59397,190808,"JOSEPH G MINISH","CHARLES A POCKEL JR","Democrat",0.676208544715106,69629,188423,0.369535566252528
1976,"NEW JERSEY",12,49189,136973,187282,"RICHARD A BUGGELLI","MATTHEW J RINALDO","Republican",0.731373009685928,-87784,186162,-0.471546287641946
1976,"NEW JERSEY",13,105291,100050,209051,"HELEN S MEYNER","WILLIAM E SCHLUTER","Democrat",0.503661785880001,5241,205341,0.0255233976653469
1976,"NEW JERSEY",14,73174,66319,146768,"JOSEPH A LE FANTE","ANTHONY LOUIS CAMPENNI","Democrat",0.498569170391366,6855,139493,0.0491422508656348
1976,"NEW JERSEY",15,106170,54487,179836,"EDWARD J PATTEN","CHARLES W WILEY","Democrat",0.590371227118041,51683,160657,0.321697778497047
1976,"NEW MEXICO",1,61800,162587,225546,"RAYMOND GARCIA","MANUEL LUJAN JR","Republican",0.720859602919138,-100787,224387,-0.449165949899058
1976,"NEW MEXICO",2,123563,52131,175694,"HAROLD RUNNELS","DONALD W TRUBEY","Democrat",0.70328525732239,71432,175694,0.40657051464478
1976,"NEW YORK",1,129779,61671,207468,"OTIS G PIKE","SALVATORE NICOSIA","Democrat",0.625537432278713,68108,191450,0.355748237137634
1976,"NEW YORK",2,90172,57612,159902,"THOMAS J DOWNEY","PETER F COHALAN","Democrat",0.563920401245763,32560,147784,0.220321550370811
1976,"NEW YORK",3,94265,71714,181439,"JEROME A AMBRO JR","HOWARD T HOGAN JR","Democrat",0.519541002761259,22551,165979,0.135866585531905
1976,"NEW YORK",4,79308,91304,190029,"GERALD P HALPERN","NORMAN F LENT","Republican",0.480474032910766,-11996,170612,-0.0703115841793074
1976,"NEW YORK",5,82882,98337,198234,"ALLARD K LOWENSTEIN","JOHN W WYDLER","Republican",0.496065256212355,-15455,181219,-0.0852835519454362
1976,"NEW YORK",6,104374,60567,181947,"LESTER L WOLF","VINCENT R BALLETTA JR","Democrat",0.573650568572167,43807,164941,0.265591938935741
1976,"NEW YORK",7,82107,19896,113373,"JOSEPH P ADDABBO","JOSEPH P ADDABBO","Democrat",0.724220052393427,62211,102003,0.609893826652157
1976,"NEW YORK",8,98954,23754,137861,"BENJAMIN S ROSENTHAL","ALBERT LEMISHOW","Democrat",0.717780953279027,75200,122708,0.612836978844085
1976,"NEW YORK",9,53418,43900,115195,"JAMES J DELANEY","JAMES J DELANEY","Democrat",0.463718043317852,9518,97318,0.0978030785671715
1976,"NEW YORK",10,69019,37203,115962,"MARIO BIAGGI","MARIO BIAGGI","Democrat",0.595186354150498,31816,106222,0.299523639170793
1976,"NEW YORK",11,84770,19203,114458,"JAMES H SCHEUER","ARTHUR CUCCIA","Democrat",0.740621013821664,65567,103973,0.630615640599002
1976,"NEW YORK",12,41297,5336,49632,"SHIRLEY CHISHOLM","HORACE L MORANCIE","Democrat",0.832063990973565,35961,46633,0.771149186198615
1976,"NEW YORK",13,102662,17631,132224,"STEPHEN J SOLARZ","JACK DOBOSH","Democrat",0.776424854791868,85031,120293,0.706865736160874
1976,"NEW YORK",14,51934,7507,65591,"FREDERICK W RICHMOND","FRANK X GARGIULO","Democrat",0.791785458370813,44427,59441,0.7474134015242
1976,"NEW YORK",15,59350,33641,109487,"LEO C ZEFERETTI","RONALD J D'ANGELO","Democrat",0.542073488176679,25709,92991,0.276467615145552
1976,"NEW YORK",16,86992,15094,113418,"ELIZABETH HOLTZMAN","GLADYS PEMBERTON","Democrat",0.767003473875399,71898,102086,0.70428854103403
1976,"NEW YORK",17,89126,27734,135915,"JOHN M MURPHY","KENNETH J GROSSBERGER","Democrat",0.655748077842769,61392,116860,0.525346568543556
1976,"NEW YORK",18,98813,29728,149422,"EDWARD I KOCH","SONIA LANDAU","Democrat",0.66130154863407,69085,128541,0.537454975455302
1976,"NEW YORK",19,77849,7627,94481,"CHARLES B RANGEL","CHARLES B RANGEL","Democrat",0.823964606640489,70222,85476,0.821540549393982
1976,"NEW YORK",20,82501,14114,110490,"THEODORE S WEISS","DENISE T WEISEMAN","Democrat",0.746682957733732,68387,96615,0.707830047094137
1976,"NEW YORK",21,37184,2428,41883,"HERMAN BADILLO","HERMAN BADILLO","Democrat",0.887806508607311,34756,39612,0.877410885590225
1976,"NEW YORK",22,86381,11130,106592,"JONATHAN B BINGHAM","PAUL SLOTKIN","Democrat",0.810389147403182,75251,97511,0.771718062577555
1976,"NEW YORK",23,75083,78601,173430,"J EDWARD MEYER","BRUCE F CAPUTO","Republican",0.45321455342213,-3518,153684,-0.0228911272481195
1976,"NEW YORK",24,99761,69677,183012,"RICHARD L OTTINGER","DAVID V HICKS","Democrat",0.545106331825235,30084,169438,0.177551670817644
1976,"NEW YORK",25,58216,122958,197605,"MINNA POST PEYSER","HAMILTON FISH JR","Republican",0.622241340047064,-64742,181174,-0.357347080706945
1976,"NEW YORK",26,60511,120049,183981,"JOHN R MALONEY","BENJAMIN A GILMAN","Republican",0.652507595893054,-59538,180560,-0.329740806380151
1976,"NEW YORK",27,121763,58842,190674,"MATTHEW F MCHUGH","WILLIAM H HARTER","Democrat",0.638592571614378,62921,180605,0.348390133163534
1976,"NEW YORK",28,170034,40220,215162,"SAMUEL S STRATTON","MARY A BRADT","Democrat",0.790260361959826,129814,210254,0.617415126466084
1976,"NEW YORK",29,95361,96476,214222,"EDWARD W PATTISON","JOSEPH A MARTINO","Republican",0.450355238957717,-1115,191837,-0.00581222600436829
1976,"NEW YORK",30,75951,89493,171515,"NORMA A BARTLE","ROBERT C MCEWEN","Republican",0.521779436200915,-13542,165444,-0.0818524697178502
1976,"NEW YORK",31,62032,115464,185175,"ANITA MAXWELL","DONALD J MITCHELL","Republican",0.623539894694208,-53432,177496,-0.301032135935458
1976,"NEW YORK",32,101419,75105,185140,"JAMES M HANLEY","GEORGE C WORTLEY","Democrat",0.547796262287998,26314,176524,0.149067548888536
1976,"NEW YORK",33,48855,125163,182755,"CHARLES R WELCH","WILLIAM F WALSH","Republican",0.684867719077453,-76308,174018,-0.438506361410889
1976,"NEW YORK",34,58247,126566,192196,"WILLIAM C LARSEN","FRANK J HORTON","Republican",0.658525671710129,-68319,184813,-0.369665553830088
1976,"NEW YORK",35,61186,120738,187915,"MICHAEL MACALUSO JR","BARBER B CONABLE JR","Republican",0.642513902562329,-59552,181924,-0.327345484927772
1976,"NEW YORK",36,118765,56790,184947,"JOHN J LAFALCE","RALPH J ARGEN","Democrat",0.642156942259134,61975,175555,0.353023269060978
1976,"NEW YORK",37,95604,23660,127951,"HENRY J NOWAK","CALVIN KIMBROUGH","Democrat",0.747192284546428,71944,119264,0.6032331634022
1976,"NEW YORK",38,44034,151610,212009,"PETER J GERACI","JACK F KEMP","Republican",0.715111150941705,-107576,195644,-0.549855860644845
1976,"NEW YORK",39,109986,63829,178004,"STANLEY N LUNDINE","RICHARD A SNOWDEN","Democrat",0.617884991348509,46157,173815,0.265552455196617
1976,"NORTH CAROLINA",1,98611,29295,129956,"WALTER B JONES","JOSEPH M WARD","Democrat",0.758802979469974,69316,127906,0.541929229277751
1976,"NORTH CAROLINA",3,77193,35089,112282,"CHARLES WHITLEY","WILLARD J ""JACK"" BLANCHARD","Democrat",0.687492207121355,42104,112282,0.37498441424271
1976,"NORTH CAROLINA",4,92165,59917,152082,"IKE ANDREWS","JOHNNIE L GALLEMORE JR","Democrat",0.606021751423574,32248,152082,0.212043502847148
1976,"NORTH CAROLINA",5,98789,83129,182164,"STEPHEN L ""STEVE"" NEAL","WILMER ""VINEGAR BEND"" MIZELL","Democrat",0.542308030126699,15660,181918,0.0860827405754241
1976,"NORTH CAROLINA",7,95463,21955,117418,"CHARLES G ROSE","M H ""MIKE"" VAUGHAN","Democrat",0.813018446916146,73508,117418,0.626036893832291
1976,"NORTH CAROLINA",8,99296,49094,151081,"W G ""BILL"" HEFNER","CARL EAGLE","Democrat",0.657236846459846,50202,148390,0.338311206954647
1976,"NORTH CAROLINA",9,70847,82297,153788,"ARTHUR GOODMAN JR","JAMES G MARTIN","Republican",0.535132780190912,-11450,153144,-0.0747662330878128
1976,"NORTH CAROLINA",10,67190,99882,167072,"JOHN J ""JACK"" HUNT","JAMES T ""JIM"" BROYHILL","Republican",0.597838057843325,-32692,167072,-0.19567611568665
1976,"NORTH CAROLINA",11,93857,88752,184405,"LAMAR GUDGER","BRUCE BRIGGS","Democrat",0.508972099455004,5105,182609,0.0279559057877761
1976,"NORTH DAKOTA",0,104263,181018,289881,"LLOYD B OMDAHL","MARK ANDREWS","Republican",0.624456242389118,-76755,285281,-0.269050515106159
1976,"OHIO",1,56995,109789,169516,"WILLIAM F BOWEN","WILLIS D GRADISON JR","Republican",0.647661577668185,-52794,166784,-0.316541155026861
1976,"OHIO",2,88178,83459,171637,"THOMAS A LUKEN","DONALD D CLANEY","Democrat",0.513747035895524,4719,171637,0.0274940717910474
1976,"OHIO",3,33873,100871,145374,"LEONARD E STUBBS JR","CHARLES W WHALEN JR","Republican",0.693872356817588,-66998,134744,-0.497224366205545
1976,"OHIO",4,51784,121173,172957,"CLINTON G DORSEY","TENNYSON GUYER","Republican",0.700596101921287,-69389,172957,-0.401192203842574
1976,"OHIO",5,60304,124910,185214,"BRUCE EDWARDS","DELBERT L LATTA","Republican",0.674409061949961,-64606,185214,-0.348818123899921
1976,"OHIO",6,67067,107064,174131,"TED STRICKLAND","WILLIAM H HARSHA","Republican",0.614847442442759,-39997,174131,-0.229694884885517
1976,"OHIO",7,54755,101027,155782,"DOROTHY FRANKE","CLARENCE J BROWN","Republican",0.648515232825359,-46272,155782,-0.297030465650717
1976,"OHIO",8,46424,110775,161357,"JOHN W GRIFFIN","THOMAS N KINDNESS","Republican",0.68652119213917,-64351,157199,-0.409360110433272
1976,"OHIO",9,91040,73919,167969,"THOMAS LUDLOW ASHLEY","CARLETON S FINKBEINER","Democrat",0.542004774690568,17121,164959,0.103789426463545
1976,"OHIO",10,57757,127147,184904,"JAMES A PLUMMER","CLARENCE E MILLER","Republican",0.687637909401635,-69390,184904,-0.375275818803271
1976,"OHIO",11,47548,120716,168264,"THOMAS R WEST JR","J WILLIAM STANTON","Republican",0.717420244377882,-73168,168264,-0.434840488755765
1976,"OHIO",12,89424,90987,195840,"FRANCINE RYAN","SAMUEL L DEVINE","Republican",0.464598651960784,-1563,180411,-0.00866355155727755
1976,"OHIO",13,108061,49828,163683,"DONALD J PEASE","WOODROW W MATHNA","Democrat",0.660184625159607,58233,157889,0.36882240054722
1976,"OHIO",14,121652,39917,164188,"JOHN F SEIBERLING","JAMES E HOUSTON","Democrat",0.740931127731625,81735,161569,0.505882935464105
1976,"OHIO",15,57741,109630,167371,"MIKE MCGEE","CHALMERS P WYLIE","Republican",0.655011919627653,-51889,167371,-0.310023839255307
1976,"OHIO",16,55671,116374,174091,"JOHN G FREEDOM","RALPH S REGULA","Republican",0.668466491662406,-60703,172045,-0.352832107878753
1976,"OHIO",17,72168,94874,167042,"JOHN C MCDONALD","JOHN M ASHBROOK","Republican",0.56796494294848,-22706,167042,-0.13592988589696
1976,"OHIO",18,116901,45735,185834,"DOUGLAS APPLEGATE","RALPH R MCCOY","Democrat",0.62906142040746,71166,162636,0.437578395927101
1976,"OHIO",19,90386,86162,179895,"CHARLES J CARNEY","JACK C HUNTER","Democrat",0.502437533005364,4224,176548,0.0239255046786143
1976,"OHIO",21,91903,12434,109626,"LOUIS STOKES","BARBARA SPARKS","Democrat",0.838332147483261,79469,104337,0.761656938574044
1976,"OHIO",22,128535,42727,176723,"CHARLES A VANIK","HARRY A HANNA","Democrat",0.727324683261375,85808,171262,0.501033504221602
1976,"OHIO",23,130576,47804,178380,"RONALD M MOTTL","MICHAEL T SCANLON","Democrat",0.732010315057742,82772,178380,0.464020630115484
1976,"OKLAHOMA",1,100945,84374,187044,"JAMES R JONES","JAMES M INHOFE","Democrat",0.539685849318877,16571,185319,0.0894187859852471
1976,"OKLAHOMA",2,102402,87341,189743,"THEODORE M ""TED"" RISENHOOVER","BUD STEWART","Democrat",0.539687893624534,15061,189743,0.0793757872490685
1976,"OKLAHOMA",3,151271,31732,184565,"WES WATKINS","GERALD BEASLEY JR","Democrat",0.819608268089833,119539,183003,0.65320787090922
1976,"OKLAHOMA",4,116425,34170,155357,"TOM STEED","M C STANLEY","Democrat",0.749402987956771,82255,150595,0.546200073043594
1976,"OKLAHOMA",5,74752,78651,157764,"TOM DUNLAP","MICKEY EDWARDS","Republican",0.498535787632159,-3899,153403,-0.0254167128413395
1976,"OKLAHOMA",6,137498,55953,193451,"GLENN ENGLISH","CAROL MCCURLEY","Democrat",0.710763966068927,81545,193451,0.421527932137854
1976,"OREGON",1,154844,109140,264000,"LES AUCOIN","PHIL BLADINE","Democrat",0.586530303030303,45704,263984,0.173131704951815
1976,"OREGON",2,173313,67431,240761,"AL ULLMAN","THOMAS H MERCER","Democrat",0.71985495989799,105882,240744,0.439811584089323
1976,"OREGON",4,122475,85943,244852,"JAMES WEAVER","JERRY LAUSMANN","Democrat",0.500200120889354,36532,208418,0.175282365246764
1976,"PENNSYLVANIA",1,117087,40191,159205,"MICHAEL O MYERS","SAMUEL N FANELLI","Democrat",0.735448007286203,76896,157278,0.488917712585358
1976,"PENNSYLVANIA",2,109855,37907,149369,"ROBERT N C NIX","JESSE W WOODS JR","Democrat",0.735460503852874,71948,147762,0.486918152163614
1976,"PENNSYLVANIA",3,98627,35491,134818,"RAYMOND F LEDERER","TERENCE J SCHADE","Democrat",0.731556617068937,63136,134118,0.470749638378145
1976,"PENNSYLVANIA",4,144890,69700,214590,"JOSHUA EILBERG","JAMES E MUGFORD","Democrat",0.675194557062305,75190,214590,0.35038911412461
1976,"PENNSYLVANIA",5,81299,119682,200981,"ANTHONY CAMPOLO","RICHARD T SCHULZE","Republican",0.595489125837766,-38383,200981,-0.190978251675532
1976,"PENNSYLVANIA",6,133624,46103,180998,"GUS YATRON","STEPHEN POSTUPACK","Democrat",0.738262301240898,87521,179727,0.486966343398599
1976,"PENNSYLVANIA",7,109436,92788,202351,"ROBERT W EDGAR","JOHN M KENNEY","Democrat",0.540822629984532,16648,202224,0.0823245509929583
1976,"PENNSYLVANIA",8,93855,92543,189623,"PETER H KOSTMAYER","JOHN S RENNINGER","Democrat",0.494955780680614,1312,186398,0.00703870213199712
1976,"PENNSYLVANIA",10,74925,125218,200143,"EDWARD MITCHELL","JOSEPH M MCDADE","Republican",0.625642665494172,-50293,200143,-0.251285330988343
1976,"PENNSYLVANIA",11,130175,53621,183796,"DANIEL J FLOOD","HOWARD G WILLIAMS","Democrat",0.708258068728373,76554,183796,0.416516137456746
1976,"PENNSYLVANIA",12,122504,58489,180993,"JOHN P MURTHA","THEODORE L HUMES","Democrat",0.676843855839729,64015,180993,0.353687711679457
1976,"PENNSYLVANIA",13,75435,130705,206140,"GERTRUDE STRICK","LAWRENCE COUGHLIN","Republican",0.634059377122344,-55270,206140,-0.268118754244688
1976,"PENNSYLVANIA",14,114472,43308,159644,"WILLIAM S MOORHEAD","JOHN F BRADLEY","Democrat",0.717045426073012,71164,157780,0.45103308404107
1976,"PENNSYLVANIA",15,108844,57616,166890,"FRED B ROONEY","ALICE B SIVULICH","Democrat",0.652190065312481,51228,166460,0.3077496095158
1976,"PENNSYLVANIA",16,57836,97527,156455,"MICHAEL J MINNEY","ROBERT S WALKER","Republican",0.623354958294717,-39691,155363,-0.255472667237373
1976,"PENNSYLVANIA",17,86158,82370,169864,"ALLEN E ERTEL","H J HEPFORD","Democrat",0.507217538736872,3788,168528,0.0224769771195291
1976,"PENNSYLVANIA",18,113787,77594,191381,"DOUGLAS WALGREN","ROBERT J CASEY","Democrat",0.594557453456717,36193,191381,0.189114906913434
1976,"PENNSYLVANIA",19,51686,124098,175784,"RICHARD P NOLL","WILLIAM F GOODLING","Republican",0.705968688845401,-72412,175784,-0.411937377690802
1976,"PENNSYLVANIA",20,134961,44432,180055,"JOSEPH M GAYDOS","JOHN P KOSTELAC","Democrat",0.749554302851906,90529,179393,0.504640649300697
1976,"PENNSYLVANIA",21,99160,67763,166923,"JOHN H DENT","ROBERT H MILLER","Democrat",0.59404635670339,31397,166923,0.18809271340678
1976,"PENNSYLVANIA",22,97036,77030,175416,"AUSTIN J MURPHY","ROGER R FISCHER","Democrat",0.553176449126648,20006,174066,0.114933416060575
1976,"PENNSYLVANIA",23,95821,73641,169462,"JOSEPH S AMMERMAN","ALBERT W JOHNSON","Democrat",0.565442400066091,22180,169462,0.130884800132183
1976,"PENNSYLVANIA",24,79937,101048,182526,"JOSEPH P VIGORITO","MARC L MARKS","Republican",0.553608800937949,-21111,180985,-0.11664502583087
1976,"PENNSYLVANIA",25,78857,103632,182489,"EUGENE V ATKINSON","GARY A MYERS","Republican",0.567880803774474,-24775,182489,-0.135761607548948
1976,"RHODE ISLAND",1,116674,68080,187002,"FERNAND J ST GERMAIN","JOHN J SLOCUM JR","Democrat",0.623918460765125,48594,184754,0.2630200158048
1976,"RHODE ISLAND",2,154453,45438,201912,"EDWARD P BEARD","THOMAS V IANNITTI","Democrat",0.764952058322438,109015,199891,0.545372227864186
1976,"SOUTH CAROLINA",1,89891,40598,130503,"MENDEL J DAVIS","LONNIE ROWELL","Democrat",0.688804088794894,49293,130489,0.377755979431216
1976,"SOUTH CAROLINA",2,60602,83426,144995,"CLYDE BURNS LIVINGSTON","FLOYD D SPENCE","Republican",0.575371564536708,-22824,144028,-0.15846918654706
1976,"SOUTH CAROLINA",4,91721,32983,124765,"JAMES R MANN","ROBERT L WATKINS","Democrat",0.73515008215445,58738,124704,0.471019373877342
1976,"SOUTH CAROLINA",5,66073,62095,128510,"KENNETH L HOLLAND","ROBERT C RICHARDSON JR","Democrat",0.514146759007081,3978,128168,0.0310373884276887
1976,"SOUTH CAROLINA",6,75916,60288,136896,"JOHN W JENRETTE JR","EDWARD L YOUNG","Democrat",0.554552360916316,15628,136204,0.114739655223048
1976,"SOUTH DAKOTA",1,29533,121587,152402,"JAMES V GUFFEY","LARRY PRESSLER","Republican",0.797804490754714,-92054,151120,-0.609145050291159
1976,"SOUTH DAKOTA",2,42968,99601,142569,"GRACE MICKELSON","JAMES ABDNOR","Republican",0.69861610869123,-56633,142569,-0.39723221738246
1976,"TENNESSEE",1,69507,97781,168734,"LLOYD H BLEVINS","JAMES H ""JIMMY"" QUILLEN","Republican",0.579497907949791,-28274,167288,-0.169013916120702
1976,"TENNESSEE",2,69449,117256,186707,"MIKE ROWLAND","JOHN J DUNCAN","Republican",0.628021445366269,-47807,186705,-0.256056345571891
1976,"TENNESSEE",3,123872,57116,183569,"MARILYN LLOYD","LAMAR BAKER","Democrat",0.67479803234751,66756,180988,0.3688421331801
1976,"TENNESSEE",6,64462,116905,181375,"ROSS BASS","ROBIN L BEARD JR","Republican",0.644548587181254,-52443,181367,-0.289154035739688
1976,"TENNESSEE",8,100683,63819,165954,"HAROLD E FORD","A D ""ANDY"" ALLISSANDRATOS","Democrat",0.606692215915254,36864,164502,0.224094539884014
1976,"TEXAS",1,135384,26334,161718,"SAM B HALL JR","JAMES HOGAN","Democrat",0.837160983934998,109050,161718,0.674321967869996
1976,"TEXAS",3,60070,171343,231413,"LES SHACKELFORD JR","JAMES M COLLINS","Republican",0.740420806091274,-111273,231413,-0.480841612182548
1976,"TEXAS",4,105394,62641,168035,"RAY ROBERTS","FRANK S GLENN","Democrat",0.627214568393489,42753,168035,0.254429136786979
1976,"TEXAS",5,67871,56056,125768,"JIM MATTOX","NANCY JUDY","Democrat",0.539652375803066,11815,123927,0.0953383846942151
1976,"TEXAS",6,119025,60316,180534,"OLIN E TEAGUE","WES MOWERY","Democrat",0.659294094187244,58709,179341,0.327359611020347
1976,"TEXAS",8,84404,54566,139163,"BOB ECKHARDT","NICK GEARHART","Democrat",0.606511788334543,29838,138970,0.214708210405123
1976,"TEXAS",10,160683,48482,209165,"J J PICKLE","PAUL MCCLURE","Democrat",0.768211698897999,112201,209165,0.536423397795998
1976,"TEXAS",11,92142,68373,160515,"W R POAGE","JACK BURGESS","Democrat",0.574039809363611,23769,160515,0.148079618727222
1976,"TEXAS",12,101814,31941,134259,"JIM WRIGHT","W R DURHAM","Democrat",0.75834022300181,69873,133755,0.522395424470113
1976,"TEXAS",13,101798,69328,171673,"JACK HIGHTOWER","BOB PRICE","Democrat",0.592976181461267,32470,171126,0.189743230134521
1976,"TEXAS",14,93589,58788,152377,"JOHN YOUNG","L DEAN HOLFORD","Democrat",0.614193743150213,34801,152377,0.228387486300426
1976,"TEXAS",15,102837,35446,138283,"E ""KIKA"" DE LA GARZA","R L ""LENDY"" MCDONALD","Democrat",0.743670588575602,67391,138283,0.487341177151204
1976,"TEXAS",16,71876,52499,124375,"RICHARD C WHITE","VIC SHAKELFORD","Democrat",0.577897487437186,19377,124375,0.155794974874372
1976,"TEXAS",18,93953,15381,109876,"BARBARA JORDAN","SAM H WRIGHT","Democrat",0.855082092540682,78572,109334,0.718641959500247
1976,"TEXAS",19,87908,72991,160899,"GEORGE MAHON","JIM REESE","Democrat",0.546355166905947,14917,160899,0.0927103338118944
1976,"TEXAS",21,149395,56211,210300,"ROBERT ""BOB"" KRUEGER","BOBBY A LOCKE","Democrat",0.7103899191631,93184,205606,0.453216345826484
1976,"TEXAS",22,96535,96267,192802,"BOB GAMMAGE","RON PAUL","Democrat",0.500695013537204,268,192802,0.00139002707440794
1976,"TEXAS",24,82743,47075,130522,"DALE MILFORD","LEO BERMAN","Democrat",0.633939106051087,35668,129818,0.274753886209925
1976,"UTAH",1,155631,106542,267531,"GUNN MCKAY","JOE H FERGUSON","Democrat",0.581730715318972,49089,262173,0.187238960533693
1976,"UTAH",2,110931,144861,276300,"ALLAN T HOWE","DAN MARRIOTT","Republican",0.5242888165038,-33930,255792,-0.13264683805592
1976,"VERMONT",0,60202,124458,184783,"JOHN A BURGESS","JAMES M JEFFORDS","Republican",0.673535985453207,-64256,184660,-0.347969240766815
1976,"VIRGINIA",1,70159,71789,147850,"ROBERT E QUINN","PAUL S TRIBLE JR","Republican",0.48555292526209,-1630,141948,-0.0114830783103672
1976,"VIRGINIA",2,41464,79381,120847,"ROBERT E ""BOB"" WASHINGTON","G WILLIAM WHITEHURST","Republican",0.656871912418182,-37917,120845,-0.313765567462452
1976,"VIRGINIA",4,65982,74495,140480,"J W ""BILLY"" O'BRIEN","ROBERT W ""BOB"" DANIEL JR","Republican",0.530289009111617,-8513,140477,-0.0606006677249657
1976,"VIRGINIA",8,83245,68729,161327,"HERBERT E HARRIS II","JAMES R TATE","Democrat",0.516001661222238,14516,151974,0.0955163383210286
1976,"VIRGINIA",9,71439,96052,167504,"CHARLES J HORNE","WILLIAM C WAMPLER","Republican",0.573431082242812,-24613,167491,-0.146951179466359
1976,"VIRGINIA",10,103689,73616,189489,"JOSEPH L FISHER","VINCENT F CALLAHAN JR","Democrat",0.547203267735858,30073,177305,0.169611686077663
1976,"WASHINGTON",1,58006,161354,224561,"DAVE WOOD","JOEL PRITCHARD","Republican",0.718530822360071,-103348,219360,-0.471134208606856
1976,"WASHINGTON",2,107328,106786,217858,"LLOYD MEEDS","JOHN NANCE GARNER","Democrat",0.492651176454388,542,214114,0.00253136179792073
1976,"WASHINGTON",3,145198,57517,205072,"DON BONKER","CHUCK ELHART","Democrat",0.708034251384879,87681,202715,0.432533359642848
1976,"WASHINGTON",4,115364,81813,199664,"MIKE MCCORMACK","DICK GRANGER","Democrat",0.577790688356439,33551,197177,0.170156762705589
1976,"WASHINGTON",5,120415,84262,207571,"THOMAS S FOLEY","DUANE ALTON","Democrat",0.580114755914844,36153,204677,0.176634404451892
1976,"WASHINGTON",6,137964,47539,187754,"NORMAN D DICKS","ROBERT M REYNOLDS","Democrat",0.73481257389989,90425,185503,0.487458423852983
1976,"WASHINGTON",7,133673,46448,183122,"BROCK ADAMS","RAYMOND PRITCHARD","Democrat",0.729966907307697,87225,180121,0.48425780447588
1976,"WEST VIRGINIA",1,108055,78134,186189,"ROBERT H MOLLOHAN","JOHN F MCCUSKEY","Democrat",0.580351148564093,29921,186189,0.160702297128187
1976,"WEST VIRGINIA",2,145405,52230,197635,"HARLEY O STAGGERS","JIM SLOAN","Democrat",0.735724947504238,93175,197635,0.471449895008475
1976,"WEST VIRGINIA",4,73626,28825,161518,"NICK JOE RAHALL II","E S ""STEVE"" GOODMAN","Democrat",0.455837739446997,44801,102451,0.437291973724024
1976,"WISCONSIN",1,136162,71427,209807,"LES ASPIN","WILLIAM W PETRIE","Democrat",0.648986926079683,64735,207589,0.311842149632206
1976,"WISCONSIN",2,155158,81350,236545,"ROBERT W KASTENMEIER","ELIZABETH T MILLER","Democrat",0.655934388805513,73808,236508,0.312074010181474
1976,"WISCONSIN",3,139083,100218,239311,"ALVIN J BALDUS","ADOLF L GUNDERSEN","Democrat",0.581180973712032,38865,239301,0.162410520641368
1976,"WISCONSIN",5,134935,36413,173511,"HENRY S REUSS","ROBERT L HICKS","Democrat",0.777674037957248,98522,171348,0.574981908163503
1976,"WISCONSIN",6,80715,139541,220271,"JOSEPH C SMITH","WILLIAM A STEIGER","Republican",0.633496919703456,-58826,220256,-0.267080124945518
1976,"WISCONSIN",7,171366,60952,233937,"DAVID R OBEY","FRANK A SAVINO","Democrat",0.732530553097629,110414,232318,0.475270964798251
1976,"WISCONSIN",8,115996,107048,228106,"ROBERT J CORNELL","HAROLD V FROEHLICH","Democrat",0.508517969715834,8948,223044,0.0401176449489787
1976,"WISCONSIN",9,84706,163791,248524,"LYNN M MCDONALD","ROBERT W KASTEN JR","Republican",0.65905506108062,-79085,248497,-0.318253339074516
1976,"WYOMING",0,85721,66147,151868,"TENO RONCALIO","LARRY HART","Democrat",0.564444122527458,19574,151868,0.128888245054916
1978,"ALABAMA",1,40450,71711,112161,"L W NOONAN","JACK EDWARDS","Republican",0.639357709007587,-31261,112161,-0.278715418015175
1978,"ALABAMA",2,49341,57924,107265,"WENDELL MITCHELL","WILLIAM L ""BILL"" DICKINSON","Republican",0.540008390434904,-8583,107265,-0.0800167808698084
1978,"ALABAMA",6,40771,65700,106471,"DON HAWKINS","JOHN H BUCHANAN JR","Republican",0.617069436748035,-24929,106471,-0.234138873496069
1978,"ALABAMA",7,77742,1841,82868,"RICHARD C SHELBY","JIM SCRUGGS","Democrat",0.938142588212579,75901,79583,0.953733837628639
1978,"ALASKA",0,55176,68811,124187,"PATRICK RODEY","DON YOUNG","Republican",0.554091813152745,-13635,123987,-0.109971206658763
1978,"ARIZONA",1,33178,81108,114286,"KEN GRAVES","JOHN J RHODES","Republican",0.709693225766936,-47930,114286,-0.419386451533871
1978,"ARIZONA",2,67878,58697,129197,"MORRIS K UDALL","TOM RICHEY","Democrat",0.525383716340163,9181,126575,0.0725340707090658
1978,"ARIZONA",4,48661,90768,143836,"MICHAEL MCCORMICK","ELDON RUDD","Republican",0.631052031480297,-42107,139429,-0.301995997963121
1978,"ARKANSAS",2,62140,65285,127425,"BENTON DOUGLAS BRANDON JR","EDWIN R BETHUNE JR","Republican",0.512340592505395,-3145,127425,-0.0246811850107907
1978,"ARKANSAS",3,35748,130086,165834,"WILLIAM CURTIS MEARS","JOHN PAUL HAMMERSCHMIDT","Republican",0.784435037447086,-94338,165834,-0.568870074894171
1978,"CALIFORNIA",1,125122,85690,210812,"HAROLD T JOHNSON","JAMES E TAYLOR","Democrat",0.593524087812838,39432,210812,0.187048175625676
1978,"CALIFORNIA",2,99712,114451,220260,"NORMA BORK","DON H CLAUSEN","Republican",0.5196177245074,-14739,214163,-0.0688214117284498
1978,"CALIFORNIA",3,105537,91966,197503,"ROBERT T MATSUI","SANDY SMOLEY","Democrat",0.534356440155339,13571,197503,0.0687128803106788
1978,"CALIFORNIA",4,87764,70733,158497,"VIC FAZIO","REX HIME","Democrat",0.553726568957141,17031,158497,0.107453137914282
1978,"CALIFORNIA",5,106046,52603,158649,"JOHN L BURTON","DOLORES SKORE","Democrat",0.668431569061261,53443,158649,0.336863138122522
1978,"CALIFORNIA",6,81801,33515,119768,"PHILLIP BURTON","TOM SPINOSA","Democrat",0.682995457885245,48286,115316,0.418727670054459
1978,"CALIFORNIA",7,109676,58332,172865,"GEORGE MILLER","PAULA GORDON","Democrat",0.634460417088479,51344,168008,0.305604495024046
1978,"CALIFORNIA",8,94824,70481,165305,"RONALD V DELLUMS","CHARLES V HUGHES","Democrat",0.573630561688999,24343,165305,0.147261123377998
1978,"CALIFORNIA",9,88179,41138,134879,"FORTNEY H STARK JR","ROBERT S ALLEN","Democrat",0.653763743799998,47041,129317,0.363765011560738
1978,"CALIFORNIA",10,84488,41374,125862,"DON EDWARDS","RUDY HANSEN","Democrat",0.671274888369802,43114,125862,0.342549776739604
1978,"CALIFORNIA",11,92882,54621,153464,"LEO J RYAN","DAVE WELCH","Democrat",0.605236407235573,38261,147503,0.259391334413537
1978,"CALIFORNIA",12,34472,116982,160085,"KIRSTEN OLSEN","PAUL N MCCLOSKEY JR","Republican",0.730749289439985,-82510,151454,-0.544785875579384
1978,"CALIFORNIA",13,100809,69306,175361,"NORMAN Y MINETA","DAN O'KEEFE","Democrat",0.574865563038532,31503,170115,0.18518649149105
1978,"CALIFORNIA",14,76602,95962,179727,"JOHN J MCFALL","NORMAN D SHUMWAY","Republican",0.533932019117884,-19360,172564,-0.112190259845622
1978,"CALIFORNIA",15,75212,49914,125126,"TONY COELHO","CHRIS PATTERAKIS","Democrat",0.601090101178013,25298,125126,0.202180202356025
1978,"CALIFORNIA",16,104550,65808,170358,"LEON E PANETTA","ERIC SEASTRAND","Democrat",0.613707603986898,38742,170358,0.227415207973796
1978,"CALIFORNIA",17,67885,81296,149181,"JOHN KREBS","CHARLES PASHAYAN JR","Republican",0.544948753527594,-13411,149181,-0.089897507055188
1978,"CALIFORNIA",18,58900,85663,144563,"BOB SOGGE","WILLIAM M THOMAS","Republican",0.59256517919523,-26763,144563,-0.18513035839046
1978,"CALIFORNIA",19,41672,123192,171751,"JERRY ZAMOS","ROBERT J LAGOMARSINO","Republican",0.717270932920332,-81520,164864,-0.494468167701863
1978,"CALIFORNIA",20,65695,129714,195409,"PAT LEAR","BARRY M GOLDWATER","Republican",0.663807705888675,-64019,195409,-0.327615411777349
1978,"CALIFORNIA",21,73869,44519,124138,"JAMES C CORMAN","ROD WALSH","Democrat",0.595055502746943,29350,118388,0.247913639895935
1978,"CALIFORNIA",22,54442,99502,153944,"ROBERT S HENRY","CARLOS J MOORHEAD","Republican",0.646351920178766,-45060,153944,-0.292703840357533
1978,"CALIFORNIA",23,117498,61496,178994,"ANTHONY C BEILENSON","JOSEPH BARBARA","Democrat",0.656435411242835,56002,178994,0.31287082248567
1978,"CALIFORNIA",24,85075,44243,135771,"HENRY A WAXMAN","HOWARD G SCHAEFER","Democrat",0.626606565466852,40832,129318,0.315748774339226
1978,"CALIFORNIA",25,45881,22205,68086,"EDWARD R ROYBAL","ROBERT K WATSON","Democrat",0.673868342977998,23676,68086,0.347736685955997
1978,"CALIFORNIA",27,85880,89392,175272,"CAREY PEEK","ROBERT K DORNAN","Republican",0.510018713770597,-3512,175272,-0.0200374275411931
1978,"CALIFORNIA",29,65214,11512,76726,"AUGUSTUS G HAWKINS","URIAH J FIELDS","Democrat",0.849959596486198,53702,76726,0.699919192972395
1978,"CALIFORNIA",30,66241,26511,92752,"GEORGE E DANIELSON","HENRY ARES","Democrat",0.714173279282387,39730,92752,0.428346558564775
1978,"CALIFORNIA",31,55667,26490,82157,"CHARLES H WILSON","DON GRIMSHAW","Democrat",0.677568557761359,29177,82157,0.355137115522719
1978,"CALIFORNIA",32,74004,23242,103609,"GLENN M ANDERSON","SONYA MATHISON","Democrat",0.714262274512832,50762,97246,0.521995763321885
1978,"CALIFORNIA",33,62540,79533,142073,"DENNIS S KAZARIAN","WAYNE GRISHAM","Republican",0.559803762854307,-16993,142073,-0.119607525708615
1978,"CALIFORNIA",34,73608,90554,168572,"MARK HANNAFORD","DAN LUNGREN","Republican",0.537182924803645,-16946,164162,-0.103227299862331
1978,"CALIFORNIA",35,80388,68442,148830,"JIM LLOYD","DAVID DREIER","Democrat",0.540133037694013,11946,148830,0.0802660753880266
1978,"CALIFORNIA",36,80448,47417,127865,"GEORGE E BROWN JR","DANA WARREN CARMODY","Democrat",0.62916357095374,33031,127865,0.258327141907481
1978,"CALIFORNIA",37,60463,106581,173588,"DAN CORCORAN","JERRY LEWIS","Republican",0.613988294121714,-46118,167044,-0.276082948205263
1978,"CALIFORNIA",38,75471,53298,128769,"JERRY M PATTERSON","DAN GOEDEKE","Democrat",0.586096032430166,22173,128769,0.172192064860331
1978,"CALIFORNIA",39,63891,112160,176051,"WILLIAM E FARRIS","WILLIAM E DANNEMEYER","Republican",0.637088116511693,-48269,176051,-0.274176233023385
1978,"CALIFORNIA",40,76358,147882,224240,"JIM MCGUY","ROBERT E BADHAM","Republican",0.659480913307171,-71524,224240,-0.318961826614342
1978,"CALIFORNIA",41,77540,107685,185225,"KING GOLDEN JR","BOB WILSON","Republican",0.581374004589013,-30145,185225,-0.162748009178027
1978,"CALIFORNIA",42,85126,30319,115445,"LIONEL VAN DEERLIN","LAWRENCE C MATTERA","Democrat",0.737372774914461,54807,115445,0.474745549828923
1978,"CALIFORNIA",43,76308,167150,243458,"RUBEN B BROOKS","CLAIR W BURGENER","Republican",0.686566060675763,-90842,243458,-0.373132121351527
1978,"COLORADO",1,82742,49845,134630,"PAT SCHROEDER","GENE HUTCHESON","Democrat",0.614588130431553,32897,132587,0.248116331163689
1978,"COLORADO",2,98889,88072,186961,"TIM WIRTH","ED SCOTT","Democrat",0.528928493108188,10817,186961,0.0578569862163767
1978,"COLORADO",3,69669,69303,141442,"RAY KOGOVSEK","HAROLD L MCCORMICK","Democrat",0.492562322365351,366,138972,0.00263362403937484
1978,"COLORADO",4,65421,103121,168542,"MORGAN SMITH","JAMES P ""JIM"" JOHNSON","Republican",0.611841558780601,-37700,168542,-0.223683117561201
1978,"COLORADO",5,52914,91933,153780,"GERRY FRANK","KEN KRAMER","Republican",0.597821563272207,-39019,144847,-0.26938079490773
1978,"CONNECTICUT",1,102749,67828,172564,"WILLIAM R COTTER","BEN F ANDREWS JR","Democrat",0.595425465334601,34921,170577,0.204722793811592
1978,"CONNECTICUT",2,116624,50167,166814,"CHRISTOPHER J DODD","THOMAS HUDSON CONNELL","Democrat",0.699125972640186,66457,166791,0.398444760208884
1978,"CONNECTICUT",3,96830,66663,166587,"ROBERT N GIAIMO","JOHN G PUCCIANO","Democrat",0.581257841248117,30167,163493,0.184515545008043
1978,"CONNECTICUT",4,59918,83990,143919,"MICHAEL G MORGAN","STEWART B MCKINNEY","Republican",0.583592159478596,-24072,143908,-0.167273535870139
1978,"CONNECTICUT",5,96738,88162,184913,"WILLIAM R RATCHFORD","GEORGE C GUIDERA","Democrat",0.52315413194313,8576,184900,0.0463818280151433
1978,"CONNECTICUT",6,119537,66664,186224,"ANTHONY TOBY MOFFETT","DANIEL F MACKINNON","Democrat",0.641899003350803,52873,186201,0.283956584551103
1978,"DELAWARE",0,64863,91689,157566,"GARY E HINDES","THOMAS B EVANS JR","Republican",0.581908533566886,-26826,156552,-0.171355204660432
1978,"FLORIDA",1,85608,49715,135323,"EARL DEWITT HUTTO","WARREN BRIGGS","Democrat",0.632619732048506,35893,135323,0.265239464097012
1978,"FLORIDA",2,112649,25148,137797,"DON FUQUA","PETE BRATHWAITE","Democrat",0.817499655290028,87501,137797,0.634999310580056
1978,"FLORIDA",4,113302,41647,154949,"BILL CHAPPELL JR","TOM BONEY","Democrat",0.731221240537209,71655,154949,0.462442481074418
1978,"FLORIDA",5,101867,106319,208186,"DAVID RYAN BEST","RICHARD KELLY","Republican",0.51069236163815,-4452,208186,-0.021384723276301
1978,"FLORIDA",6,40654,150694,191348,"JIM CHRISTISON","C W BILL YOUNG","Republican",0.787538934297719,-110040,191348,-0.575077868595439
1978,"FLORIDA",9,89543,56074,145617,"BILL NELSON","EDWARD J GURNEY","Democrat",0.614921334734269,33469,145617,0.229842669468537
1978,"FLORIDA",11,123346,99757,223103,"DAN MICA","BILL JAMES","Democrat",0.552865716731734,23589,223103,0.105731433463468
1978,"FLORIDA",12,107037,66610,173647,"EDWARD J STACK","J HERBERT BURKE","Democrat",0.616405696614396,40427,173647,0.232811393228792
1978,"FLORIDA",14,65202,38081,103283,"CLAUDE PEPPER","AL CARDENAS","Democrat",0.631294598336609,27121,103283,0.262589196673218
1978,"FLORIDA",15,108837,37897,146734,"DANTE B FASCELL","HERBERT J HOODWIN","Democrat",0.741729933076179,70940,146734,0.483459866152357
1978,"GEORGIA",4,60284,14221,74513,"ELLIOTT H LEVITAS","HOMER CHEUNG","Democrat",0.809040033282783,46063,74505,0.61825380846923
1978,"GEORGIA",5,52739,17132,69875,"WYCHE FOWLER JR","THOMAS P BOWLES JR","Democrat",0.754762075134168,35607,69871,0.509610568046829
1978,"GEORGIA",6,39451,47078,86540,"VIRGINIA SHAPARD","NEWTON LEROY GINGRICH","Republican",0.54400277328403,-7627,86529,-0.0881438592841706
1978,"GEORGIA",7,47090,23698,70826,"LARRY P MCDONALD","EARNEST NORSWORTHY","Democrat",0.664868833479231,23392,70788,0.33045148895293
1978,"GEORGIA",9,47264,14172,61437,"ED JENKINS","DAVID G ASHWORTH","Democrat",0.769308397219916,33092,61436,0.538641838661371
1978,"HAWAII",1,84552,24470,115412,"CECIL ""CEE"" HEFTEL","WILLIAM D SPILLANE","Democrat",0.732610127196479,60082,109022,0.551099778026453
1978,"HAWAII",2,118272,15697,137957,"DANIEL K AKAKA","CHARLIE ISAAK","Democrat",0.857310611277427,102575,133969,0.765662205435586
1978,"IDAHO",1,57972,86680,144652,"ROY TRUBY","STEVEN D SYMMS","Republican",0.5992312584686,-28708,144652,-0.198462516937201
1978,"IDAHO",2,60040,80591,140631,"STAN KRESS","GEORGE HANSEN","Republican",0.573067104692422,-20551,140631,-0.146134209384844
1978,"ILLINOIS",1,47581,33540,81279,"BENNETT M STEWART","A A RAYNER","Democrat",0.585403363722487,14041,81121,0.173087116776174
1978,"ILLINOIS",2,80906,11104,94077,"MORGAN F MURPHY","JAMES P WOGNUM","Democrat",0.859997661490056,69802,92010,0.758634930985762
1978,"ILLINOIS",3,95701,51098,146800,"MARTIN A RUSSO","ROBERT L DUNNE","Democrat",0.65191416893733,44603,146799,0.303837219599589
1978,"ILLINOIS",4,46788,94435,141229,"ANDREW THOMAS","EDWARD J DERWINSKI","Republican",0.668665783939559,-47647,141223,-0.337388385744532
1978,"ILLINOIS",5,98702,18802,117506,"JOHN G FARY","JOSEPH A BARRACCA","Democrat",0.839974128980648,79900,117504,0.679976851851852
1978,"ILLINOIS",6,44543,87193,131737,"JEANNE P QUINN","HENRY J HYDE","Republican",0.661871759642318,-42650,131736,-0.323753567741544
1978,"ILLINOIS",7,64716,10273,74989,"CARDISS COLLINS","JAMES C HOLT","Democrat",0.863006574297564,54443,74989,0.726013148595127
1978,"ILLINOIS",8,81457,13302,94762,"DAN ROSTENKOWSKI","CARL C LODICO","Democrat",0.859595618496866,68155,94759,0.719245665319389
1978,"ILLINOIS",9,87543,28673,116217,"SIDNEY R YATES","JOHN M COLLINS","Democrat",0.753271896538372,58870,116216,0.506556756384663
1978,"ILLINOIS",10,89479,88829,178309,"ABNER J MIKVA","JOHN E PORTER","Democrat",0.501819874487547,650,178308,0.00364537766112569
1978,"ILLINOIS",11,112365,40044,152412,"FRANK ANNUNZIO","JOHN HOEGER","Democrat",0.737245098811117,72321,152409,0.474519221305828
1978,"ILLINOIS",12,28424,110503,138935,"GILBERT BOGEN","PHILIP M CRANE","Republican",0.79535754129629,-82079,138927,-0.590806682646282
1978,"ILLINOIS",13,40675,64060,104738,"FREDERICK J STEFFEN","ROBERT M MCCLORY","Republican",0.611621379060131,-23385,104735,-0.223277796343152
1978,"ILLINOIS",14,39438,118741,158179,"JAMES A ROMANYAK","JOHN N ERLENBORN","Republican",0.750674868345356,-79303,158179,-0.501349736690711
1978,"ILLINOIS",15,48756,80856,129612,"TIM L HALL","TOM CORCORAN","Republican",0.623831126747523,-32100,129612,-0.247662253495047
1978,"ILLINOIS",16,40471,76752,117309,"ERNEST W DAHLIN","JOHN B ANDERSON","Republican",0.654272050737795,-36281,117223,-0.309504107555684
1978,"ILLINOIS",17,39260,94375,133635,"CLIFFORD J SINCLAIR","GEORGE M O'BRIEN","Republican",0.706214689265537,-55115,133635,-0.412429378531073
1978,"ILLINOIS",18,44527,85973,130514,"VIRGIL R GRUNKMEYER","ROBERT H MICHEL","Republican",0.658726266913894,-41446,130500,-0.317593869731801
1978,"ILLINOIS",20,48426,111054,159480,"VICTOR ROBERTS","PAUL FINDLEY","Republican",0.696350639578631,-62628,159480,-0.392701279157261
1978,"ILLINOIS",21,27054,97473,124527,"KEN BAUGHMAN","EDWARD R MADIGAN","Republican",0.782745910525428,-70419,124527,-0.565491821050856
1978,"ILLINOIS",22,73331,86051,159383,"TERRY L BRUCE","DANIEL B CRANE","Republican",0.539900742237252,-12720,159382,-0.07980825940194
1978,"ILLINOIS",23,74247,25858,100105,"MELVIN PRICE","DANIEL J STACK","Democrat",0.741691224214575,48389,100105,0.483382448429149
1978,"ILLINOIS",24,110298,57763,168061,"PAUL SIMON","JOHN T ANDERSON","Democrat",0.656297415819256,52535,168061,0.312594831638512
1978,"INDIANA",1,72367,17419,90170,"ADAM BENJAMIN JR","OWEN W CRUMPACKER","Democrat",0.802561827658867,54948,89786,0.611988506003163
1978,"INDIANA",2,82402,52842,145778,"FLOYD J FITHIAN","JAY PHILIP OPPENHEIM","Democrat",0.565256760279329,29560,135244,0.218567921682293
1978,"INDIANA",3,64336,50145,115862,"JOHN BRADEMAS","THOMAS L THORSON","Democrat",0.555281282905526,14191,114481,0.123959434316611
1978,"INDIANA",4,42238,80527,125117,"JOHN D WALDA","DAN QUAYLE","Republican",0.643613577691281,-38289,122765,-0.311888567588482
1978,"INDIANA",5,45479,94950,140429,"MAX ERVIN HEISS","ELWOOD H HILLIS","Republican",0.676142392240919,-49471,140429,-0.352284784481838
1978,"INDIANA",6,66421,60630,127282,"DAVID W EVANS","DAVID G CRANE","Democrat",0.521841265850631,5791,127051,0.0455801213685843
1978,"INDIANA",7,67469,86955,154424,"CHARLOTTE T ZIETLOW","JOHN T MYERS","Republican",0.56309252447806,-19486,154424,-0.126185048956121
1978,"INDIANA",8,76654,83019,159673,"DAVID L CORNWELL","H JOEL DECKARD","Republican",0.51993135971642,-6365,159673,-0.0398627194328409
1978,"INDIANA",9,99727,52218,151945,"LEE H HAMILTON","FRANK I HAMILTON JR","Democrat",0.656336174273586,47509,151945,0.312672348547172
1978,"INDIANA",10,73343,55999,130742,"PHILIP R SHARP","WILLIAM GOULD FRAZIER","Democrat",0.560975050098668,17344,129342,0.134094107095916
1978,"INDIANA",11,61504,45809,107441,"ANDREW JACOBS JR","CHARLES E BOSMA","Democrat",0.572444411351346,15695,107313,0.146254414656193
1978,"IOWA",1,45037,79940,125955,"RICHARD E MYERS","JIM LEACH","Republican",0.63467111269898,-34903,124977,-0.279275386671147
1978,"IOWA",2,65450,72644,138978,"MICHAEL T BLOUIN","THOMAS J TAUKE","Republican",0.522701434759458,-7194,138094,-0.0520949498167915
1978,"IOWA",3,34880,103659,138539,"JOHN KNUDSON","CHARLES E GRASSLEY","Republican",0.74822974036192,-68779,138539,-0.496459480723839
1978,"IOWA",4,88526,48308,136834,"NEAL SMITH","CHARLES E MINOR","Democrat",0.646959089115278,40218,136834,0.293918178230557
1978,"IOWA",5,82333,57377,139710,"TOM HARKIN","JULIAN B GARRETT","Democrat",0.589313578126118,24956,139710,0.178627156252237
1978,"IOWA",6,87139,44320,131459,"BERKLEY BEDELL","WILLIS EDGAR JUNKER","Democrat",0.662860663781103,42819,131459,0.325721327562206
1978,"KANSAS",2,70460,76419,146879,"MARTHA KEYS","JAMES E JEFFRIES","Republican",0.520285404993226,-5959,146879,-0.0405708099864514
1978,"KANSAS",4,100139,43854,143993,"DAN GLICKMAN","JAMES PAUL LITSEY","Democrat",0.695443528504858,56285,143993,0.390887057009716
1978,"KANSAS",5,62402,86011,150766,"DON ALLEGRUCCI","ROBERT ""BOB"" WHITTAKER","Republican",0.570493347306422,-23609,148413,-0.159076361235202
1978,"KENTUCKY",3,37346,17785,56871,"ROMANO L MAZZOLI","NORBERT DRUMMOND LEVERONNE","Democrat",0.656679151061174,19561,55131,0.354809453846293
1978,"KENTUCKY",4,32212,62087,94299,"GEORGE CLARKE MARTIN","M GENE SNYDER","Republican",0.65840570949851,-29875,94299,-0.31681141899702
1978,"KENTUCKY",5,15714,59743,75458,"JESSE M RAMEY","TIM LEE CARTER","Republican",0.791738450528771,-44029,75457,-0.58349788621334
1978,"KENTUCKY",6,47436,52092,102857,"CHARLES T EASTERLY","LARRY J HOPKINS","Republican",0.506450703403755,-4656,99528,-0.0467808054014951
1978,"KENTUCKY",7,51559,15861,67420,"CARL D PERKINS","GRANVILLE THOMAS","Democrat",0.764743399584693,35698,67420,0.529486799169386
1978,"LOUISIANA",4,65583,65317,130900,"CLAUDE ""BUDDY"" LEACH","JAMES HAMILTON WILSON","Democrat",0.501016042780749,266,130900,0.00203208556149733
1978,"MAINE",1,70348,120791,196485,"JOHN QUINN","DAVID F EMERY","Republican",0.614759396391582,-50443,191139,-0.263907418161652
1978,"MAINE",2,70691,87939,173037,"MARKHAM L GARTLEY","OLYMPIA J SNOWE","Republican",0.508209226928345,-17248,158630,-0.108731009266847
1978,"MARYLAND",1,46093,80202,126295,"JOSEPH D QUINN","ROBERT E BAUMAN","Republican",0.635037016508967,-34109,126295,-0.270074033017934
1978,"MARYLAND",2,98601,49886,148487,"CLARENCE D LONG","MALCOLM M MCKNIGHT","Democrat",0.664037929246331,48715,148487,0.328075858492663
1978,"MARYLAND",4,43663,71374,115037,"SUE F WARD","MARJORIE S HOLT","Republican",0.620443857193772,-27711,115037,-0.240887714387545
1978,"MARYLAND",5,64868,19160,84028,"GLADYS NOON SPELLMAN","SAUL J HARRIS","Democrat",0.771980768315323,45708,84028,0.543961536630647
1978,"MARYLAND",6,126196,14545,140741,"BEVERLY B BYRON","MELVIN PERKINS","Democrat",0.896654137742378,111651,140741,0.793308275484756
1978,"MARYLAND",8,81851,77807,159658,"MICHAEL D BARNES","NEWTON I STEERS JR","Democrat",0.512664570519485,4044,159658,0.0253291410389708
1978,"MASSACHUSETTS",2,101570,37881,139479,"EDWARD P BOLAND","THOMAS P SWANK","Democrat",0.728209981430896,63689,139451,0.45671239360062
1978,"MASSACHUSETTS",3,119337,39259,158730,"JOSEPH D EARLY","CHARLES K MACLEOD","Democrat",0.751823851823852,80078,158596,0.504918156826149
1978,"MASSACHUSETTS",5,90156,48685,172681,"JAMES M SHANNON","JOHN J BUCKLEY","Democrat",0.522095656152096,41471,138841,0.298694189756628
1978,"MASSACHUSETTS",6,97099,83511,180645,"NICHOLAS MAVROULES","WILLIAM E BRONSON","Democrat",0.537512801350715,13588,180610,0.0752339294612701
1978,"MASSACHUSETTS",8,102160,28566,136928,"THOMAS P O'NEILL JR","WILLIAM A BARNSTEAD","Democrat",0.746085534003272,73594,130726,0.562963756253538
1978,"MASSACHUSETTS",10,64868,102080,166957,"JOHN J MARINO","MARGARET HECKLER","Republican",0.611414915217691,-37212,166948,-0.222895751970674
1978,"MICHIGAN",1,89646,6878,96526,"JOHN CONYERS","ROBERT S ARNOLD","Democrat",0.928723867144604,82768,96524,0.857486221043471
1978,"MICHIGAN",2,45631,97503,144326,"EARL GREENE","CARL D PURSELL","Republican",0.675574740517994,-51872,143134,-0.362401665572121
1978,"MICHIGAN",3,83932,79572,163510,"HOWARD WOLPE","GARRY BROWN","Democrat",0.513314170387132,4360,163504,0.0266660142871122
1978,"MICHIGAN",4,38204,95440,135108,"MORGAN L HAGER JR","DAVE STOCKMAN","Republican",0.706397844687213,-57236,133644,-0.428272125946545
1978,"MICHIGAN",5,80622,81794,165446,"DALE ROBERT SPRIK","HAROLD S SAWYER","Republican",0.494384874823205,-1172,162416,-0.00721603782878534
1978,"MICHIGAN",6,97971,74718,172706,"BOB CARR","MICHAEL H CONLIN","Democrat",0.567270390142786,23253,172689,0.134652467731008
1978,"MICHIGAN",7,105402,29958,137540,"DALE E KILDEE","GALE M CRONK","Democrat",0.766337065580922,75444,135360,0.557358156028369
1978,"MICHIGAN",8,103346,51900,155248,"BOB TRAXLER","NORMAN R HUGHES","Democrat",0.665683293826652,51446,155246,0.331383739355603
1978,"MICHIGAN",9,53450,122363,175819,"HOWARD M LEROUX","GUY VANDER JAGT","Republican",0.695960049823967,-68913,175813,-0.391967601940698
1978,"MICHIGAN",10,94913,89451,184389,"DONALD JOSEPH ALBOSTA","ELFORD A CEDERBERG","Democrat",0.514743287289372,5462,184364,0.0296261743073485
1978,"MICHIGAN",11,79081,96351,175435,"KEITH MCLEOD","ROBERT W DAVIS","Republican",0.549211958845156,-17270,175432,-0.0984427014455743
1978,"MICHIGAN",12,82892,68063,150956,"DAVID E BONIOR","KIRBY HOLMES","Democrat",0.549113649010308,14829,150955,0.0982345732171839
1978,"MICHIGAN",13,44771,11749,56543,"CHARLES C DIGGS","DOVIE T PICKETT","Democrat",0.791804467396495,33022,56520,0.584253361641897
1978,"MICHIGAN",14,84032,40716,124756,"LUCIEN N NEDZI","JOHN EDWARD GETZ","Democrat",0.673570810221553,43316,124748,0.34722801167153
1978,"MICHIGAN",15,95137,23177,119545,"WILLIAM D FORD","EDGAR NIETEN","Democrat",0.795825839641976,71960,118314,0.608212045911726
1978,"MICHIGAN",16,93387,26827,122111,"JOHN D DINGELL","MELVIN E HEUER","Democrat",0.764771396516284,66560,120214,0.553679271964996
1978,"MICHIGAN",18,113037,36913,151798,"JAMES J BLANCHARD","ROBERT J SALLOUM","Democrat",0.744654079763897,76124,149950,0.507662554184728
1978,"MICHIGAN",19,47165,117122,164298,"BETTY F COLLIER","WILLIAM S BROOMFIELD","Republican",0.712863211968496,-69957,164287,-0.425821884872205
1978,"MINNESOTA",1,83271,110090,195929,"GERALD SIKORSKI","ARLEN ERDAHL","Republican",0.561887214245977,-26819,193361,-0.138699117195298
1978,"MINNESOTA",2,61173,145415,206588,"JOHN F CONSIDINE","TOM HAGEDORN","Republican",0.703888899645672,-84242,206588,-0.407777799291343
1978,"MINNESOTA",3,67120,128759,195879,"MICHAEL O FREEMAN","BILL FRENZEL","Republican",0.657339479985093,-61639,195879,-0.314678959970186
1978,"MINNESOTA",4,95989,69396,165385,"BRUCE F VENTO","JOHN BERG","Democrat",0.580397254890105,26593,165385,0.16079450978021
1978,"MINNESOTA",5,91673,55412,147087,"MARTIN OLAV SABO","MIKE TILL","Democrat",0.623256983961873,36261,147085,0.246530917496686
1978,"MINNESOTA",6,115880,93742,209632,"RICHARD NOLAN","RUSS BJORHUS","Democrat",0.552778201801252,22138,209622,0.105609144078389
1978,"MINNESOTA",7,93055,106573,206192,"GENE WENSTROM","ARLAN STANGELAND","Republican",0.516862923876775,-13518,199628,-0.0677159516701064
1978,"MISSISSIPPI",1,57358,26734,86151,"JAMIE L WHITTEN","TERRILL K MOFFETT","Democrat",0.665784494666342,30624,84092,0.364172572896352
1978,"MISSISSIPPI",2,57678,35730,93408,"DAVID BOWEN","M ROLAND BYRD","Democrat",0.617484583761562,21948,93408,0.234969167523124
1978,"MISSISSIPPI",3,101685,8408,110093,"G V ""SONNY"" MONTGOMERY","DOROTHY ELEANOR CLEVELAND","Democrat",0.923628205244657,93277,110093,0.847256410489314
1978,"MISSISSIPPI",4,34837,68225,132132,"JOHN HAMPTON STENNIS","JON CLIFTON HINSON","Republican",0.516339720885175,-33388,103062,-0.323960334555898
1978,"MISSOURI",1,65950,30995,99010,"WILLIAM ""BILL"" CLAY","BILL WHITE","Democrat",0.666094333905666,34955,96945,0.36056526896694
1978,"MISSOURI",2,102911,79495,182406,"ROBERT A YOUNG","BOB CHASE","Democrat",0.564186485093692,23416,182406,0.128372970187384
1978,"MISSOURI",3,121565,26881,148446,"RICHARD A GEPHARDT","LEE BUCHSCHACHER","Democrat",0.818917316734705,94684,148446,0.63783463346941
1978,"MISSOURI",4,120748,45116,165864,"IKE SKELTON","BILL BAKER","Democrat",0.72799401919645,75632,165864,0.4559880383929
1978,"MISSOURI",5,82140,30360,114131,"RICHARD BOLLING","STEVEN L WALTER","Democrat",0.719699292917787,51780,112500,0.460266666666667
1978,"MISSOURI",6,76061,96574,172635,"PHIL SNOWDEN","E THOMAS COLEMAN","Republican",0.559411475077476,-20513,172635,-0.118822950154951
1978,"MISSOURI",7,66351,104566,170917,"JIM THOMAS","GENE TAYLOR","Republican",0.611794028680588,-38215,170917,-0.223588057361175
1978,"MISSOURI",8,96509,63109,159618,"RICHARD H ICHORD","DONALD D MEYER","Democrat",0.60462479169016,33400,159618,0.209249583380321
1978,"MISSOURI",9,135170,45795,180965,"HAROLD L VOLKMER","JERRY DENT","Democrat",0.746940016025198,89375,180965,0.493880032050396
1978,"MISSOURI",10,99148,52687,151835,"BILL D BURLISON","JAMES A WEIR","Democrat",0.652998320545329,46461,151835,0.305996641090658
1978,"MONTANA",1,86016,64093,150109,"PAT WILLIAMS","JIM WALTERMIRE","Democrat",0.573023602848597,21923,150109,0.146047205697193
1978,"MONTANA",2,57480,75766,133246,"THOMAS G MONAHAN","RON MARLENEE","Republican",0.568617444426099,-18286,133246,-0.137234888852198
1978,"NEBRASKA",1,71311,99013,170324,"HESS DYAS","DOUGLAS K BEREUTER","Republican",0.581321481411897,-27702,170324,-0.162642962823795
1978,"NEBRASKA",2,77135,70309,147444,"JOHN J CAVANAUGH","HAROLD J DAUB JR","Democrat",0.523147771357261,6826,147444,0.0462955427145221
1978,"NEBRASKA",3,35371,141597,176968,"MARILYN FOWLER","VIRGINIA SMITH","Republican",0.800127706704037,-106226,176968,-0.600255413408074
1978,"NEVADA",0,132513,44425,182967,"JIM SANTINI","BILL O'MARA","Democrat",0.724245355719884,88088,176938,0.497846703365021
1978,"NEW HAMPSHIRE",1,82697,49131,134235,"NORMAN E D'AMOURS","DANIEL M HUGHES","Democrat",0.616061384884717,33566,131828,0.254619655915284
1978,"NEW HAMPSHIRE",2,39546,84535,124081,"EDGAR J HELMS","JAMES C CLEVELAND","Republican",0.681288835518734,-44989,124081,-0.362577671037467
1978,"NEW JERSEY",1,106096,26853,133620,"JAMES J FLORIO","ROBERT MARK DEITCH","Democrat",0.794012872324502,79243,132949,0.596040586992004
1978,"NEW JERSEY",2,112768,56997,169765,"WILLIAM J HUGHES","JAMES H BIGGS","Democrat",0.664259417429977,55771,169765,0.328518834859953
1978,"NEW JERSEY",3,83349,64730,148955,"JAMES J HOWARD","BRUCE G COE","Democrat",0.559558255849082,18619,148079,0.125736937715679
1978,"NEW JERSEY",4,69259,41833,113382,"FRANK THOMPSON JR","CHRISTOPHER H SMITH","Democrat",0.610846518847789,27426,111092,0.246876462751593
1978,"NEW JERSEY",5,38108,100739,138847,"JOHN T FAHY","MILLICENT H FENWICK","Republican",0.725539622750221,-62631,138847,-0.451079245500443
1978,"NEW JERSEY",6,56874,89446,148184,"W THOMAS MCGANN","EDWIN B FORSYTHE","Republican",0.603614425309075,-32572,146320,-0.222607982504101
1978,"NEW JERSEY",7,78358,69543,149118,"ANDREW MAGUIRE","MARGARET S ROUKEMA","Democrat",0.525476468300272,8815,147901,0.0596006788324623
1978,"NEW JERSEY",8,69496,23842,93338,"ROBERT A ROE","THOMAS MELANI","Democrat",0.744562771861407,45654,93338,0.489125543722814
1978,"NEW JERSEY",9,56888,73478,150155,"NICHOLAS S MASTORELLI","HAROLD C HOLLENBECK","Republican",0.489347674070128,-16590,130366,-0.12725710691438
1978,"NEW JERSEY",10,55074,8066,63777,"PETER W RODINO JR","JOHN L PELT","Democrat",0.86354014770215,47008,63140,0.744504276211593
1978,"NEW JERSEY",11,88294,35642,125174,"JOSEPH G MINISH","JULIUS GEORGE FELD","Democrat",0.705370124786297,52652,123936,0.424832171443326
1978,"NEW JERSEY",12,34423,94850,129273,"RICHARD MCCORMACK","MATTHEW J RINALDO","Republican",0.73371856458812,-60427,129273,-0.467437129176239
1978,"NEW JERSEY",13,71808,77301,149109,"HELEN S MEYNER","JAMES A COURTER","Republican",0.518419411303141,-5493,149109,-0.0368388226062813
1978,"NEW JERSEY",14,67008,21355,105340,"FRANK J GUARINI","HENRY J HILL","Democrat",0.636111638503892,45653,88363,0.516652897706053
1978,"NEW JERSEY",15,55944,53108,115886,"EDWARD J PATTEN","CHARLES W WILEY","Democrat",0.482750289077197,2836,109052,0.0260059421193559
1978,"NEW MEXICO",1,70761,118075,188836,"ROBERT M HAWK","MANUEL LUJAN JR","Republican",0.625278019021797,-47314,188836,-0.250556038043593
1978,"NEW YORK",1,67180,75586,160204,"JOHN RANDOLPH","WILLIAM CARNEY","Republican",0.471810941050161,-8406,142766,-0.0588795651625737
1978,"NEW YORK",2,64807,43791,118129,"THOMAS J DOWNEY","HAROLD J WITHERS","Democrat",0.54861211048938,21016,108598,0.193521059319693
1978,"NEW YORK",3,70526,54509,138670,"JEROME A AMBRO","GREGORY W CARMAN","Democrat",0.508588735847696,16017,125035,0.12810013196305
1978,"NEW YORK",4,46508,80266,143302,"EVERETT A ROSENBLUM","NORMAN F LENT","Republican",0.560117793192,-33758,126774,-0.26628488491331
1978,"NEW YORK",5,56497,74279,145383,"JOHN W MATTHEWS","JOHN W WYDLER","Republican",0.510919433496351,-17782,130776,-0.135972961399645
1978,"NEW YORK",6,74741,44304,134606,"LESTER WOLFF","STUART L AIN","Democrat",0.555257566527495,30437,119045,0.255676424881347
1978,"NEW YORK",7,55985,13008,77001,"JOSEPH P ADDABBO","JOSEPH P ADDABBO","Democrat",0.727068479630135,42977,68993,0.622918267070572
1978,"NEW YORK",8,68971,15165,95202,"BENJAMIN S ROSENTHAL","ALBERT LEMISHOW","Democrat",0.724470074158106,53806,84136,0.639512218313207
1978,"NEW YORK",9,51350,32096,94787,"GERALDINE A FERRARO","ALFRED A DELLIBOVI","Democrat",0.541740956038275,19254,83446,0.230736044867339
1978,"NEW YORK",10,51682,23431,82061,"MARIO BIAGGI","MARIO BIAGGI","Democrat",0.629799783088191,28251,75113,0.376113322593958
1978,"NEW YORK",11,55880,11987,75203,"JAMES H SCHEUER","KENNETH HUHN","Democrat",0.743055463212904,43893,67867,0.646750261540955
1978,"NEW YORK",12,21406,3580,29277,"SHIRLEY CHISHOLM","CHARLES GIBBS","Democrat",0.731154148307545,17826,24986,0.713439526134635
1978,"NEW YORK",13,64514,12524,84839,"STEPHEN J SOLARZ","MAX CARASSO","Democrat",0.760428576480156,51990,77038,0.674861756535736
1978,"NEW YORK",14,29040,7516,40745,"FREDERICK W RICHMOND","ARTHUR BRAMWELL","Democrat",0.712725487789913,21524,36556,0.588795273005799
1978,"NEW YORK",15,42646,20508,72331,"LEO C ZEFERETTI","ROBERT P WHELAN","Democrat",0.589595056061716,22138,63154,0.350539949963581
1978,"NEW YORK",16,52855,9033,72890,"ELIZABETH HOLTZMAN","LARRY PENNER","Democrat",0.725133763204829,43822,61888,0.708085573940021
1978,"NEW YORK",17,54228,25068,99961,"JOHN M MURPHY","JOHN M PETERS","Democrat",0.542491571712968,29160,79296,0.36773607748184
1978,"NEW YORK",18,48196,57738,114301,"CARTER BURDEN","S WILLIAM GREEN","Republican",0.505139937533355,-9542,105934,-0.0900749523288085
1978,"NEW YORK",19,49344,5757,61991,"CHARLES B RANGEL","CHARLES B RANGEL","Democrat",0.795986514171412,43587,55101,0.79103827516742
1978,"NEW YORK",20,57452,11661,75936,"TED S WEISS","HARRY TORCZYNER","Democrat",0.756584492203961,45791,69113,0.662552631198183
1978,"NEW YORK",21,20769,1655,24449,"ROBERT GARCIA","ROBERT GARCIA","Democrat",0.849482596425212,19114,22424,0.852390296111309
1978,"NEW YORK",22,54110,8560,69837,"JONATHAN B BINGHAM","ANTHONY J GEIDEL JR","Democrat",0.774804186892335,45550,62670,0.726823041327589
1978,"NEW YORK",23,66354,49071,128572,"PETER A PEYSER","ANGELO MARTINELLI","Democrat",0.516084372958342,17283,115425,0.149733593242365
1978,"NEW YORK",24,75397,48863,134463,"RICHARD L OTTINGER","MICHAEL R EDELMAN","Democrat",0.560726742672706,26534,124260,0.213536133912764
1978,"NEW YORK",25,31213,114641,146533,"GUNARS M OZOLS","HAMILTON FISH JR","Republican",0.782356192802986,-83428,145854,-0.571996654188435
1978,"NEW YORK",26,39062,87059,139637,"CHARLES EMMET HOLBROOK","BENJAMIN A GILMAN","Republican",0.62346655972271,-47997,126121,-0.380563110029258
1978,"NEW YORK",27,83413,60474,149590,"MATTHEW F MCHUGH","NEIL TYLER WALLACE","Democrat",0.557610802861154,22939,143887,0.159423714442583
1978,"NEW YORK",28,139575,33112,182945,"SAMUEL S STRATTON","PAUL H TOCKER","Democrat",0.76293421520129,106463,172687,0.616508480661544
1978,"NEW YORK",29,80512,90572,184223,"EDWARD PATTISON","GERALD B H SOLOMON","Republican",0.49164328015503,-10060,171084,-0.0588015243973721
1978,"NEW YORK",30,52455,79502,141263,"NORMA BARTLE","ROBERT C MCEWEN","Republican",0.562794220708891,-27047,131957,-0.204968285123184
1978,"NEW YORK",32,76251,60687,145471,"JAMES M HANLEY","PETER DEL GIORNO","Democrat",0.524166328684068,15564,136938,0.113657275555361
1978,"NEW YORK",33,58286,82501,147454,"ROY A BERNARDI","GARY A LEE","Republican",0.559503302724918,-24215,140787,-0.171997414534012
1978,"NEW YORK",34,60704,62081,140912,"FRANK HORTON","FRANK HORTON","Republican",0.440565743158851,-1377,122785,-0.0112147249256831
1978,"NEW YORK",35,36428,96119,138593,"FRANCIS C REPICCI","BARBER B CONABLE","Republican",0.693534305484404,-59691,132547,-0.450338370540261
1978,"NEW YORK",36,95613,30964,134257,"JOHN J LAFALCE","FRANCINA JOYCE CARTONIA","Democrat",0.712163984000834,64649,126577,0.510748398208205
1978,"NEW YORK",37,67475,17585,90271,"HENRY J NOWAK","CHARLES POTH III","Democrat",0.747471502475878,49890,85060,0.586527157300729
1978,"NEW YORK",39,79385,52378,135816,"STANLEY N LUNDINE","CRISPIN MAGUIRE","Democrat",0.584504034870707,27007,131763,0.204966492869774
1978,"NORTH CAROLINA",1,67716,16814,84530,"WALTER JONES","JAMES MILFORD NEWCOMB","Democrat",0.801088370992547,50902,84530,0.602176741985094
1978,"NORTH CAROLINA",2,61851,15988,79053,"L H FOUNTAIN","BARRY LYNN GARDNER","Democrat",0.782399149937384,45863,77839,0.589203355644343
1978,"NORTH CAROLINA",3,54452,22150,76602,"CHARLES WHITELY","WILLARD JACKSON BLANCHARD","Democrat",0.710843058927965,32302,76602,0.421686117855931
1978,"NORTH CAROLINA",5,68778,58161,126939,"STEPHEN L NEAL","HAMILTON C HORTON","Democrat",0.541819299033394,10617,126939,0.083638598066788
1978,"NORTH CAROLINA",6,58193,26882,85075,"RICHARDSON PREYER","GEORGE H BEMUS","Democrat",0.684019982368498,31311,85075,0.368039964736997
1978,"NORTH CAROLINA",7,53696,23146,76842,"CHARLES ROSE","RAYMOND SCHRUMP","Democrat",0.698784518882903,30550,76842,0.397569037765805
1978,"NORTH CAROLINA",8,63168,43942,107110,"W G ""BILL"" HEFNER","ROGER LEE AUSTIN","Democrat",0.589748856315937,19226,107110,0.179497712631874
1978,"NORTH CAROLINA",9,29761,66157,96824,"CHARLES KIMBALL MAXWELL","JAMES G MARTIN","Republican",0.683270676691729,-36396,95918,-0.379449112783836
1978,"NORTH CAROLINA",11,75460,65832,141292,"LAMAR GUDGER","R CURTIS RATCLIFF","Democrat",0.534071284998443,9628,141292,0.0681425699968859
1978,"NORTH DAKOTA",0,68016,147712,220314,"BRUCE F HAGEN","MARK ANDREWS","Republican",0.670461250760279,-79696,215728,-0.369428168805162
1978,"OHIO",1,38669,73593,114169,"TIMOTHY M BURKE","WILLIS D GRADISON JR","Republican",0.644597044731932,-34924,112262,-0.311093691542998
1978,"OHIO",2,64522,58716,123238,"THOMAS A LUKEN","STANLEY J ARONOFF","Democrat",0.523556046024765,5806,123238,0.0471120920495302
1978,"OHIO",3,62849,51833,116804,"TONY P HALL","DUDLEY P KIRCHER","Democrat",0.538072326290196,11016,114682,0.0960569226208123
1978,"OHIO",4,39360,85575,124935,"JOHN WILLIAM GRIFFIN","TENNYSON GUYER","Republican",0.68495617721215,-46215,124935,-0.369912354424301
1978,"OHIO",5,51071,85547,136618,"JAMES ROBERT SHEREK","DELBERT LATTA","Republican",0.626176638510299,-34476,136618,-0.252353277020598
1978,"OHIO",6,46318,85592,131910,"TED STRICKLAND","WILLIAM H HARSHA","Republican",0.648866651504814,-39274,131910,-0.297733303009628
1978,"OHIO",8,32493,81156,113652,"LUELLA R SCHROEDER","THOMAS N KINDNESS","Republican",0.714074543342836,-48663,113649,-0.428186785629438
1978,"OHIO",9,71709,34326,113128,"THOMAS LUDLOW ASHLEY","JOHN C HOYT","Democrat",0.63387490276501,37383,106035,0.352553402178526
1978,"OHIO",10,35039,99329,134368,"JAMES A PLUMMER","CLARENCE E MILLER","Republican",0.739231066920695,-64290,134368,-0.478462133841391
1978,"OHIO",11,37131,89327,131181,"PATRICK JAMES DONLIN","J WILLIAM STANTON","Republican",0.680944648996425,-52196,126458,-0.41275364152525
1978,"OHIO",12,61698,81573,143271,"JAMES L BAUMANN","SAMUEL L DEVINE","Republican",0.569361559561949,-19875,143271,-0.138723119123898
1978,"OHIO",13,80875,43269,124144,"DONALD J PEASE","MARK W WHITFIELD","Democrat",0.651461206341023,37606,124144,0.302922412682047
1978,"OHIO",14,82356,31311,113667,"JOHN F SEIBERLING","WALTER J VOGEL","Democrat",0.724537464699517,51045,113667,0.449074929399034
1978,"OHIO",15,37000,91023,128023,"HENRY W ECKHART","CHALMERS P WYLIE","Republican",0.710989431586512,-54023,128023,-0.421978863173024
1978,"OHIO",16,29640,105152,134792,"OWEN S HAND JR","RALPH S REGULA","Republican",0.780105644251884,-75512,134792,-0.560211288503769
1978,"OHIO",17,42117,87010,129127,"KENNETH ROBERT GRIER","JOHN M ASHBROOK","Republican",0.673832738311894,-44893,129127,-0.347665476623789
1978,"OHIO",18,71894,48931,120825,"DOUGLAS APPLEGATE","WILLIAM J RESS","Democrat",0.59502586385268,22963,120825,0.190051727705359
1978,"OHIO",19,69977,71890,141867,"CHARLES J CARNEY","LYLE WILLIAMS","Republican",0.506742230398895,-1913,141867,-0.0134844607977895
1978,"OHIO",21,58934,9533,68467,"LOUIS STOKES","BILL MACK","Democrat",0.860765040092307,49401,68467,0.721530080184615
1978,"OHIO",22,87551,30930,132572,"CHARLES A VANIK","RICHARD W SANDER","Democrat",0.660403403433606,56621,118481,0.477890969860146
1978,"OHIO",23,99975,33732,133707,"RONALD M MOTTL","HOMER S TAFT","Democrat",0.747717023042922,66243,133707,0.495434046085844
1978,"OKLAHOMA",1,73886,49404,123290,"JAMES R JONES","PAULA UNRUH","Democrat",0.599286235704437,24482,123290,0.198572471408873
1978,"OKLAHOMA",2,72583,59853,132436,"MICHAEL LYNN SYNAR","GARY RICHARDSON","Democrat",0.548060950194811,12730,132436,0.0961219003896222
1978,"OKLAHOMA",4,62993,41421,104414,"TOM STEED","SEWARD ELIOT ROBB","Democrat",0.60330032371138,21572,104414,0.206600647422759
1978,"OKLAHOMA",5,17978,71451,89429,"JESSE DENNIS KNIPP","MICKEY EDWARDS","Republican",0.79896901452549,-53473,89429,-0.597938029050979
1978,"OKLAHOMA",6,103512,36031,139543,"GLENN ENGLISH","HAROLD V HUNTER","Democrat",0.74179285238242,67481,139543,0.48358570476484
1978,"OREGON",1,158706,93640,252378,"LES AUCOIN","NICK BUNICK","Democrat",0.6288424506098,65066,252346,0.257844388260563
1978,"OREGON",2,152099,67547,220019,"AL ULLMAN","TERRY L HICKS","Democrat",0.691299387780146,84552,219646,0.384946686941715
1978,"OREGON",4,124745,96953,221766,"JAMES WEAVER","JERRY LAUSMANN","Democrat",0.562507327543447,27792,221698,0.125359723587944
1978,"PENNSYLVANIA",1,104412,37913,145162,"MICHAEL MYERS","SAMUEL N FANELLI","Democrat",0.719279150190821,66499,142325,0.467233444581064
1978,"PENNSYLVANIA",2,132594,25785,161759,"WILLIAM H GRAY III","ROLAND J ATKINS","Democrat",0.819700913086753,106809,158379,0.674388650010418
1978,"PENNSYLVANIA",3,86015,33750,119765,"RAYMOND F LEDERER","RAYMOND S KAUFFMAN","Democrat",0.71819813802029,52265,119765,0.436396276040579
1978,"PENNSYLVANIA",4,87555,110445,198000,"JOSHUA EILBERG","CHARLES F DOUGHERTY","Republican",0.55780303030303,-22890,198000,-0.115606060606061
1978,"PENNSYLVANIA",5,36704,110565,147269,"MURRAY P ZEALOR","RICHARD T SCHULZE","Republican",0.750769000943851,-73861,147269,-0.501538001887702
1978,"PENNSYLVANIA",6,106431,37746,144177,"GUS YATRON","STEPHEN MAZUR","Democrat",0.738196799766953,68685,144177,0.476393599533906
1978,"PENNSYLVANIA",7,79771,78403,158714,"ROBERT W EDGAR","EUGENE DANIEL KANE","Democrat",0.502608465541792,1368,158174,0.00864870332671615
1978,"PENNSYLVANIA",8,89276,56776,146052,"PETER H KOSTMAYER","G ROGER BOWERS","Democrat",0.61126174239312,32500,146052,0.222523484786241
1978,"PENNSYLVANIA",9,33882,101151,135033,"BLAINE LEROY HAVICE JR","BUD SHUSTER","Republican",0.749083557352647,-67269,135033,-0.498167114705294
1978,"PENNSYLVANIA",10,35721,116003,151724,"GENE BASALYGA","JOSEPH M MCDADE","Republican",0.764565922332657,-80282,151724,-0.529131844665313
1978,"PENNSYLVANIA",11,61433,45335,106768,"DANIEL J FLOOD","ROBERT P HUDOCK","Democrat",0.5753877566312,16098,106768,0.150775513262401
1978,"PENNSYLVANIA",12,104216,47442,151658,"JOHN P MURTHA","LUTHER V ELKIN","Democrat",0.687177728837252,56774,151658,0.374355457674504
1978,"PENNSYLVANIA",13,47151,112711,159862,"ALAN BENDIX RUBENSTEIN","R LAWRENCE COUGHLIN","Republican",0.705051857226858,-65560,159862,-0.410103714453716
1978,"PENNSYLVANIA",14,68004,49992,119202,"WILLIAM S MOORHEAD","STAN THOMAS","Democrat",0.570493783661348,18012,117996,0.152649242347198
1978,"PENNSYLVANIA",15,58077,65986,124063,"FRED B ROONEY","DONALD LAWRENCE RITTER","Republican",0.53187493450908,-7909,124063,-0.0637498690181601
1978,"PENNSYLVANIA",16,27386,91910,119296,"CHARLES W BOOHAR","ROBERT S WALKER","Republican",0.770436561158798,-64524,119296,-0.540873122317597
1978,"PENNSYLVANIA",17,79234,53613,132847,"ALLEN E ERTEL","THOMAS RICHARD RIPPON","Democrat",0.596430480176444,25621,132847,0.192860960352887
1978,"PENNSYLVANIA",18,88299,65088,154671,"DOUG WALGREN","TED JACOB","Democrat",0.570882712337801,23211,153387,0.15132312386317
1978,"PENNSYLVANIA",19,28577,105424,134001,"RAJ KUMAR","WILLIAM F GOODLING","Republican",0.78674039745972,-76847,134001,-0.573480794919441
1978,"PENNSYLVANIA",20,97745,37745,135490,"JOSEPH M GAYDOS","KATHLEEN M MEYER","Democrat",0.721418554874898,60000,135490,0.442837109749797
1978,"PENNSYLVANIA",21,73712,65622,139334,"DONALD A BAILEY","ROBERT MILLER","Democrat",0.529030961574346,8090,139334,0.0580619231486931
1978,"PENNSYLVANIA",22,99559,39518,139077,"AUSTIN J MURPHY","MARILYN COYLE ECOFF","Democrat",0.715855245655284,60041,139077,0.431710491310569
1978,"PENNSYLVANIA",23,61657,73194,134851,"JOSEPH S AMMERMAN","WILLIAM F CLINGER JR","Republican",0.542776842589228,-11537,134851,-0.0855536851784562
1978,"PENNSYLVANIA",24,48894,87041,135935,"JOSEPH P VIGORITO","MARC L MARKS","Republican",0.640313385073748,-38147,135935,-0.280626770147497
1978,"PENNSYLVANIA",25,68293,62160,146948,"EUGENE V ATKINSON","TIM SHAFFER","Democrat",0.464742630046003,6133,130453,0.0470131005036297
1978,"RHODE ISLAND",1,86768,54912,141680,"FERNAND ST GERMAIN","JERRY SLOCUM","Democrat",0.612422360248447,31856,141680,0.224844720496894
1978,"RHODE ISLAND",2,87397,78725,166122,"EDWARD P BEARD","CLAUDINE CAMARADA SCHNEIDER","Democrat",0.52610129904528,8672,166122,0.05220259809056
1978,"SOUTH CAROLINA",1,65621,42994,108615,"MENDEL J DAVIS","C C WANNAMAKER","Democrat",0.604161487823965,22627,108615,0.208322975647931
1978,"SOUTH CAROLINA",2,52598,71032,123630,"JACK SOLOMON BASS","FLOYD D SPENCE","Republican",0.574553101997897,-18434,123630,-0.149106203995794
1978,"SOUTH CAROLINA",3,80968,17924,98892,"BUTLER DERRICK","ANTHONY PANUCCIO","Democrat",0.818751769607248,63044,98892,0.637503539214497
1978,"SOUTH CAROLINA",4,45357,51483,98531,"MAX M HELLER","CARROLL A CAMPBELL JR","Republican",0.522505607372299,-6126,96840,-0.0632589838909541
1978,"SOUTH DAKOTA",1,64683,64544,129227,"THOMAS A DASCHLE","LEO K THORSNESS","Democrat",0.500537813305269,139,129227,0.00107562661053805
1978,"SOUTH DAKOTA",2,55516,70780,126296,"ROBERT SAMUELSON","JAMES ABDNOR","Republican",0.560429467283208,-15264,126296,-0.120858934566415
1978,"TENNESSEE",1,50694,92143,142841,"WILLIAM GORDON BALL","JAMES QUILLEN","Republican",0.645073893349949,-41449,142837,-0.290183915932146
1978,"TENNESSEE",2,27745,125082,152833,"MARGARET FRANCIS","JOHN J DUNCAN","Republican",0.818422722841271,-97337,152827,-0.636909708363051
1978,"TENNESSEE",5,68608,47288,133608,"WILLIAM HILL BONER","WILLIAM DEAN GOODWIN","Democrat",0.513502185497874,21320,115896,0.183958031338441
1978,"TENNESSEE",6,38954,114630,153591,"C RONALD ARLINE","ROBIN BEARD","Republican",0.746332792937086,-75676,153584,-0.492733618085217
1978,"TENNESSEE",7,96863,36003,132866,"ED JONES","ROSS EARL COOK","Democrat",0.729027742236539,60860,132866,0.458055484473078
1978,"TENNESSEE",8,80776,33679,115917,"HAROLD E FORD","DUNCAN RAGSDALE","Democrat",0.696843431075683,47097,114455,0.411489231575728
1978,"TEXAS",1,73708,20700,94408,"SAM B HALL","FRED HUDSON","Democrat",0.780738920430472,53008,94408,0.561477840860944
1978,"TEXAS",2,66986,28584,95570,"CHARLES WILSON","JAMES H DILLION","Democrat",0.700910327508632,38402,95570,0.401820655017265
1978,"TEXAS",4,58336,36582,94918,"RAY ROBERTS","FRANK S GLENN","Democrat",0.614593649255147,21754,94918,0.229187298510293
1978,"TEXAS",5,35524,34672,70593,"JIM MATTOX","THOMAS W PAUKEN","Democrat",0.503222699134475,852,70196,0.0121374437289874
1978,"TEXAS",6,66025,35393,101418,"WILLIAM PHILIP GRAMM","WES MOWERY","Democrat",0.651018556863673,30632,101418,0.302037113727346
1978,"TEXAS",7,22415,128214,150629,"ROBERT LAURENCE HUTCHINGS","BILL ARCHER","Republican",0.851190673774638,-105799,150629,-0.702381347549277
1978,"TEXAS",8,39429,24673,64102,"ROBERT ECKHARDT","NICK GEARHART","Democrat",0.615097812860753,14756,64102,0.230195625721506
1978,"TEXAS",9,50792,29473,80265,"JACK BROOKS","RANDY EVANS","Democrat",0.63280383728898,21319,80265,0.265607674577961
1978,"TEXAS",10,94529,29328,123857,"JAMES J PICKLE","EMMETT LEROY HUDSPETH","Democrat",0.763210799551095,65201,123857,0.52642159910219
1978,"TEXAS",11,53354,49965,103319,"MARVIN LEATH","JACK BURGESS","Democrat",0.516400662027313,3389,103319,0.0328013240546269
1978,"TEXAS",12,46456,21364,67820,"JIM WRIGHT","CLAUDE K BROWN","Democrat",0.684989678560897,25092,67820,0.369979357121793
1978,"TEXAS",13,75271,25275,100546,"JACK HIGHTOWER","CLIFFORD ALVIN JONES","Democrat",0.748622521035148,49996,100546,0.497245042070296
1978,"TEXAS",14,63953,24325,88278,"JOE WYATT JR","JOY YATES","Democrat",0.724450032850767,39628,88278,0.448900065701534
1978,"TEXAS",15,54560,27853,82413,"E DE LA GARZA","ROBERT LENDOL MCDONALD","Democrat",0.662031475616711,26707,82413,0.324062951233422
1978,"TEXAS",16,53090,22743,75833,"RICHARD C WHITE","MICHAEL GIERE","Democrat",0.700090989410942,30347,75833,0.400181978821885
1978,"TEXAS",17,69030,32302,101332,"CHARLES W STENHOLM","BILLY L FISHER","Democrat",0.681226068764063,36728,101332,0.362452137528125
1978,"TEXAS",19,54729,48070,102799,"KENT HANCE","GEORGE BUSH","Democrat",0.532388447358437,6659,102799,0.0647768947168747
1978,"TEXAS",21,63501,84336,147837,"NELSON WILLIAM WOLFF","THOMAS G LOEFFLER","Republican",0.570466121471621,-20835,147837,-0.140932242943242
1978,"TEXAS",22,53443,54643,108086,"BOB GAMMAGE","RONALD E PAUL","Republican",0.50555113520715,-1200,108086,-0.0111022704142997
1978,"TEXAS",24,39201,33314,72515,"MARTIN FROST","LEO BERMAN","Democrat",0.540591601737572,5887,72515,0.0811832034751431
1978,"UTAH",1,93892,85028,183994,"GUN MCKAY","JED J RICHARDSON","Democrat",0.510299248888551,8864,178920,0.0495416946121171
1978,"UTAH",2,68899,121492,195166,"EDWIN BROWN FIRMAGE","DAN MARRIOTT","Republican",0.622505969277436,-52593,190391,-0.276236796907417
1978,"VERMONT",0,23228,90688,120502,"SARAH MARIE DIETZ","JAMES M JEFFORDS","Republican",0.752585019335779,-67460,113916,-0.592190737034306
1978,"VIRGINIA",1,34578,89158,123741,"LEWIS BURWELL PULLER","PAUL S TRIBLE JR","Republican",0.720521088402389,-54580,123736,-0.441100407318808
1978,"VIRGINIA",7,46950,84517,131476,"LEWIS PERLEY FICKETT JR","J KENNETH ROBINSON","Republican",0.642832151875627,-37567,131467,-0.285752318072216
1978,"VIRGINIA",8,56137,2632,111170,"HERBERT E HARRIS II","JOHN F HERRITY","Democrat",0.504965368354772,53505,58769,0.910428967653014
1978,"VIRGINIA",9,47367,76877,124254,"CHARLES CHAMP CLARK","WILLIAM C WAMPLER","Republican",0.618708452041785,-29510,124244,-0.237516499790734
1978,"VIRGINIA",10,70892,61981,132882,"JOSEPH L FISHER","FRANK R WOLF","Democrat",0.533495883565871,8911,132873,0.0670640385932432
1978,"WASHINGTON",1,52706,99942,156193,"JANICE NIEMI","JOEL PRITCHARD","Republican",0.63986222173849,-47236,152648,-0.309443949478539
1978,"WASHINGTON",2,70620,66793,137413,"ALLAN BYRON SWIFT","JOHN NANCE GARNER","Democrat",0.513925174474031,3827,137413,0.0278503489480617
1978,"WASHINGTON",3,82616,58270,140886,"DON BONKER","RICHARD H BENNETT SR","Democrat",0.586403191232628,24346,140886,0.172806382465256
1978,"WASHINGTON",4,85602,54389,139991,"MIKE MCCORMACK","SUSAN ROYLANCE","Democrat",0.611482166710717,31213,139991,0.222964333421434
1978,"WASHINGTON",5,77201,68761,160849,"THOMAS S FOLEY","DUANE ALTON","Democrat",0.479959465088375,8440,145962,0.0578232690700319
1978,"WASHINGTON",6,71057,43640,116740,"NORMAN N DICKS","JAMES EDWARD BEAVER","Democrat",0.608677402775398,27417,114697,0.239038510161556
1978,"WASHINGTON",7,67450,59052,126502,"MICHAEL E LOWRY","JOHN E CUNNINGHAM","Democrat",0.533193151096425,8398,126502,0.0663863021928507
1978,"WEST VIRGINIA",1,76372,44062,120434,"ROBERT H MOLLOHAN","GENE A HAYNES","Democrat",0.634139860836641,32310,120434,0.268279721673282
1978,"WEST VIRGINIA",2,69683,56272,125955,"HARLEY O STAGGERS","CLEVELAND KEITH BENEDICT","Democrat",0.553237267277996,13411,125955,0.106474534555992
1978,"WEST VIRGINIA",3,74837,51584,126421,"JOHN M SLACK","DAVID MICHAEL STATON","Democrat",0.591966524548928,23253,126421,0.183933049097856
1978,"WISCONSIN",1,77146,64437,141585,"LES ASPIN","WILLIAM WATSON PETRIE III","Democrat",0.544874103895187,12709,141583,0.0897636015623345
1978,"WISCONSIN",2,99631,71412,172762,"ROBERT W KASTENMEIER","JAMES A WRIGHT","Democrat",0.576695106562786,28219,171043,0.164981905134966
1978,"WISCONSIN",3,96326,57060,153412,"ALVIN BALDUS","MICHAEL STEVEN ELLIS","Democrat",0.627890908142779,39266,153386,0.255994680088144
1978,"WISCONSIN",4,101575,52125,153703,"CLEMENT J ZABLOCKI","ELROY CHARLES HONADEL","Democrat",0.660852423179769,49450,153700,0.321730644111906
1978,"WISCONSIN",5,85067,30185,116420,"HENRY S REUSS","JAMES R W MEDINA","Democrat",0.730690602989177,54882,115252,0.476191302537049
1978,"WISCONSIN",6,48785,114742,164817,"ROBERT J STEFFES","WILLIAM A STEIGER","Republican",0.696178185502709,-65957,163527,-0.403340121203226
1978,"WISCONSIN",7,110874,65750,178304,"DAVID R OBEY","VINTON A VESTA","Democrat",0.621825646087581,45124,176624,0.25548056889211
1978,"WISCONSIN",8,73925,101856,175791,"ROBERT J CORNELL","TOBY ROTH","Republican",0.579415328429783,-27931,175781,-0.158896581541805
1978,"WISCONSIN",9,75207,118386,193688,"MATTHEW J FLYNN","F JAMES SENSENBRENNER","Republican",0.611220106563132,-43179,193593,-0.223040089259426
1978,"WYOMING",0,53522,75855,129377,"WILLIAM D BAGLEY","RICHARD BRUCE CHENEY","Republican",0.586309776853691,-22333,129377,-0.172619553707382
1980,"ALABAMA",2,63447,104796,172962,"CECIL WYATT","BILL DICKINSON","Republican",0.605890311166615,-41349,168243,-0.245769511955921
1980,"ALABAMA",6,87536,95019,187982,"WB ""PETE"" CLIFFORD","ALBERT LEE SMITH JR","Republican",0.505468608696577,-7483,182555,-0.0409903864588754
1980,"ALABAMA",7,122505,43320,168804,"RICHARD C SHELBY","JAMES E ""JIM"" BACON","Democrat",0.725723324091846,79185,165825,0.477521483491633
1980,"ALASKA",0,39922,114089,154618,"KEVIN ""PAT"" PARNELL","DONALD E YOUNG","Republican",0.737876573232095,-74167,154011,-0.48156949828259
1980,"ARIZONA",1,40045,136961,186833,"STEVE JANCEK","JOHN J RHODES","Republican",0.733066428307633,-96916,177006,-0.547529462278115
1980,"ARIZONA",2,127736,88653,219686,"MORRIS K UDALL","RICHARD H HUFF","Democrat",0.581448066786231,39083,216389,0.1806145414046
1980,"ARIZONA",3,141448,65845,219822,"BOB STUMP","BOB CROFT","Democrat",0.643466077098743,75603,207293,0.364715644040079
1980,"ARIZONA",4,85046,142565,227611,"LES MILLER","ELDON RUDD","Republican",0.626353735100676,-57519,227611,-0.252707470201352
1980,"ARKANSAS",2,42278,159148,201655,"JAMES G ""JIM"" REID","ED BETHUNE","Republican",0.789209293099601,-116870,201426,-0.580213080734364
1980,"CALIFORNIA",1,107682,145098,270199,"HAROLD T JOHNSON","EUGENE A CHAPPIE","Republican",0.537004208009652,-37416,252780,-0.148018039401851
1980,"CALIFORNIA",2,109789,141698,261674,"NORMA K BORK","DON H CLAUSEN","Republican",0.541505843148345,-31909,251487,-0.126881309968309
1980,"CALIFORNIA",3,170670,64215,241865,"ROBERT T MATSUI","JOSEPH MURPHY","Democrat",0.705641576912741,106455,234885,0.453221789386295
1980,"CALIFORNIA",4,133853,60935,205055,"VIC FAZIO","ALBERT DEHR","Democrat",0.65276633098437,72918,194788,0.374345442224367
1980,"CALIFORNIA",5,101105,89624,197821,"JOHN L BURTON","DENNIS MCQUAID","Democrat",0.511093362180962,11481,190729,0.0601953557141284
1980,"CALIFORNIA",6,93400,34500,134650,"PHILLIP BURTON","TOM SPINOSA","Democrat",0.693650204233197,58900,127900,0.46051602814699
1980,"CALIFORNIA",7,142044,70479,224469,"GEORGE MILLER","GILES ST CLAIR","Democrat",0.632800074843297,71565,212523,0.336740023432758
1980,"CALIFORNIA",8,108380,76580,195425,"RONALD V DELLUMS","CHARLES V HUGHES","Democrat",0.554586158372777,31800,184960,0.171929065743945
1980,"CALIFORNIA",9,90504,67265,163592,"FORTNEY H ""PETE"" STARK","WILLIAM J ""BILL"" KENNEDY","Democrat",0.55322998679642,23239,157769,0.147297631347096
1980,"CALIFORNIA",10,102231,45987,164543,"DON EDWARDS","JOHN M LUTTON","Democrat",0.62130263821615,56244,148218,0.379468080799903
1980,"CALIFORNIA",11,85823,80100,185012,"TOM LANTOS","BILL ROYER","Democrat",0.46387801872311,5723,165923,0.0344919028706087
1980,"CALIFORNIA",12,37009,143817,199083,"KIRSTEN OLSEN","PAUL N ""PETE"" MCCLOSKEY JR","Republican",0.722397191121291,-106808,180826,-0.590667271299481
1980,"CALIFORNIA",13,132246,79766,224609,"NORMAN Y MINETA","WE ""TED"" GAGNE","Democrat",0.588783174316256,52480,212012,0.247533158500462
1980,"CALIFORNIA",14,79883,133979,220579,"ANN CERNEY","NORMAN D SHUMWAY","Republican",0.607396896350061,-54096,213862,-0.252948162833977
1980,"CALIFORNIA",15,108072,37895,150491,"TONY COELHO","RON SCHWARTZ","Democrat",0.71812932334824,70177,145967,0.480773051443134
1980,"CALIFORNIA",16,158360,54675,223035,"LEON E PANETTA","WA JACK ROTH","Democrat",0.710023090546327,103685,213035,0.4867040627127
1980,"CALIFORNIA",17,53780,129159,182939,"WILLARD H ""BILL"" JOHNSON","CHARLES ""CHIP"" PASHAYAN JR","Republican",0.706022225987898,-75379,182939,-0.412044451975795
1980,"CALIFORNIA",18,51415,126046,177461,"MARY ""PAT"" TIMMERMANS","WILLIAM M THOMAS","Republican",0.710274370143299,-74631,177461,-0.420548740286598
1980,"CALIFORNIA",19,36990,162849,209603,"CARMEN LODISE","ROBERT J LAGOMARSINO","Republican",0.77694021555035,-125859,199839,-0.629801990602435
1980,"CALIFORNIA",20,43024,199674,253303,"MATT MILLER","BARRY GOLDWATER JR","Republican",0.788281228410244,-156650,242698,-0.645452372907894
1980,"CALIFORNIA",21,73898,74674,153400,"JAMES C CORMAN","BOBBI FIEDLER","Republican",0.486792698826597,-776,148572,-0.00522305683439679
1980,"CALIFORNIA",22,57477,115241,180423,"PIERCE O'DONNELL","CARLOS J MOORHEAD","Republican",0.638726769868587,-57764,172718,-0.334441112101808
1980,"CALIFORNIA",23,126020,62742,199385,"ANTHONY C BEILENSON","ROBERT ""BOB"" WINCKLER","Democrat",0.63204353386664,63278,188762,0.335226369714243
1980,"CALIFORNIA",24,93569,39744,146731,"HENRY A WAXMAN","ROLAND CAYARD","Democrat",0.637690740198049,53825,133313,0.403749071733439
1980,"CALIFORNIA",25,49080,21116,74365,"EDWARD R ROYBAL","RICHARD E FERRARO JR","Democrat",0.659987897532441,27964,70196,0.39837027750869
1980,"CALIFORNIA",26,40099,116715,164514,"JOSEPH LOUIS LISONI","JOHN H ROUSSELOT","Republican",0.709453298807396,-76616,156814,-0.488578825870139
1980,"CALIFORNIA",27,100061,109807,215316,"CAREY PECK","ROBERT K DORNAN","Republican",0.509980679559345,-9746,209868,-0.0464387138582347
1980,"CALIFORNIA",28,108725,23179,137304,"JULIAN C DIXON","ROBERT REID","Democrat",0.79185602750102,85546,131904,0.6485474284328
1980,"CALIFORNIA",29,80095,10282,92999,"AUGUSTUS F ""GUS"" HAWKINS","MICHAEL ARTHUR HIRT","Democrat",0.861245819847525,69813,90377,0.772464233156666
1980,"CALIFORNIA",30,74119,24136,102735,"GEORGE E DANIELSON","J ARTHUR ""ART"" PLATTEN","Democrat",0.721458120406872,49983,98255,0.50870693603379
1980,"CALIFORNIA",31,69146,38203,107349,"MERVYN M DYMALLY","DON GRIMSHAW","Democrat",0.644123373296444,30943,107349,0.288246746592889
1980,"CALIFORNIA",32,84057,39260,127526,"GLENN M ANDERSON","JOHN R ADLER","Democrat",0.659136176152314,44797,123317,0.363267027254961
1980,"CALIFORNIA",33,50365,122439,172804,"FRED L ANDERSON","WAYNE GRISHAM","Republican",0.708542626328094,-72074,172804,-0.417085252656189
1980,"CALIFORNIA",34,46351,138024,192169,"SIMONE","DAN LUNGREN","Republican",0.718242796704984,-91673,184375,-0.497209491525424
1980,"CALIFORNIA",35,88279,100743,194514,"JIM LLOYD","DAVE DREIER","Republican",0.517921589191524,-12464,189022,-0.0659394144596925
1980,"CALIFORNIA",36,88628,73247,168690,"GEORGE E BROWN JR","JOHN PAUL STARK","Democrat",0.525389768213884,15381,161875,0.0950177606177606
1980,"CALIFORNIA",37,58091,165371,231077,"DONALD M ""DON"" RUSK","JERRY LEWIS","Republican",0.715653223817169,-107280,223462,-0.480081624616266
1980,"CALIFORNIA",38,91880,66256,165437,"JERRY M PATTERSON","ART JACOBSON","Democrat",0.555377575753912,25624,158136,0.162037739667122
1980,"CALIFORNIA",39,54504,175228,229732,"LEONARD L LAHTINEN","WILLIAM E ""BILL"" DANNEMEYER","Republican",0.762749638709453,-120724,229732,-0.525499277418905
1980,"CALIFORNIA",40,66512,213999,304997,"MICHAEL F DOW","ROBERT E BADHAM","Republican",0.701642966980003,-147487,280511,-0.525779737692996
1980,"CALIFORNIA",41,101101,123187,233918,"BOB WILSON","BILL LOWERY","Republican",0.526624714643593,-22086,224288,-0.098471607932658
1980,"CALIFORNIA",42,69936,79713,149649,"LIONEL VAN DEERLIN","DUNCAN L HUNTER","Republican",0.532666439468356,-9777,149649,-0.0653328789367119
1980,"CALIFORNIA",43,46361,298815,345176,"TOM METZGER","CLAIR W BURGENER","Republican",0.865688808028368,-252454,345176,-0.731377616056736
1980,"COLORADO",1,107364,67804,179622,"PAT SCHROEDER","NAOMI BRADFORD","Democrat",0.597721882620169,39560,175168,0.225840336134454
1980,"COLORADO",2,153550,111868,272270,"TIMOTHY E WIRTH","JOHN MCELDERRY","Democrat",0.563962243361369,41682,265418,0.157042853159921
1980,"COLORADO",3,105820,84292,192782,"RAY KOGOVSEK","HAROLD L ""MACK"" MCCORMICK","Democrat",0.548910167961739,21528,190112,0.113238512035011
1980,"COLORADO",4,76849,178221,260491,"POLLY BACA BARRAGAN","HANK BROWN","Republican",0.684173349559102,-101372,255070,-0.397428156976516
1980,"COLORADO",5,62003,177319,244900,"ED SCHREIBER","KEN KRAMER","Republican",0.724046549612087,-115316,239322,-0.481844544170615
1980,"CONNECTICUT",1,137849,80816,218694,"WILLIAM R COTTER","MARJORIE D ANDERSON","Democrat",0.630328221167476,57033,218665,0.260823634326481
1980,"CONNECTICUT",2,119176,104107,223311,"SAMUEL GEJDENSON","TONY GUGLIELMO","Democrat",0.533677248321847,15069,223283,0.0674883443880636
1980,"CONNECTICUT",3,103903,117024,223648,"JOSEPH L LIEBERMAN","LAWRENCE J DENARDIS","Republican",0.523250822721419,-13121,220927,-0.0593906584527921
1980,"CONNECTICUT",4,74326,124285,198625,"JOHN A PHILLIPS","STEWART B MCKINNEY","Republican",0.625726872246696,-49959,198611,-0.251541958904592
1980,"CONNECTICUT",5,117316,115614,232943,"WILLIAM R RATCHFORD","EDWARD M DONAHUE","Democrat",0.50362535040761,1702,232930,0.00730691624093075
1980,"CONNECTICUT",6,142685,98331,242024,"ANTHONY TOBY MOFFETT","NICHOLAS SCHAUS","Democrat",0.589548970350048,44354,241016,0.18402927606466
1980,"DELAWARE",0,81227,133842,216575,"ROBERT L MAXWELL","THOMAS B EVANS JR","Republican",0.617993766593559,-52615,215069,-0.24464241708475
1980,"FLORIDA",1,119829,75939,195768,"EARL HUTTO","WARREN BRIGGS","Democrat",0.612096971925953,43890,195768,0.224193943851906
1980,"FLORIDA",2,138252,57588,195840,"DON FUQUA","JOHN R LACAPRA","Democrat",0.70594362745098,80664,195840,0.411887254901961
1980,"FLORIDA",3,104672,31208,135880,"CHARLES E BENNETT","HARRY RADCLIFFE","Democrat",0.770326758904916,73464,135880,0.540653517809832
1980,"FLORIDA",4,147775,76924,224699,"BILL CHAPPELL","BARNEY E DILLARD JR","Democrat",0.657657577470305,70851,224699,0.315315154940609
1980,"FLORIDA",5,140903,177603,318506,"DAVID BEST","BIL MCCOLLUM","Republican",0.557612729430529,-36700,318506,-0.115225458861058
1980,"FLORIDA",7,132529,52138,184667,"SAM M GIBBONS","CHARLES P ""CHUCK"" JONES","Democrat",0.717664769558178,80391,184667,0.435329539116355
1980,"FLORIDA",8,151613,61820,218913,"ANDY IRELAND","SCOTT NICHOLSON","Democrat",0.6925719349696,89793,213433,0.420708137916817
1980,"FLORIDA",9,139468,58734,198202,"BILL NELSON","STAN DOWIAT","Democrat",0.703665956953007,80734,198202,0.407331913906015
1980,"FLORIDA",10,72646,272393,345039,"RICHARD D ""SPARKY"" SPARKMAN","L A ""SKIP"" BAFALIS","Republican",0.789455684719698,-199747,345039,-0.578911369439397
1980,"FLORIDA",11,201713,137520,339233,"DAN MICA","AL COOGLER","Democrat",0.594614910695599,64193,339233,0.189229821391197
1980,"FLORIDA",12,107164,128561,235725,"ALAN S BECKER","CLAY SHAW","Republican",0.545385512779722,-21397,235725,-0.0907710255594443
1980,"FLORIDA",13,127828,42830,170658,"WILLIAM LEHMAN","ALVIN E ""AL"" ENTIN","Democrat",0.749030224191072,84998,170658,0.498060448382144
1980,"FLORIDA",14,95820,32027,127847,"CLAUDE PEPPER","EVELOP S ESTRELLA","Democrat",0.749489624316566,63793,127847,0.498979248633132
1980,"FLORIDA",15,132952,70433,203385,"DANTE B FASCELL","HERBERT J HOODWIN","Democrat",0.653696191951226,62519,203385,0.307392383902451
1980,"GEORGIA",2,92264,33107,125372,"CHARLES HATCHER","JACK E HARRELL JR","Democrat",0.735921896436206,59157,125371,0.471855532778713
1980,"GEORGIA",4,117091,51546,168650,"ELLIOTT H LEVITAS","BARRY BILLINGTON","Democrat",0.694284020160095,65545,168637,0.388675083166802
1980,"GEORGIA",5,101646,35640,137302,"WYCHE FOWLER JR","F WILLIAM DOWDA","Democrat",0.740309682306157,66006,137286,0.48079192342992
1980,"GEORGIA",6,66606,96071,162685,"DOCK H DAVIS","NEWT GINGRICH","Republican",0.590533853766481,-29465,162677,-0.181125789140444
1980,"GEORGIA",7,115892,54242,170142,"LARRY P MCDONALD","RICHARD CASTELLUCIS","Democrat",0.681148687566856,61650,170134,0.362361432753006
1980,"GEORGIA",8,91103,31033,122138,"BILLY LEE EVANS","DARWIN ASHWORTH","Democrat",0.745902176226891,60070,122136,0.491828781030982
1980,"GEORGIA",9,115576,54341,169918,"ED JENKINS","DAVID ASHWORTH","Democrat",0.680186913687779,61235,169917,0.360381833483407
1980,"GEORGIA",10,102177,25194,127378,"DOUG BARNARD JR","BRUCE J NEUBAUER","Democrat",0.802155788283691,76983,127371,0.604399745624985
1980,"HAWAII",1,98256,19819,123181,"CEC HEFTEL","ALOMA KEEN NOBLE","Democrat",0.797655482582541,78437,118075,0.664298115604489
1980,"IDAHO",1,100697,116845,217542,"GLENN W NICHOLS","LARRY CRAIG","Republican",0.537114672109294,-16148,217542,-0.0742293442185877
1980,"IDAHO",2,81364,116196,197560,"DIANE BILYEU","GEORGE HANSEN","Republican",0.588155497064183,-34832,197560,-0.176310994128366
1980,"ILLINOIS",1,119562,5660,125223,"HAROLD WASHINGTON","GEORGE WILLIAMS","Democrat",0.954792649912556,113902,125222,0.909600549424223
1980,"ILLINOIS",2,129771,17428,147302,"GUS SAVAGE","MARSHA A HARRIS","Democrat",0.88098600154784,112343,147199,0.763204913076855
1980,"ILLINOIS",3,137283,61955,199240,"MARTIN A RUSSO","LAWRENCE C SARSOUN","Democrat",0.689033326641237,75328,199238,0.378080486654152
1980,"ILLINOIS",4,71814,152377,224192,"RICHARD S JALOVEC","EDWARD J DERWINSKI","Republican",0.679671888381387,-80563,224191,-0.359349840091708
1980,"ILLINOIS",5,106142,27136,133279,"JOHN G FARY","ROBERT V KOTOWSKI","Democrat",0.796389528732959,79006,133278,0.592791008268431
1980,"ILLINOIS",6,60951,123593,184550,"MARIO RAYMOND REDA","HENRY J HYDE","Republican",0.669699268490924,-62642,184544,-0.339442084272585
1980,"ILLINOIS",7,80056,14041,94097,"CARDISS COLLINS","RUTH R HOOPER","Democrat",0.850781640222324,66015,94097,0.701563280444648
1980,"ILLINOIS",8,98524,17845,116373,"DAN ROSTENKOWSKI","WALTER F ZILKE","Democrat",0.846622498345836,80679,116369,0.693303199305657
1980,"ILLINOIS",9,106543,39244,145788,"SIDNEY R YATES","JOHN D ANDRICA","Democrat",0.730807748237166,67299,145787,0.4616255221659
1980,"ILLINOIS",10,89008,137707,226733,"ROBERT A WEINBERGER","JOHN EDWARD PORTER","Republican",0.607353142242197,-48699,226715,-0.214802725889332
1980,"ILLINOIS",11,121166,52417,173587,"FRANK ANNUNZIO","MICHAEL R ZANILLO","Democrat",0.698013100059336,68749,173583,0.396058369771233
1980,"ILLINOIS",12,64729,185080,249818,"DAVID MCCARTNEY","PHILIP M CRANE","Republican",0.740859345603599,-120351,249809,-0.481772073864432
1980,"ILLINOIS",13,52000,131448,183458,"MICHAEL REESE","ROBERT MCCLORY","Republican",0.716501869637737,-79448,183448,-0.433081854258427
1980,"ILLINOIS",14,61224,202583,263828,"LEROY E KENNEL","JOHN N ERLENBORN","Republican",0.767860120987916,-141359,263807,-0.535842490911917
1980,"ILLINOIS",15,45721,150898,196619,"JOHN P QUILLIN","TOM CORCORAN","Republican",0.767463978557515,-105177,196619,-0.53492795711503
1980,"ILLINOIS",16,64224,132905,197147,"DOUGLAS R AURAND","LYNN MARTIN","Republican",0.674141630357043,-68681,197129,-0.34840637349147
1980,"ILLINOIS",17,65305,125806,191111,"MICHAEL A MURER","GEORGE M O'BRIEN","Republican",0.65828759202767,-60501,191111,-0.31657518405534
1980,"ILLINOIS",18,76471,125561,202043,"JOHN L KNUPPEL","ROBERT H MICHEL","Republican",0.621456818598021,-49090,202032,-0.242981309891502
1980,"ILLINOIS",19,51753,142616,194369,"THOMAS J HAND","TOM RAILSBACK","Republican",0.733738404786772,-90863,194369,-0.467476809573543
1980,"ILLINOIS",20,96950,123427,220377,"DAVID ROBINSON","PAUL FINDLEY","Republican",0.560072058336396,-26477,220377,-0.120144116672793
1980,"ILLINOIS",21,63476,132186,195662,"PENNY L SEVERNS","EDWARD R MADIGAN","Republican",0.675583404033486,-68710,195662,-0.351166808066973
1980,"ILLINOIS",22,66065,146014,212079,"PETER M VOELZ","DANIEL B CRANE","Republican",0.688488723541699,-79949,212079,-0.376977447083398
1980,"ILLINOIS",23,107786,59644,167430,"MELVIN PRICE","RONALD L DAVINROY","Democrat",0.643767544645524,48142,167430,0.287535089291047
1980,"ILLINOIS",24,112134,110176,228296,"PAUL SIMON","JOHN T ANDERSON","Democrat",0.491178119634159,1958,222310,0.00880752102919347
1980,"INDIANA",1,112016,43537,155553,"ADAM BENJAMIN JR","JOSEPH DOUGLAS HARKIN","Democrat",0.720114687598439,68479,155553,0.440229375196878
1980,"INDIANA",2,122326,103957,226283,"FLOYD J FITHIAN","ERNEST NIEMEYER","Democrat",0.540588555039486,18369,226283,0.0811771100789719
1980,"INDIANA",3,85136,103972,189108,"JOHN BRADEMAS","JOHN PATRICK HILER","Republican",0.54980222941388,-18836,189108,-0.0996044588277598
1980,"INDIANA",4,77542,120055,198342,"JOHN D WALDA","DAN R COATS","Republican",0.605292877958274,-42513,197597,-0.21515002758139
1980,"INDIANA",5,80378,129474,209852,"NELS J ACKERSON","ELWOOD H HILLIS","Republican",0.616977679507462,-49096,209852,-0.233955359014925
1980,"INDIANA",6,99089,98302,197391,"DAVE EVANS","DAVID G CRANE","Democrat",0.50199350527633,787,197391,0.00398701055265944
1980,"INDIANA",7,69051,137604,208264,"PATRICK D CARROLL","JOHN T MYERS","Republican",0.660719087312257,-68553,206655,-0.331726791028526
1980,"INDIANA",8,97059,119415,216474,"KENNETH C SNIDER","JOEL DECKARD","Republican",0.551636686160925,-22356,216474,-0.103273372321849
1980,"INDIANA",9,136574,75601,212175,"LEE H HAMILTON","GEORGE MEYER JR","Democrat",0.643685636856369,60973,212175,0.287371273712737
1980,"INDIANA",10,103083,90051,193134,"PHILIP R SHARP","WILLIAM G FRAZIER","Democrat",0.533738233558048,13032,193134,0.0674764671160956
1980,"INDIANA",11,105468,78743,184211,"ANDREW JACOBS JR","SHEILA SUESS","Democrat",0.572539099185174,26725,184211,0.145078198370347
1980,"IOWA",1,72602,133349,208111,"JIM LAREW","JIM LEACH","Republican",0.640759018024035,-60747,205951,-0.294958509548388
1980,"IOWA",2,93175,111587,206634,"STEVE SOVERN","TOM TAUKE","Republican",0.540022455162268,-18412,204762,-0.0899190279446382
1980,"IOWA",3,101735,107869,209945,"LYNNE G CUTLER","COOPER EVANS","Republican",0.51379647050418,-6134,209604,-0.0292647086887655
1980,"IOWA",4,117896,100335,218620,"NEAL SMITH","DONALD C YOUNG","Democrat",0.53927362546885,17561,218231,0.0804697774376693
1980,"IOWA",5,127895,84472,212367,"TOM HARKIN","CAL HULTMAN","Democrat",0.602235752259061,43423,212367,0.204471504518122
1980,"IOWA",6,129460,71866,201326,"BERKLEY BEDELL","CLARENCE S CARNEY","Democrat",0.643036666898463,57594,201326,0.286073333796926
1980,"KANSAS",1,73586,121545,195131,"PHIL MARTIN","PAT ROBERTS","Republican",0.622889238511564,-47959,195131,-0.245778477023128
1980,"KANSAS",2,78859,92107,170977,"SAM KEYS","JIM JEFFRIES","Republican",0.538709884955286,-13248,170966,-0.0774890913982897
1980,"KANSAS",3,82414,109294,197046,"DAN WATKINS","LARRY WINN JR","Republican",0.554662363103032,-26880,191708,-0.140213240970643
1980,"KANSAS",4,124014,55899,179913,"DAN GLICKMAN","CLAY HUNTER","Democrat",0.689299828250321,68115,179913,0.378599656500642
1980,"KANSAS",5,45676,141029,190047,"DAVID L MILLER","BOB WHITTAKER","Republican",0.742074328981778,-95353,186705,-0.510714763932407
1980,"KENTUCKY",2,99670,52110,151780,"WILLIAM H NATCHER","MARK T WATSON","Democrat",0.656674133614442,47560,151780,0.313348267228884
1980,"KENTUCKY",3,85873,46681,134724,"ROMANO L MAZZOLI","RICHARD CESLER","Democrat",0.637399424007601,39192,132554,0.295668180515111
1980,"KENTUCKY",4,62138,126049,188187,"PHIL M MCGARY","GENE SNYDER","Republican",0.669807159899462,-63911,188187,-0.339614319798923
1980,"KENTUCKY",5,54027,112093,166120,"TED R MARCUM","HAROLD ""HAL"" ROGERS","Republican",0.674771249699013,-58066,166120,-0.349542499398026
1980,"KENTUCKY",6,72473,105376,179051,"TOM EASTERLY","LARRY J HOPKINS","Republican",0.588525057106634,-32903,177849,-0.185005257268807
1980,"LOUISIANA",1,8277,81777,92555,"MICHAEL J MUSMECI SR","ROBERT L ""BOB"" LIVINGSTON","Republican",0.883550321430501,-73500,90054,-0.816176960490372
1980,"LOUISIANA",2,48662,25521,74183,"CLYDE F BELL JR","ROB COUHIG","Democrat",0.655972392596687,23141,74183,0.311944785193373
1980,"LOUISIANA",6,12149,118540,130689,"ALICE BROOKS","W HENSON MOORE","Republican",0.907038847952008,-106391,130689,-0.814077695904016
1980,"LOUISIANA",8,75433,34059,109492,"GILLIS LONG","CLYDE C HOLLOWAY","Democrat",0.688936177985606,41374,109492,0.377872355971212
1980,"MAINE",1,86819,188667,275491,"HAROLD C PACHIOS","DAVID F EMERY","Republican",0.684839069152894,-101848,275486,-0.369702997611494
1980,"MAINE",2,51026,186406,237448,"HAROLD L SILVERMAN","OLYMPIA J SNOWE","Republican",0.7850392506991,-135380,237432,-0.570184305401125
1980,"MARYLAND",1,97743,91143,188886,"ROY DYSON","ROBERT E BAUMAN","Democrat",0.517470855436613,6600,188886,0.0349417108732251
1980,"MARYLAND",2,121017,89961,210978,"CLARENCE D LONG","HELEN DELICH BENTLEY","Democrat",0.573600091004749,31056,210978,0.147200182009499
1980,"MARYLAND",3,102293,32074,134367,"BARBARA A MIKULSKI","RUSSELL T SCHAFFER","Democrat",0.761295556200555,70219,134367,0.52259111240111
1980,"MARYLAND",4,47375,120985,168360,"JAMES J RILEY","MARJORIE S HOLT","Republican",0.718608933238299,-73610,168360,-0.437217866476598
1980,"MARYLAND",5,106035,25693,131728,"GLADYS NOON SPELLMAN","KEVIN R IGOE","Democrat",0.804954147941212,80342,131728,0.609908295882424
1980,"MARYLAND",6,146101,62913,209014,"BEVERLY B BYRON","RAYMOND E BECK","Democrat",0.699001023854861,83188,209014,0.398002047709723
1980,"MARYLAND",7,97104,12650,109754,"PARREN J MITCHELL","VICTOR CLARK JR","Democrat",0.88474224174062,84454,109754,0.76948448348124
1980,"MARYLAND",8,148301,101659,249960,"MICHAEL D BARNES","NEWTON STEERS","Democrat",0.593298927828453,46642,249960,0.186597855656905
1980,"MASSACHUSETTS",1,52457,156514,208991,"HELEN POPPY DOYLE","SILVIO O CONTE","Republican",0.748903062811317,-104057,208971,-0.497949476243115
1980,"MASSACHUSETTS",2,120711,38672,179665,"EDWARD P BOLAND","THOMAS P SWANK","Democrat",0.671867085965547,82039,159383,0.514728672443109
1980,"MASSACHUSETTS",3,141560,54213,195783,"JOSEPH D EARLY","DAVID G SKEHAN","Democrat",0.723045412523048,87347,195773,0.446164690738764
1980,"MASSACHUSETTS",4,103466,95898,199376,"BARNEY FRANK","RICHARD A JONES","Democrat",0.518949121258326,7568,199364,0.0379607150739351
1980,"MASSACHUSETTS",5,136758,70547,207321,"JAMES M SHANNON","WILLIAM C SAWYER","Democrat",0.659643740865614,66211,207305,0.319389305612503
1980,"MASSACHUSETTS",6,111393,103192,219257,"NICHOLAS MAVROULES","THOMAS H TRIMARCO","Democrat",0.508047633598927,8201,214585,0.0382179555886945
1980,"MASSACHUSETTS",8,128689,35477,164183,"THOMAS P O'NEILL JR","WILLIAM A BARNSTEAD","Democrat",0.783814402221911,93212,164166,0.567791138238125
1980,"MASSACHUSETTS",10,85629,131794,217433,"ROBERT E MCCARTHY","MARGARET M HECKLER","Republican",0.606136143087756,-46165,217423,-0.212328042571393
1980,"MASSACHUSETTS",12,195791,71620,267421,"GERRY E STUDDS","PAUL V DOANE","Democrat",0.732145194281676,124171,267411,0.464345146609526
1980,"MICHIGAN",1,123286,6244,130230,"JOHN CONYERS JR","WILLIAM M BELL","Democrat",0.946678952622284,117042,129530,0.903589901953215
1980,"MICHIGAN",2,83550,115562,201801,"KATHLEEN F O'REILLY","CARL D PURSELL","Republican",0.57265325741696,-32012,199112,-0.16077383583109
1980,"MICHIGAN",3,113080,102591,217414,"HOWARD WOLPE","JAMES S GILMORE","Democrat",0.520113700129706,10489,215671,0.0486342623718534
1980,"MICHIGAN",4,47777,148950,199292,"LYNDON G FURST","DAVE STOCKMAN","Republican",0.74739578106497,-101173,196727,-0.514281212034952
1980,"MICHIGAN",5,101737,118061,222158,"DALE R SPRIK","HAROLD S SAWYER","Republican",0.531428082715905,-16324,219798,-0.0742681917032912
1980,"MICHIGAN",6,108548,111272,219826,"BOB CARR","JIM DUNN","Republican",0.506182162255602,-2724,219820,-0.0123919570557729
1980,"MICHIGAN",8,124155,77009,204401,"BOB TRAXLER","NORMAN R HUGHES","Democrat",0.607408965709561,47146,201164,0.234365989938558
1980,"MICHIGAN",10,126962,111496,242252,"DON ALBOSTA","RICHARD J ALLEN","Democrat",0.52409061638294,15466,238458,0.0648583817695359
1980,"MICHIGAN",11,75515,146205,223139,"DAN DORRITY","BOB DAVIS","Republican",0.655219392396668,-70690,221720,-0.318825545733357
1980,"MICHIGAN",12,112698,90931,203647,"DAVID E BONIOR","KIRK WALSH","Democrat",0.553398773367641,21767,203629,0.106895383270556
1980,"MICHIGAN",13,79719,6473,87090,"GEORGE W CROCKETT","M MICHAEL HURD","Democrat",0.915363417154668,73246,86192,0.849800445516985
1980,"MICHIGAN",14,90362,78395,169666,"DENNIS M HERTEL","VIC CAPUTO","Democrat",0.53258755437153,11967,168757,0.0709126139952713
1980,"MICHIGAN",15,113492,53046,167795,"WILLIAM D FORD","GERALD R CARLSON","Democrat",0.676372955094014,60446,166538,0.362956202188089
1980,"MICHIGAN",16,105844,42735,151465,"JOHN D DINGELL","PAMELLA A SEAY","Democrat",0.698801703363813,63109,148579,0.42475046944723
1980,"MICHIGAN",17,127525,44313,174528,"WILLIAM M BRODHEAD","L PATTERSON","Democrat",0.730685047671434,83212,171838,0.484246790581827
1980,"MICHIGAN",18,135705,68575,207977,"JIM BLANCHARD","BETTY J SUIDA","Democrat",0.65250003606168,67130,204280,0.328617583708635
1980,"MICHIGAN",19,60100,168530,231894,"WAYNE E DANIELS","WILLIAM S BROOMFIELD","Republican",0.726754465402296,-108430,228630,-0.474259720946507
1980,"MINNESOTA",1,67279,171099,238380,"RUSSELL V SMITH","ARLEN ERDAHL","Republican",0.717757362194815,-103820,238378,-0.435526768409836
1980,"MINNESOTA",2,102586,158082,260668,"HAROLD J BERGQUIST","TOM HAGEDORN","Republican",0.60644958337809,-55496,260668,-0.21289916675618
1980,"MINNESOTA",3,57868,179393,237261,"JOEL A SALITERMAN","BILL FRENZEL","Republican",0.75609982255828,-121525,237261,-0.512199645116559
1980,"MINNESOTA",4,119182,82537,203712,"BRUCE F VENTO","JOHN BERG","Democrat",0.585051445177506,36645,201719,0.181663601346427
1980,"MINNESOTA",5,126451,48200,180430,"MARTIN OLAV SABO","JOHN DOHERTY","Democrat",0.700831347336917,78251,174651,0.448042095378784
1980,"MINNESOTA",6,126173,140402,266584,"ARCHIE BAUMANN","VIN WEBER","Republican",0.526670767938061,-14229,266575,-0.0533770983775673
1980,"MINNESOTA",7,124026,135084,259113,"GENE WENSTROM","ARLAN STANGELAND","Republican",0.521332391659238,-11058,259110,-0.0426768553896029
1980,"MINNESOTA",8,182228,72350,258765,"JAMES L OBERSTAR","EDWARD FIORE","Democrat",0.704221977469905,109878,254578,0.431608387213349
1980,"MISSISSIPPI",1,104269,61292,165561,"JAMIE L WHITTEN","T K MOFFETT","Democrat",0.629792040395987,42977,165561,0.259584080791974
1980,"MISSISSIPPI",2,96750,42300,139050,"DAVID R BOWEN","FRANK DRAKE","Democrat",0.6957928802589,54450,139050,0.391585760517799
1980,"MISSISSIPPI",4,52303,69321,177896,"BRITT R SINGLETARY","JON C HENSON","Republican",0.389671493456851,-17018,121624,-0.139923041504966
1980,"MISSISSIPPI",5,46416,131559,177975,"JIMMY MCVEAY","TRENT LOTT","Republican",0.739199325747998,-85143,177975,-0.478398651495997
1980,"MISSOURI",1,91272,38667,129939,"WILLIAM ""BILL"" CLAY","BILL WHITE","Democrat",0.702421905663427,52605,129939,0.404843811326853
1980,"MISSOURI",2,148227,81762,229989,"ROBERT A YOUNG","JOHN O SHIELDS","Democrat",0.64449604111501,66465,229989,0.28899208223002
1980,"MISSOURI",3,143132,41277,184409,"RICHARD A GEPHARDT","ROBERT A CEDARBURG","Democrat",0.776166022265725,101855,184409,0.552332044531449
1980,"MISSOURI",4,151459,71869,223328,"IKE SKELTON","BILL BAKER","Democrat",0.678190822467402,79590,223328,0.356381644934804
1980,"MISSOURI",5,110957,47309,158266,"RICHARD BOLLING","VINCENT E BAKER","Democrat",0.701079195784312,63648,158266,0.402158391568625
1980,"MISSOURI",6,62048,149281,211329,"VERNON KING","TOM COLEMAN","Republican",0.706391455976227,-87233,211329,-0.412782911952453
1980,"MISSOURI",7,76844,161668,238512,"KEN YOUNG","GENE TAYLOR","Republican",0.677819145367948,-84824,238512,-0.355638290735896
1980,"MISSOURI",8,95751,127675,223426,"STEVE GARDNER","WENDELL BAILEY","Republican",0.57144199869308,-31924,223426,-0.142883997386159
1980,"MISSOURI",9,135905,104835,240740,"HAROLD L VOLKMER","JOHN W TURNER","Democrat",0.564530198554457,31070,240740,0.129060397108914
1980,"MISSOURI",10,94465,116167,210632,"BILL D BURLISON","BILL EMERSON","Republican",0.551516388772836,-21702,210632,-0.103032777545672
1980,"MONTANA",1,112866,70874,183740,"PAT WILLIAMS","JOHN K ""JACK"" MCDONALD","Democrat",0.614270164362686,41992,183740,0.228540328725373
1980,"MONTANA",2,63370,91431,154801,"TOM ""THOMAS"" MONAHAN","RON MARLENEE","Republican",0.590635719407497,-28061,154801,-0.181271438814995
1980,"NEBRASKA",1,43605,160705,204341,"REX S STORY","DOUG BEREUTER","Republican",0.786454994347684,-117100,204310,-0.573148646664383
1980,"NEBRASKA",2,88843,107736,203050,"RICHARD M FELLMAN","HAL DAUB","Republican",0.530588524993844,-18893,196579,-0.0961089434781945
1980,"NEBRASKA",3,34967,182887,217870,"STAN DITUS","VIRGINIA SMITH","Republican",0.83943177123973,-147920,217854,-0.678986844400378
1980,"NEVADA",0,165107,63163,236029,"JIM SANTINI","VINCE SAUNDERS","Democrat",0.699519974240454,101944,228270,0.446593945765979
1980,"NEW HAMPSHIRE",1,114061,73565,187646,"NORMAN E D'AMOURS","MARSHALL W COBLEIGH","Democrat",0.607852019227695,40496,187626,0.215833626469679
1980,"NEW HAMPSHIRE",2,63350,113304,176679,"MAURICE L AREL","JUDD GREGG","Republican",0.641298626322313,-49954,176654,-0.282778765269963
1980,"NEW JERSEY",1,147352,42154,192081,"JAMES J FLORIO","SCOTT L SIBERT","Democrat",0.767134698382453,105198,189506,0.555116988380315
1980,"NEW JERSEY",2,135437,97072,235710,"WILLIAM J HUGHES","BEECH N FOX","Democrat",0.574591659242289,38365,232509,0.165004365422414
1980,"NEW JERSEY",3,106269,104184,212830,"JAMES J HOWARD","MARIE SHEEHAN MUHLER","Democrat",0.499314006484048,2085,210453,0.00990720018246354
1980,"NEW JERSEY",4,68480,95447,168504,"FRANK THOMPSON JR","CHRISTOPHER H SMITH","Republican",0.566437591985947,-26967,163927,-0.164506152128691
1980,"NEW JERSEY",5,41269,156016,201299,"KIERAN E PILLION JR","MILLICENT FENWICK","Republican",0.775046075738081,-114747,197285,-0.5816306358821
1980,"NEW JERSEY",6,92227,125792,223254,"LEWIS M WEINSTEIN","EDWIN B FORSYTHE","Republican",0.563447911347613,-33565,218019,-0.153954471857957
1980,"NEW JERSEY",7,99737,108760,214343,"ANDREW MAGUIRE","MARGE ROUKEMA","Republican",0.507411018787644,-9023,208497,-0.0432764020585428
1980,"NEW JERSEY",8,95493,44625,142201,"ROBERT A ROE","WILLIAM R CLEVELAND","Democrat",0.671535361917286,50868,140118,0.363036868924763
1980,"NEW JERSEY",9,75321,116128,196504,"GARBIEL M AMBROSIO","HAROLD C HOLLENBECK","Republican",0.590970158368277,-40807,191449,-0.21314814911543
1980,"NEW JERSEY",10,76154,11778,89245,"PETER W RODINO JR","EVERETT J JENNINGS","Democrat",0.853313911143481,64376,87932,0.732111176818451
1980,"NEW JERSEY",11,106155,57772,168524,"JOSEPH G MINISH","ROBERT A DAVIS","Democrat",0.629910279841447,48383,163927,0.295149670280064
1980,"NEW JERSEY",12,36577,134973,175026,"ROSE ZEIDWERG MONYEK","MATTHEW J RINALDO","Republican",0.771159713414007,-98396,171550,-0.573570387642087
1980,"NEW JERSEY",13,56251,152862,213373,"DAVE STICKLE","JIM COURTER","Republican",0.716407417995716,-96611,209113,-0.462003796990144
1980,"NEW JERSEY",14,86921,45606,135420,"FRANK J GUARINI","DENNIS TETI","Democrat",0.641862354157436,41315,132527,0.311747794788986
1980,"NEW JERSEY",15,92457,75812,173071,"BERNARD J DWYER","WILLIAM J O'SULLIVAN JR","Democrat",0.534214281999873,16645,168269,0.0989189928031901
1980,"NEW MEXICO",1,120903,125910,246813,"BILL RICHARDSON","MANUEL LUJAN JR","Republican",0.510143306876056,-5007,246813,-0.0202866137521119
1980,"NEW MEXICO",2,55085,61564,161992,"DAVID W KING","JOSEPH R SKEEN","Republican",0.380043458936244,-6479,116649,-0.0555426964654648
1980,"NEW YORK",1,85629,91647,204486,"THOMAS A TWOMEY","WILLIAM CARNEY","Republican",0.448182271646959,-6018,177276,-0.0339470655926352
1980,"NEW YORK",2,84035,51256,149141,"THOMAS J DOWNEY","LOUIS J MODICA","Democrat",0.563460081399481,32779,135291,0.242285148309939
1980,"NEW YORK",3,75389,74868,175657,"JEROME A AMBRO JR","GREGORY W CARMAN","Democrat",0.429183010070763,521,150257,0.00346739253412487
1980,"NEW YORK",4,54607,97064,175725,"CHARLES F BRENNAN","NORMAN F LENT","Republican",0.552363067292645,-42457,151671,-0.279928265785813
1980,"NEW YORK",5,73032,88945,182368,"KAREN S BURSTEIN","RAYMOND J MCGRATH","Republican",0.487722626776627,-15913,161977,-0.0982423430487044
1980,"NEW YORK",6,74319,71838,169971,"LESTER L WOLFF","JOHN LEBOUTILLIER","Democrat",0.43724517711845,2481,146157,0.0169748968574889
1980,"NEW YORK",7,73785,19280,100840,"JOSEPH P ADDABBO","JOSEPH P ADDABBO","Democrat",0.731703689012297,54505,93065,0.58566593241283
1980,"NEW YORK",8,79150,20970,111429,"BENJAMIN S ROSENTHAL","ALBERT LEMISHOW","Democrat",0.710317780829048,58180,100120,0.581102676787855
1980,"NEW YORK",9,63796,34453,109360,"GERALDINE FERRARO","VITO P BATTISTA","Democrat",0.583357717629846,29343,98249,0.298659528341255
1980,"NEW YORK",10,57804,35089,100918,"MARIO BIAGGI","MARIO BIAGGI","Democrat",0.57278186250223,22715,92893,0.244528651243904
1980,"NEW YORK",11,69922,19128,98222,"JAMES H SCHEUER","ANDREW E CARLAN","Democrat",0.711877176192706,50794,89050,0.570398652442448
1980,"NEW YORK",12,34611,3372,40689,"SHIRLEY CHISHOLM","CHARLES GIBBS","Democrat",0.85062301850623,31239,37983,0.822446884132375
1980,"NEW YORK",13,77704,16813,103156,"STEPHEN J SOLARZ","HARRY DEMELL","Democrat",0.75326689673892,60891,94517,0.644233312525789
1980,"NEW YORK",14,42929,7154,59162,"FREDERICK W RICHMOND","CHRISTOPHER LOVELL","Democrat",0.725617795206382,35775,50083,0.714314238364315
1980,"NEW YORK",15,49684,37709,98976,"LEO C ZEFERETTI","PAUL M ATANASIO","Democrat",0.501980278047203,11975,87393,0.137024704495783
1980,"NEW YORK",16,64536,13860,86926,"CHARLES E SCHUMER","THEODORE SILVERMAN","Democrat",0.742424591031452,50676,78396,0.646410531149548
1980,"NEW YORK",17,46178,57810,145645,"JOHN M MURPHY","GUY V MOLINARI","Republican",0.396924027601359,-11632,103988,-0.111859060660845
1980,"NEW YORK",18,62598,87286,161200,"MARK J GREEN","BILL GREEN","Republican",0.541476426799007,-24688,149884,-0.164714045528542
1980,"NEW YORK",19,72995,7335,87376,"CHARLES B RANGEL","CHARLES B RANGEL","Democrat",0.835412470243545,65660,80330,0.817378314452882
1980,"NEW YORK",20,79356,15350,104929,"THEODORE S WEISS","JAMES E GREENE","Democrat",0.756282819811492,64006,94706,0.675838912001352
1980,"NEW YORK",21,29731,1883,32758,"ROBERT GARCIA","ROBERT GARCIA","Democrat",0.907595091275414,27848,31614,0.880875561460113
1980,"NEW YORK",22,63178,9943,79015,"JONATHAN B BINGHAM","ROBERT BLACK","Democrat",0.799569701955325,53235,73121,0.728039824400651
1980,"NEW YORK",23,85749,54866,152520,"PETER A PEYSER","ANDREW A ALBANESE","Democrat",0.562214791502754,30883,140615,0.219628062439996
1980,"NEW YORK",24,100182,52921,168553,"RICHARD L OTTINGER","JOSEPH W CHRISTIANS","Democrat",0.594364977188184,47261,153103,0.308687615526802
1980,"NEW YORK",25,37369,136619,196305,"GUNARS M OZOLS","HAMILTON FISH JR","Republican",0.695952726624386,-99250,173988,-0.570441639653309
1980,"NEW YORK",26,34906,137159,184692,"EUGENE R VICTOR","BENJAMIN A GILMAN","Republican",0.742636389231802,-102253,172065,-0.594269607415802
1980,"NEW YORK",27,103863,75892,188678,"MATTHEW F MCHUGH","NEIL T WALLACE","Democrat",0.550477533151719,27971,179755,0.155606241829156
1980,"NEW YORK",28,164088,37504,210655,"SAMUEL S STRATTON","FRANK WICKS","Democrat",0.778941871780874,126584,201592,0.627921742926307
1980,"NEW YORK",29,65562,124156,212328,"RODGER L HURLEY","GERALD B H SOLOMON","Republican",0.584736822274971,-58594,189718,-0.308847868942325
1980,"NEW YORK",30,50635,101496,173889,"MARY ANNE KRUPSAK","DAVID O'B MARTIN","Republican",0.583682694132464,-50861,152131,-0.334323707857044
1980,"NEW YORK",31,37266,128397,175565,"IRVING A SCHWARTZ","DONALD J MITCHELL","Republican",0.731335972431863,-91131,165663,-0.550098694337299
1980,"NEW YORK",32,52407,98498,178957,"JEFFREY S BROOKS","GEORGE C WORTLEY","Republican",0.550400375509201,-46091,150905,-0.305430568900964
1980,"NEW YORK",33,36941,119489,175271,"DOLORE M REED","GARY A LEE","Republican",0.681738564851002,-82548,156430,-0.527699290417439
1980,"NEW YORK",34,37883,133278,182795,"JAMES TOOLE","FRANK HORTON","Republican",0.729111846604119,-95395,171161,-0.557340749352948
1980,"NEW YORK",35,39214,127623,176774,"JOHN M OWENS","BARBER B CONABLE JR","Republican",0.721955717469764,-88409,166837,-0.529912429497054
1980,"NEW YORK",36,115334,41756,171357,"JOHN J LAFALCE","H WILLIAM FEDER","Democrat",0.67306267033153,73578,157090,0.468381182761474
1980,"NEW YORK",37,90119,14701,114337,"HENRY J NOWAK","ROGER HEYMANOWSKI","Democrat",0.788187550836562,75418,104820,0.719500095401641
1980,"NEW YORK",38,35681,141763,205309,"GALE A DENN","JACK F KEMP","Republican",0.690486047859568,-106082,177444,-0.597833682739343
1980,"NEW YORK",39,93839,69194,171432,"STANLEY N LUNDINE","JAMES ABDELLA","Democrat",0.547383219002287,24645,163033,0.151165714916612
1980,"NORTH CAROLINA",2,99297,35946,135243,"LH FOUNTAIN","BARRY L GARDNER","Democrat",0.73421175217941,63351,135243,0.468423504358821
1980,"NORTH CAROLINA",3,84862,39393,124255,"CHARLES O WHITLEY","LARRY J PARKER","Democrat",0.682966480222124,45469,124255,0.365932960444248
1980,"NORTH CAROLINA",4,97167,84631,184631,"IKE ANDREWS","THURMAN HOGAN","Democrat",0.526276735759434,12536,181798,0.0689556540776026
1980,"NORTH CAROLINA",5,99117,94894,194338,"STEPHEN L NEAL","ANNE BAGNAL","Democrat",0.510023773014027,4223,194011,0.0217668070367144
1980,"NORTH CAROLINA",6,76957,80275,157232,"RICHARDSON PREYER","EUGENE JOHNSTON","Republican",0.510551287269767,-3318,157232,-0.0211025745395339
1980,"NORTH CAROLINA",7,88564,40270,128834,"CHARLES G ROSE","VIVIAN S WRIGHT","Democrat",0.687427231941879,48294,128834,0.374854463883757
1980,"NORTH CAROLINA",8,95013,67317,162330,"WG ""BILL"" HEFNER","LE HARRIS","Democrat",0.585307706523748,27696,162330,0.170615413047496
1980,"NORTH CAROLINA",9,71504,101156,172660,"RANDALL R KINCAID","JAMES G MARTIN","Republican",0.585868180238619,-29652,172660,-0.171736360477239
1980,"NORTH CAROLINA",10,52485,120777,173262,"JAMES O ICENHOUR","JAMES T BROYHILL","Republican",0.697077258718011,-68292,173262,-0.394154517436022
1980,"NORTH CAROLINA",11,90789,104485,195274,"LAMAR GUDGER","WILLIAM M ""BILL"" HENDON","Republican",0.53506867273677,-13696,195274,-0.0701373454735397
1980,"NORTH DAKOTA",0,166437,124707,293076,"BYRON L DORGAN","JIM SMYKOWSKI","Democrat",0.567897064242722,41730,291144,0.1433311351084
1980,"OHIO",1,38529,124080,166180,"DONALD J ZWICK","WILLIS D GRADISON JR","Republican",0.746660247923938,-85551,162609,-0.526114790694242
1980,"OHIO",2,103423,72693,176116,"THOMAS A LUKEN","TOM ""THEARON"" ATKINS","Democrat",0.587243634877013,30730,176116,0.174487269754026
1980,"OHIO",3,95558,66698,166869,"TONY P HALL","ALBERT H SEALY","Democrat",0.572652799501405,28860,162256,0.177867074253032
1980,"OHIO",4,51150,133795,184945,"GERRY TEBBEN","TENNYSON GUYER","Republican",0.723431290383628,-82645,184945,-0.446862580767255
1980,"OHIO",5,57704,137003,194707,"JAMES R SHERCK","DELBERT L LATTA","Republican",0.703636746496017,-79299,194707,-0.407273492992034
1980,"OHIO",6,84235,101288,185523,"TED STRICKLAND","BOB MCEWEN","Republican",0.545959261115872,-17053,185523,-0.0919185222317448
1980,"OHIO",7,38952,124137,163089,"DONALD HOLLISTER","CLARENCE J BROWN","Republican",0.761161083825396,-85185,163089,-0.522322167650792
1980,"OHIO",8,44162,139590,183752,"JOHN W GRIFFIN","THOMAS N KINDNESS","Republican",0.759665200922983,-95428,183752,-0.519330401845966
1980,"OHIO",9,68728,96927,172423,"THOMAS LUDLOW ASHLEY","ED WEBER","Republican",0.562146581372555,-28199,165655,-0.170227279587094
1980,"OHIO",10,49433,143403,192836,"JACK E STECHER","CLARENCE E MILLER","Republican",0.743652637474331,-93970,192836,-0.487305274948661
1980,"OHIO",11,51224,128507,185473,"PATRICK J DONLIN","J WILLIAM STANTON","Republican",0.692860955502957,-77283,179731,-0.4299926000523
1980,"OHIO",12,108690,98110,206804,"BOB SHAMANSKY","SAMUEL L DEVINE","Democrat",0.525570105026982,10580,206800,0.0511605415860735
1980,"OHIO",13,113439,64296,177735,"DONALD J PEASE","DAVID EARL ATMSTRONG","Democrat",0.63824795341379,49143,177735,0.27649590682758
1980,"OHIO",14,103336,55962,159298,"JOHN F SEIBERLING","LOUIS A MANGELS","Democrat",0.648696154377331,47374,159298,0.297392308754661
1980,"OHIO",15,48708,129025,177733,"TERRY FREEMAN","CHALMERS P WYLIE","Republican",0.725948473271705,-80317,177733,-0.451896946543411
1980,"OHIO",16,39219,149960,189179,"LARRY V SLAGLE","RALPH REGULA","Republican",0.792688406218449,-110741,189179,-0.585376812436898
1980,"OHIO",17,47900,128870,176770,"DONALD E YUNKER","JOHN M ASHBROOK","Republican",0.729026418509928,-80970,176770,-0.458052837019856
1980,"OHIO",18,134835,42354,177189,"DOUGLAS APPLEGATE","GARY L HAMMERSLEY","Democrat",0.760967102923996,92481,177189,0.521934205847993
1980,"OHIO",19,77272,107032,184304,"HARRY MESHEL","LYLE WILLIAMS","Republican",0.580736175015192,-29760,184304,-0.161472350030385
1980,"OHIO",21,83188,11103,94291,"LOUIS STOKES","ROBERT L WOODALL","Democrat",0.882247510366843,72085,94291,0.764495020733686
1980,"OHIO",22,108137,80836,195869,"DENNIS E ECKART","JOSEPH J NAHRA","Democrat",0.552088385604664,27301,188973,0.144470374074603
1980,"OKLAHOMA",1,115381,82293,197674,"JAMES R JONES","RICHARD C ""DICK"" FREEMAN","Democrat",0.583693353703573,33088,197674,0.167386707407145
1980,"OKLAHOMA",2,101516,86544,188060,"MIKE SYNAR","GARY RICHARDSON","Democrat",0.539806444751675,14972,188060,0.07961288950335
1980,"OKLAHOMA",4,74245,71339,145584,"DAVE MCCURDY","HOWARD RUTLEDGE","Democrat",0.509980492361798,2906,145584,0.019960984723596
1980,"OKLAHOMA",5,36815,90053,131590,"DAVID HOOD","MICKEY EDWARDS","Republican",0.684345314993541,-53238,126868,-0.419633004382508
1980,"OKLAHOMA",6,111694,60980,172674,"GLENN ENGLISH","CAROL MCCURLEY","Democrat",0.646848975526136,50714,172674,0.293697951052272
1980,"OREGON",1,203532,105083,308635,"LES AUCOIN","LYNN ENGDAHL","Democrat",0.659458583763993,98449,308615,0.319002640830809
1980,"OREGON",2,138089,141854,290748,"AL ULLMAN","DENNY SMITH","Republican",0.487893295912612,-3765,279943,-0.0134491664374533
1980,"OREGON",3,156371,60940,217423,"RON WYDEN","DARRELL R CONGER","Democrat",0.719201740386252,95431,217311,0.439144820096544
1980,"OREGON",4,158745,130861,289634,"JIM WEAVER","MICHAEL FITZGERALD","Democrat",0.548088276928814,27884,289606,0.0962825355828263
1980,"PENNSYLVANIA",1,52956,37893,155451,"MICHAEL MYERS","ROBERT R BURKE","Democrat",0.34066040102669,15063,90849,0.165802595515636
1980,"PENNSYLVANIA",3,67942,40866,124608,"RAYMOND F LEDERER","WILLIAM J PHILLIPS","Democrat",0.545245891114535,27076,108808,0.248841996911992
1980,"PENNSYLVANIA",4,73895,127475,201370,"THOMAS J MAGRANN","CHARLES F DOUGHERTY","Republican",0.633038685007697,-53580,201370,-0.266077370015395
1980,"PENNSYLVANIA",5,47092,148898,198235,"GRADY G BRICKHOUSE","RICHARD T SCHULZE","Republican",0.751118621837718,-101806,195990,-0.519444869636206
1980,"PENNSYLVANIA",6,117965,57844,175809,"GUS YATRON","GEORGE HULSHART","Democrat",0.670983851793708,60121,175809,0.341967703587416
1980,"PENNSYLVANIA",7,99381,87643,187024,"BOB EDGAR","DENNIS J ROCHFORD","Democrat",0.531380999230045,11738,187024,0.0627619984600907
1980,"PENNSYLVANIA",8,99593,103585,204345,"PETER H KOSTMAYER","JAMES K COYNE","Republican",0.506912329638601,-3992,203178,-0.019647796513402
1980,"PENNSYLVANIA",10,43152,145703,190319,"GENE BASALYGA","JOSEPH M MCDADE","Republican",0.765572538737593,-102551,188855,-0.543014482010008
1980,"PENNSYLVANIA",11,86703,93621,180324,"RAPHAEL MUSTO","JAMES L NELLIGAN","Republican",0.519182138816796,-6918,180324,-0.0383642776335929
1980,"PENNSYLVANIA",12,106750,72999,179749,"JOHN P MURTHA","CHARLES A GETTY","Democrat",0.593883693372425,33751,179749,0.18776738674485
1980,"PENNSYLVANIA",13,57745,138212,197584,"PETE SLAWEK","LAWRENCE COUGHLIN","Republican",0.699510081787999,-80467,195957,-0.41063600687906
1980,"PENNSYLVANIA",14,102545,44071,149624,"WILLIAM J COYNE","STAN THOMAS","Democrat",0.685351280543228,58474,146616,0.398824139248104
1980,"PENNSYLVANIA",15,66626,99874,167725,"JEANETTE REIBMAN","DON RITTER","Republican",0.595462811149203,-33248,166500,-0.199687687687688
1980,"PENNSYLVANIA",16,38891,129765,168656,"JAMES A WOODCOCK","ROBERT S WALKER","Republican",0.76940636561996,-90874,168656,-0.53881273123992
1980,"PENNSYLVANIA",17,97995,63790,161785,"ALLEN E ERTEL","DANIEL S SEIVERLING","Democrat",0.605711283493525,34205,161785,0.211422566987051
1980,"PENNSYLVANIA",18,127641,58821,186462,"DOUG WALGREN","STEVEN R SNYDER","Democrat",0.684541622421727,68820,186462,0.369083244843453
1980,"PENNSYLVANIA",19,41584,136873,180002,"RICHARD P NOLL","BILL GOODLING","Republican",0.760397106698814,-95289,178457,-0.533960561928083
1980,"PENNSYLVANIA",20,122100,46313,168413,"JOSEPH M GAYDOS","KATHLEEN M MEYER","Democrat",0.725003414225743,75787,168413,0.450006828451485
1980,"PENNSYLVANIA",21,112427,51821,164248,"DON BAILEY","DIRK MATSON","Democrat",0.684495397204228,60606,164248,0.368990794408456
1980,"PENNSYLVANIA",22,118084,50020,169768,"AUSTIN J MURPHY","MARILYN COYLE ECOFF","Democrat",0.69556100089534,68064,168104,0.404892209584543
1980,"PENNSYLVANIA",23,41033,122855,167046,"PETER ATIGAN","BILL CLINGER","Republican",0.735456101912048,-81822,163888,-0.499255589182857
1980,"PENNSYLVANIA",24,86567,86687,174555,"DAVID C DICARLO","MARC LINCOLN MARKS","Republican",0.496617112085016,-120,173254,-0.000692624701305598
1980,"PENNSYLVANIA",25,119817,58768,178585,"EUGENE V ATKINSON","ROBERT MORRIS","Democrat",0.670924209760058,61049,178585,0.341848419520116
1980,"RHODE ISLAND",1,120756,57844,178600,"FERNAND J ST GERMAIN","WILLIAM P MONTGOMERY","Democrat",0.676125419932811,62912,178600,0.352250839865622
1980,"RHODE ISLAND",2,92970,115057,208027,"EDWARD P BEARD","CLAUDINE SCHNEIDER","Republican",0.553086858917352,-22087,208027,-0.106173717834704
1980,"SOUTH CAROLINA",1,76743,81988,158731,"CHARLES D RAVENEL","THOMAS F HARTNETT","Republican",0.516521662435189,-5245,158731,-0.0330433248703782
1980,"SOUTH CAROLINA",2,73353,92306,165659,"TOM TURNIPSEED","FLOYD SPENCE","Republican",0.55720486058711,-18953,165659,-0.114409721174219
1980,"SOUTH CAROLINA",3,87680,57840,146638,"BUTLER DERRICK","MARSHALL PARKER","Democrat",0.597935050941775,29840,145520,0.205057724024189
1980,"SOUTH CAROLINA",6,70747,75964,146711,"JOHN W JENRETTE JR","JOHN L NAPIER","Republican",0.517779852908098,-5217,146711,-0.0355597058161965
1980,"SOUTH DAKOTA",1,109910,57155,167065,"THOMAS A DASCHLE","BART KULL","Democrat",0.657887648520037,52755,167065,0.315775297040074
1980,"SOUTH DAKOTA",2,63447,88991,152438,"KENNETH D STOFFERAHN","CLINT ROBERTS","Republican",0.583784883034414,-25544,152438,-0.167569766068828
1980,"TENNESSEE",2,46578,147947,194527,"DAVID H ""DAVE"" DUNNAWAY","JOHN J DUNCAN","Republican",0.760547379027076,-101369,194525,-0.521110397121193
1980,"TENNESSEE",3,117355,74761,192156,"MARILYN LLOYD BOUQUARD","GLEN BYERS","Democrat",0.610727742042923,42594,192116,0.221709800328968
1980,"TENNESSEE",4,137612,35954,173570,"ALBERT GORE JR","JAMES BEAU SEIGNEUR","Democrat",0.792832862821916,101658,173566,0.585702268877545
1980,"TENNESSEE",5,118506,62746,181262,"BILL BONER","MIKE ADAMS","Democrat",0.65378292195827,55760,181252,0.307637984684307
1980,"TENNESSEE",7,133606,39227,172835,"ED JONES","DANIEL CAMPBELL","Democrat",0.773026296757023,94379,172833,0.546070484224656
1980,"TEXAS",2,142496,60742,205768,"CHARLES WILSON","FH PANNILL SR","Democrat",0.692508067337973,81754,203238,0.402257451854476
1980,"TEXAS",3,49667,218228,275234,"EARLE STEPHEN PORTER","JIM COLLINS","Republican",0.792881693395438,-168561,267895,-0.629205472293249
1980,"TEXAS",4,102787,93915,196702,"RALPH M HALL","JOHN WRIGHT","Democrat",0.522551880509603,8872,196702,0.0451037610192067
1980,"TEXAS",5,70892,67848,139035,"JIM MATTOX","TOM PAUKEN","Democrat",0.509885999928076,3044,138740,0.0219403200230647
1980,"TEXAS",6,144816,59503,204319,"PHIL GRAMM","DAVE ""BUSTER"" HASKINS","Democrat",0.708774024931602,85313,204319,0.417548049863204
1980,"TEXAS",7,48594,242810,295684,"ROBERT L HUTCHINGS","BILL ARCHER","Republican",0.821180719957793,-194216,291404,-0.666483644699455
1980,"TEXAS",8,67921,72856,140777,"BOB ECKHARDT","JACK FIELDS","Republican",0.517527721147631,-4935,140777,-0.0350554422952613
1980,"TEXAS",10,135618,88940,229424,"JJ ""JAKE"" PICKLE","JOHN BIGGAR","Democrat",0.591123858009624,46678,224558,0.207866119220869
1980,"TEXAS",12,99104,65005,165390,"JIM WRIGHT","JIM BRADSHAW","Democrat",0.599213979079751,34099,164109,0.20778263227489
1980,"TEXAS",13,98779,80819,179598,"JACK HIGHTOWER","RON SLOVER","Democrat",0.550000556799073,17960,179598,0.100001113598147
1980,"TEXAS",14,93884,71495,165379,"WILLIAM N ""BILL"" PATMAN","CL CONCKLIN","Democrat",0.567689972729307,22389,165379,0.135379945458613
1980,"TEXAS",15,105325,45090,150415,"E ""KIKA"" DE LA GARZA","LENDY MCDONALD","Democrat",0.700229365422331,60235,150415,0.400458730844663
1980,"TEXAS",18,71985,16128,90096,"MICKEY LELAND","CL KENNEDY","Democrat",0.798981086840703,55857,88113,0.633924619522658
1980,"TEXAS",20,84113,17725,102685,"HENRY B GONZALEZ","MERLE NASH","Democrat",0.819136193212251,66388,101838,0.65189811268878
1980,"TEXAS",21,58425,196424,256744,"JOE SULLIVAN","TOM LOEFFLER","Republican",0.765057800766522,-137999,254849,-0.541493197932894
1980,"TEXAS",22,101094,106797,209251,"MIKE ANDREWS","RON PAUL","Republican",0.510377489235416,-5703,207891,-0.0274326449918467
1980,"TEXAS",23,104595,45139,149780,"ABRAHAM ""CHICK"" KAZEN JR","BOBBY LOCKE","Democrat",0.698324208839631,59456,149734,0.397077484071754
1980,"TEXAS",24,93690,59172,152862,"MARTIN FROST","CLAY SMOTHERS","Democrat",0.612905758134788,34518,152862,0.225811516269576
1980,"UTAH",1,144459,157111,301570,"GUNN MCKAY","JAMES V HANSEN","Republican",0.520976887621448,-12652,301570,-0.0419537752428955
1980,"UTAH",2,87967,194885,290765,"ARTHUR L MONSON","DAN MARRIOTT","Republican",0.67024917029216,-106918,282852,-0.377999802016602
1980,"VIRGINIA",3,60962,96524,186912,"JOHN A MAPP","THOMAS J ""TOM"" BLILEY JR","Republican",0.516414141414141,-35562,157486,-0.225810548239209
1980,"VIRGINIA",4,59930,92557,152494,"CECIL Y JENKINS","ROBERT W ""BOB"" DANIEL JR","Republican",0.606955027738796,-32627,152487,-0.213965780689501
1980,"VIRGINIA",8,94530,95624,195897,"HERBERT E HARRIS II","STANFORD E ""STAN"" PARRIS","Republican",0.488134070455392,-1094,190154,-0.00575323159123658
1980,"VIRGINIA",9,52636,119196,171864,"ROOSEVELT FERGUSON","WILLIAM C WAMPLER","Republican",0.693548387096774,-66560,171832,-0.387355091019135
1980,"VIRGINIA",10,105883,110840,216744,"JOSEPH L FISHER","FRANK R WOLF","Republican",0.511386705052966,-4957,216723,-0.0228725146846435
1980,"WASHINGTON",1,41830,180475,230534,"ROBIN DRAKE","JOEL PRITCHARD","Republican",0.782856324880495,-138645,222305,-0.623670182856886
1980,"WASHINGTON",2,162002,82639,253688,"AL SWIFT","NEAL SNIDER","Democrat",0.638587556368453,79363,244641,0.324405966293467
1980,"WASHINGTON",3,155906,92872,248778,"DON BONKER","ROD CULP","Democrat",0.62668724726463,63034,248778,0.253374494529259
1980,"WASHINGTON",4,100114,134691,234805,"MIKE MCCORMACK","SID MORRISON","Republican",0.573629181661379,-34577,234805,-0.147258363322757
1980,"WASHINGTON",5,120530,111705,232235,"THOMAS S FOLEY","JOHN SONNELAND","Democrat",0.519000150709411,8825,232235,0.0380003014188214
1980,"WASHINGTON",6,122903,106236,229139,"NORMAN D DICKS","JIM BEAVER","Democrat",0.536368754336887,16667,229139,0.0727375086737744
1980,"WASHINGTON",7,112848,84218,197066,"MIKE LOWRY","RON DUNLAP","Democrat",0.572640638161834,28630,197066,0.145281276323668
1980,"WEST VIRGINIA",1,107471,61438,168909,"ROBERT H MOLLOHAN","JOE BARTLETT","Democrat",0.636265681520819,46033,168909,0.272531363041638
1980,"WEST VIRGINIA",2,80940,102805,183745,"PAT R HAMILTON","CLEVE BENEDICT","Republican",0.559498217638575,-21865,183745,-0.11899643527715
1980,"WEST VIRGINIA",3,84980,94583,179563,"JOHN G HUTCHINSON","MICK STATON","Republican",0.526739918580108,-9603,179563,-0.0534798371602168
1980,"WEST VIRGINIA",4,117595,36020,153615,"NICK JOE RAHALL II","WINTON GUY COVEY JR","Democrat",0.76551769032972,81575,153615,0.531035380659441
1980,"WISCONSIN",1,126222,96047,224442,"LES ASPIN","KATHRYN H CANARY","Democrat",0.562381372470393,30175,222269,0.135758922746762
1980,"WISCONSIN",2,142037,119514,263138,"ROBERT KASTENMEIER","JAMES A WRIGHT","Democrat",0.539781407474405,22523,261551,0.0861132245718808
1980,"WISCONSIN",3,126859,132001,258868,"ALVIN J BALDUS","STEVEN GUNDERSON","Republican",0.50991625075328,-5142,258860,-0.0198640191609364
1980,"WISCONSIN",4,146437,61027,209139,"CLEMENT J ZABLOCKI","ELROY C HONADEL","Democrat",0.700189825905259,85410,207464,0.411685882851965
1980,"WISCONSIN",5,129574,37267,168218,"HENRY S REUSS","DAVID BATHKE","Democrat",0.770274286937189,92307,166841,0.553263286602214
1980,"WISCONSIN",6,98628,143980,242611,"GARY R GOYKE","THOMAS E PETRI","Republican",0.593460313011364,-45352,242608,-0.186935303040295
1980,"WISCONSIN",7,164340,89745,254107,"DAVID OBEY","VINTON A VESTA","Democrat",0.646735430350207,74595,254085,0.293582856130822
1980,"WISCONSIN",8,81043,169664,250726,"MICHAEL R MONFILS","TOBY ROTH","Republican",0.676690889656438,-88621,250707,-0.353484346268752
1980,"WISCONSIN",9,56838,206227,263079,"GARY C BENEDICT","F JAMES SENSENBRENNER JR","Republican",0.783897612504229,-149389,263065,-0.567878661167392
1980,"WYOMING",0,53338,116361,169699,"JIM ROGERS","DICK CHENEY","Republican",0.685690546202394,-63023,169699,-0.371381092404787
1982,"ALABAMA",1,54315,87901,144028,"STEVE GUDAC","JACK EDWARDS","Republican",0.610304940705974,-33586,142216,-0.236161894582888
1982,"ALABAMA",2,81904,83290,165194,"BILLY JOE CAMP","BILL DICKINSON","Republican",0.504195067617468,-1386,165194,-0.00839013523493589
1982,"ALABAMA",5,108807,24593,134880,"RONNIE G FLIPPO","LEO YAMBREK","Democrat",0.806694839857651,84214,133400,0.631289355322339
1982,"ALABAMA",6,88029,76726,165387,"BEN ERDREICH","ALBERT LEE SMITH JR","Democrat",0.532260697636453,11303,164755,0.0686048981821493
1982,"ALASKA",0,52011,128274,181084,"DAVE CARLSON","DON YOUNG","Republican",0.708367387510768,-76263,180285,-0.423013561860388
1982,"ARIZONA",1,41261,89116,135227,"WILLIAM E ""BILL"" HEGARTY","JOHN MCCAIN","Republican",0.659010404726867,-47855,130377,-0.367050936898379
1982,"ARIZONA",2,73468,28407,103674,"MORRIS K UDALL","ROY B LAOS","Democrat",0.708644404575882,45061,101875,0.442316564417178
1982,"ARIZONA",3,58644,101198,159842,"PAT BOSCH","BOB STUMP","Republican",0.633112698790055,-42554,159842,-0.26622539758011
1982,"ARIZONA",4,44182,95620,145466,"WAYNE O EARLEY","ELDON RUDD","Republican",0.657335734810884,-51438,139802,-0.367934650434185
1982,"ARIZONA",5,82938,80531,166802,"JIM MCNULTY","JIM KOLBE","Democrat",0.497224253905828,2407,163469,0.0147245043402725
1982,"ARKANSAS",1,124208,67427,191635,"BILL ALEXANDER","CHUCK BANKS","Democrat",0.64814882458841,56781,191635,0.29629764917682
1982,"ARKANSAS",2,82913,96775,179688,"CHARLES L GEORGE","ED BETHUNE","Republican",0.538572414407195,-13862,179688,-0.0771448288143894
1982,"ARKANSAS",3,69089,133909,202998,"JIM MCDOUGAL","JOHN PAUL HAMMERSCHMIDT","Republican",0.659656745386654,-64820,202998,-0.319313490773308
1982,"ARKANSAS",4,121256,63661,184917,"BERLY ANTHONY JR","BOB LESLIE","Democrat",0.655732031127479,57595,184917,0.311464062254958
1982,"CALIFORNIA",1,107749,102043,216166,"DOUGLAS H BOSCO","DON H CLAUSEN","Democrat",0.498454891148469,5706,209792,0.0271983679072605
1982,"CALIFORNIA",2,81314,116172,200612,"JOHN NEWMEYER","GENE CHAPPIE","Republican",0.57908799074831,-34858,197486,-0.17650871454179
1982,"CALIFORNIA",4,118476,67047,185523,"VIC FAZIO","ROGER B CANFIELD","Democrat",0.638605455927297,51429,185523,0.277210911854595
1982,"CALIFORNIA",5,103268,72139,178311,"PHILLIP BURTON","MILTON MARKS","Democrat",0.579145425688825,31129,175407,0.17746726185386
1982,"CALIFORNIA",6,96379,82128,184064,"BARBARA BOXER","DENNIS MCQUAID","Democrat",0.523616785465925,14251,178507,0.0798344042530545
1982,"CALIFORNIA",7,126952,56960,188869,"GEORGE MILLER","PAUL E VALLELY","Democrat",0.672169599034251,69992,183912,0.38057331767367
1982,"CALIFORNIA",8,121537,95694,217231,"RONALD V DELLUMS","CLAUDE B HUTCHISON JR","Democrat",0.559482762589133,25843,217231,0.118965525178266
1982,"CALIFORNIA",9,104393,67702,172095,"FORTNEY H ""PETE"" STARK","BILL KENNEDY","Democrat",0.606601005258723,36691,172095,0.213202010517447
1982,"CALIFORNIA",10,77263,41506,123281,"DON EDWARDS","BOB HERRIOTT","Democrat",0.626722690438916,35757,118769,0.30106340880196
1982,"CALIFORNIA",11,109812,76462,192372,"TOM LANTOS","BILL ROYER","Democrat",0.570831513941738,33350,186274,0.179037332102172
1982,"CALIFORNIA",12,61372,115365,183208,"EMMETT LYNCH","ED ZSCHAU","Republican",0.629694118160779,-53993,176737,-0.305499131477846
1982,"CALIFORNIA",13,110805,52806,168164,"NORMAN Y MINETA","TOM KELLY","Democrat",0.658910349420804,57999,163611,0.354493279791701
1982,"CALIFORNIA",14,77400,134225,211625,"BARON REED","NORMAN D SHUMWAY","Republican",0.63425871234495,-56825,211625,-0.2685174246899
1982,"CALIFORNIA",15,86022,45948,135043,"TONY COELHO","ED BATES","Democrat",0.636997104625934,40074,131970,0.303659922709707
1982,"CALIFORNIA",16,142630,24448,167078,"LEON E PANETTA","G RICHARD ARNOLD","Democrat",0.853673134703552,118182,167078,0.707346269407103
1982,"CALIFORNIA",17,68364,80271,148635,"GENE TACKETT","CHARLES PASHAYAN JR","Republican",0.540054495912807,-11907,148635,-0.0801089918256131
1982,"CALIFORNIA",18,92762,59664,155927,"RICHARD LEHMAN","ADRIAN C FONDE","Democrat",0.594906590904718,33098,152426,0.217141432563998
1982,"CALIFORNIA",19,66042,112486,184246,"FRANK FROST","ROBERT J ""BOB"" LAGOMARSINO","Republican",0.610520716867666,-46444,178528,-0.260149668399355
1982,"CALIFORNIA",20,57769,123312,181081,"ROBERT J BETHEA","WILLIAM M THOMAS","Republican",0.680977021332995,-65543,181081,-0.361954042665989
1982,"CALIFORNIA",21,46412,138474,192767,"GEORGE HENRY MARGOLIS","BOBBI FIEDLER","Republican",0.718349095021451,-92062,184886,-0.49793927068572
1982,"CALIFORNIA",22,46521,145831,198222,"HARVEY L GOLDHAMMER","CARLOS J MOORHEAD","Republican",0.735695331497008,-99310,192352,-0.516293046082183
1982,"CALIFORNIA",23,120788,82031,202819,"ANTHONY C BEILENSON","DAVID ARMOR","Democrat",0.595545782199893,38757,202819,0.191091564399785
1982,"CALIFORNIA",24,88516,42133,136069,"HENRY A WAXMAN","JERRY ZERG","Democrat",0.650522896471643,46383,130649,0.355019938920313
1982,"CALIFORNIA",26,97383,66072,163455,"HOWARD L BERMAN","HAL PHILIPS","Democrat",0.595778654675599,31311,163455,0.191557309351198
1982,"CALIFORNIA",27,108347,67479,182217,"MEL LEVINE","BART W CHRISTENSEN","Democrat",0.594604235609191,40868,175826,0.232434338493738
1982,"CALIFORNIA",28,103469,24473,131152,"JULIAN DIXON","DAVID GOERZ","Democrat",0.788924301573746,78996,127942,0.617436025699145
1982,"CALIFORNIA",29,97028,24568,121596,"AUGUSTUS F ""GUS"" HAWKINS","MILTON R MACKAIG","Democrat",0.797953880061844,72460,121596,0.595907760123688
1982,"CALIFORNIA",30,60905,52177,113082,"MATTHEW G MARTINEZ","JOHN H ROUSSELOT","Democrat",0.538591464600909,8728,113082,0.0771829292018181
1982,"CALIFORNIA",31,86718,33043,119761,"MERVYN M DYMALLY","HENRY C MINTURN","Democrat",0.724092150199147,53675,119761,0.448184300398293
1982,"CALIFORNIA",32,84663,57863,145999,"GLENN M ANDERSON","BRIAN LUNGREN","Democrat",0.579887533476257,26800,142526,0.188035867140031
1982,"CALIFORNIA",33,55514,112362,172350,"PAUL SERVELLE","DAVID DREIER","Republican",0.651940818102698,-56848,167876,-0.338630894231457
1982,"CALIFORNIA",34,68316,51026,119342,"ESTEBAN ED TORRES","PAUL R JACKSON","Democrat",0.572438873154464,17290,119342,0.144877746308927
1982,"CALIFORNIA",35,52349,112786,165135,"ROBERT E ERWIN","JERRY LEWIS","Republican",0.682992702940019,-60437,165135,-0.365985405880038
1982,"CALIFORNIA",36,76546,64361,140907,"GEORGE E BROWN JR","JOHN PAUL STARK","Democrat",0.54323773836644,12185,140907,0.0864754767328806
1982,"CALIFORNIA",37,68510,105065,177872,"CURTIS R ""SAM"" CROSS","AL MCCANDLESS","Republican",0.590677565890078,-36555,173575,-0.210600604925825
1982,"CALIFORNIA",38,73914,61279,141182,"JERRY M PATTERSON","WILLIAM F ""BILL"" DOHR","Democrat",0.523536994801037,12635,135193,0.0934589808643939
1982,"CALIFORNIA",39,46681,129539,179372,"FRANK G VERGES","WILLIAM E ""BILL"" DANNEMEYER","Republican",0.722180719398791,-82858,176220,-0.470196345477244
1982,"CALIFORNIA",40,52546,144228,201600,"PAUL HASEMAN","ROBERT E BADHAM","Republican",0.715416666666667,-91682,196774,-0.465925376320042
1982,"CALIFORNIA",41,58677,140130,203461,"TONY BRANDENBURG","BILL LOWERY","Republican",0.688731501368813,-81453,198807,-0.409708913670042
1982,"CALIFORNIA",42,58690,142845,207049,"JAMES P SPELLMAN","DAN LUNGREN","Republican",0.689909151939879,-84155,201535,-0.417570149105614
1982,"CALIFORNIA",43,57995,122741,180736,"ROY ""PAT"" ARCHER","JOHNNIE R CREAN","Republican",0.679117608002833,-64746,180736,-0.358235216005666
1982,"CALIFORNIA",44,78474,38447,120825,"JIM BATES","SHIRLEY M GISSENDANNER","Democrat",0.649484792054625,40027,116921,0.342342265290239
1982,"CALIFORNIA",45,50148,117771,171758,"RICHARD HILL","DUNCAN HUNTER","Republican",0.685679851884628,-67623,167919,-0.402712021867686
1982,"COLORADO",1,94969,59009,157597,"PATRICIA SCHROEDER","ARCH DECKER","Democrat",0.602606648603717,35960,153978,0.233539856343114
1982,"COLORADO",2,101194,59580,163636,"TIMOTHY E WIRTH","JOHN C BUECHNER","Democrat",0.618409152020338,41614,160774,0.258835383830719
1982,"COLORADO",3,92384,77409,172888,"RAY KOGOVSEK","TOM WIENS","Democrat",0.534357503123409,14975,169793,0.0881956264392525
1982,"COLORADO",4,45750,105550,151300,"CHARLES L ""BUD"" BISHOPP","HANK BROWN","Republican",0.697620621282221,-59800,151300,-0.395241242564441
1982,"COLORADO",5,57392,84479,141871,"TOM CRONIN","KEN KRAMER","Republican",0.595463484433041,-27087,141871,-0.190926968866083
1982,"COLORADO",6,56598,98909,159112,"STEVE HOGAN","JACK SWIGERT","Republican",0.621631303735733,-42311,155507,-0.272084214858495
1982,"CONNECTICUT",1,126798,58075,186110,"BARBARA BAILEY KENNELLY","HERSCHEL A KLEIN","Democrat",0.681306754070174,68723,184873,0.371730863890346
1982,"CONNECTICUT",2,95254,74294,170803,"SAMUEL GEJDENSON","TONY GUGLIELMO","Democrat",0.557683413054806,20960,169548,0.123622808880081
1982,"CONNECTICUT",3,90638,88951,181449,"BRUCE A MORRISON","LAWRENCE J DENARDIS","Democrat",0.49952328202415,1687,179589,0.00939367110457767
1982,"CONNECTICUT",4,71110,93660,165897,"JOHN ARISTOTLE PHILLIPS","STEWART B MCKINNEY","Republican",0.564567171196586,-22550,164770,-0.136857437640347
1982,"CONNECTICUT",5,101362,70808,173373,"WILLIAM R RATCHFORD","NEAL B HANLON","Democrat",0.584646975019178,30554,172170,0.17746413428588
1982,"CONNECTICUT",6,92178,99703,192972,"WILLIAM E CURRY JR","NANCY L JOHNSON","Republican",0.516670812345833,-7525,191881,-0.0392170147122435
1982,"DELAWARE",0,98533,87153,188064,"THOMAS R CARPER","THOMAS B EVANS JR","Democrat",0.523933341841075,11380,185686,0.0612862574453648
1982,"FLORIDA",1,82569,28373,110942,"EARL HUTTO","J TERRYL BECHTOL","Democrat",0.744253754213914,54196,110942,0.488507508427827
1982,"FLORIDA",2,79143,49101,128244,"DON FUQUA","RON MCNEIL","Democrat",0.617128286703472,30042,128244,0.234256573406943
1982,"FLORIDA",3,73802,13972,87774,"CHARLES E BENNETT","GEORGE GRIMSLEY","Democrat",0.840818465604849,59830,87774,0.681636931209698
1982,"FLORIDA",4,83895,41457,125352,"BILL CHAPPELL","LARRY GAUDET","Democrat",0.669275320696918,42438,125352,0.338550641393835
1982,"FLORIDA",5,49070,69993,119063,"DICK BATCHELOR","BILL MCCOLLUM","Republican",0.587865247809983,-20923,119063,-0.175730495619966
1982,"FLORIDA",6,85825,54059,139897,"BUDDY MACKAY","ED HAVILL","Democrat",0.613487065483892,31766,139884,0.227088158760116
1982,"FLORIDA",7,85331,29632,114963,"SAM M GIBBONS","KEN AYERS","Democrat",0.742247505719231,55699,114963,0.484495011438463
1982,"FLORIDA",9,90697,95009,185742,"GEORGE H SHELDON","MICHAEL BILIRAKIS","Republican",0.511510589958114,-4312,185706,-0.0232194974852724
1982,"FLORIDA",11,101746,42422,144168,"BILL NELSON","JOEL ROBINSON","Democrat",0.705746074024749,59324,144168,0.411492148049498
1982,"FLORIDA",12,73913,81893,155806,"BRAD CULVERHOUSE","TOM LEWIS","Republican",0.525608769880492,-7980,155806,-0.0512175397609848
1982,"FLORIDA",13,71239,132951,204190,"DANA N STEVENS","CONNIE MACK","Republican",0.651114158381899,-61712,204190,-0.302228316763798
1982,"FLORIDA",14,128646,47560,176206,"DAN MICA","STEVE MITCHELL","Democrat",0.730088646243601,81086,176206,0.460177292487202
1982,"FLORIDA",15,67083,89158,156241,"EDWARD J ""ED"" STACK","E CLAY SHAW JR","Republican",0.57064406909838,-22075,156241,-0.14128813819676
1982,"FLORIDA",16,91888,43458,135346,"LARRY SMITH","MAURICE BERKOWITZ","Democrat",0.67891182598673,48430,135346,0.357823651973461
1982,"FLORIDA",18,72183,29196,101379,"CLAUDE PEPPER","RICARDO NUNEZ","Democrat",0.712011363300092,42987,101379,0.424022726600183
1982,"FLORIDA",19,74312,51969,126281,"DANTE B FASCELL","GLENN RINKER","Democrat",0.588465406514044,22343,126281,0.176930813028088
1982,"GEORGIA",1,65625,36799,102425,"LINDSAY THOMAS","HERB JONES","Democrat",0.640712716621919,28826,102424,0.281437944231821
1982,"GEORGIA",3,74626,30537,105171,"RICHARD RAY","TYRON ELLIOTT","Democrat",0.709568226982723,44089,105163,0.419244411057121
1982,"GEORGIA",4,38758,20418,59184,"ELLIIOTT H LEVITAS","DICK WINDER","Democrat",0.654872938632063,18340,59176,0.309922941733135
1982,"GEORGIA",5,53264,3633,65955,"WYCHE FOWLER JR","PAUL JONES","Democrat",0.807580926389205,49631,56897,0.872295551610806
1982,"GEORGIA",6,50459,62352,112812,"JIM WOOD","NEWT GINGRICH","Republican",0.552707158812892,-11893,112811,-0.105424116442545
1982,"GEORGIA",7,71647,45569,117224,"LARRY MCDONALD","DAVE SELLERS","Democrat",0.611197365727155,26078,117216,0.22247815997816
1982,"GEORGIA",9,86514,25907,112422,"ED JENKINS","CHARLES SHERWOOD","Democrat",0.76954688584085,60607,112421,0.539107462128962
1982,"IDAHO",1,74388,86277,160665,"LARRY LA ROCCO","LARRY CRAIG","Republican",0.53699934646625,-11889,160665,-0.0739986929324993
1982,"IDAHO",2,76608,83873,160481,"RICHARD STALLINGS","GEORGE HANSEN","Republican",0.522635078295873,-7265,160481,-0.0452701565917461
1982,"ILLINOIS",1,172641,4820,177462,"HAROLD WASHINGTON","CHARLES ALLEN TALIAFERRO","Democrat",0.972833620718802,167821,177461,0.945678205352162
1982,"ILLINOIS",2,140827,20670,161794,"GUS SAVAGE","KEVIN WALKER SPARKS","Democrat",0.870409285882048,120157,161497,0.744020012755655
1982,"ILLINOIS",3,137391,48268,185659,"MARTIN A RUSSO","RICHARD D MURPHY","Democrat",0.740017989970861,89123,185659,0.480035979941721
1982,"ILLINOIS",4,66323,79842,146172,"MICHAEL A MURER","GEORGE M O'BRIEN","Republican",0.546219522206715,-13519,146165,-0.0924913625012828
1982,"ILLINOIS",5,110351,35970,146322,"WILLIAM O LIPINSKI","DANIEL J PARTYKA","Democrat",0.754165470674266,74381,146321,0.508341249718086
1982,"ILLINOIS",6,45237,97918,143168,"LEROY E KENNEL","HENRY J HYDE","Republican",0.683937751452839,-52681,143155,-0.367999720582585
1982,"ILLINOIS",7,133978,20994,154974,"CARDISS COLLINS","DANSBY ""DAN"" CHEEKS","Democrat",0.864519209673881,112984,154972,0.729060733551867
1982,"ILLINOIS",8,124318,24666,148985,"DAN ROSTENKOWSKI","BONNIE HICKEY","Democrat",0.834432996610397,99652,148984,0.668877194866563
1982,"ILLINOIS",9,114083,54851,171529,"SIDNEY R YATES","CATHERINE BERTINI","Democrat",0.665094532119933,59232,168934,0.350622136455657
1982,"ILLINOIS",10,63115,90750,153868,"EUGENIA S CHAPMAN","JOHN EDWARD PORTER","Republican",0.589791249642551,-27635,153865,-0.179605498326455
1982,"ILLINOIS",11,134755,50967,185722,"FRANK ANNUNZIO","JAMES F MOYNIHAN","Democrat",0.725573706938327,83788,185722,0.451147413876654
1982,"ILLINOIS",12,40108,86487,130701,"DANIEL G DEFOSSE","PHILIP M CRANE","Republican",0.661716436752588,-46379,126595,-0.36635728109325
1982,"ILLINOIS",13,49105,113423,162530,"ROBERT ""BOB"" BILY","JOHN N ERLENBORN","Republican",0.697858856826432,-64318,162528,-0.395734888757629
1982,"ILLINOIS",14,53914,98262,152180,"DAN MCGRATH","TOM CORCORAN","Republican",0.645695886450256,-44348,152176,-0.291425717590159
1982,"ILLINOIS",15,53303,105038,158344,"TIM L HALL","EDWARD R MADIGAN","Republican",0.663353205678775,-51735,158341,-0.326731547735583
1982,"ILLINOIS",16,66877,89405,156287,"CARL R ""SKIP"" SCHWERDTFEGER","LYNN MARTIN","Republican",0.572056537012036,-22528,156282,-0.144149678145916
1982,"ILLINOIS",17,94483,84347,178887,"LANE EVAMS","KENNETH G MCMILLAN","Democrat",0.528171415474573,10136,178830,0.0566795280433932
1982,"ILLINOIS",18,91281,97406,188694,"G DOUGLAS STEPHENS","ROBERT H MICHEL","Republican",0.516211432265997,-6125,188687,-0.0324611658460837
1982,"ILLINOIS",19,87231,94833,182064,"JOHN GWINN","DANIEL B CRANE","Republican",0.520877273925653,-7602,182064,-0.041754547851305
1982,"ILLINOIS",20,100758,99348,200109,"RICHARD J DURBIN","PAUL FINDLEY","Democrat",0.503515584006716,1410,200106,0.00704626547929597
1982,"ILLINOIS",21,89500,46764,140608,"MELVIN PRICE","ROBERT H GAFFNER","Democrat",0.636521392808375,42736,136264,0.313626489755181
1982,"ILLINOIS",22,123693,63279,186972,"PAUL SIMON","PETER G PRINEAS","Democrat",0.661558950003209,60414,186972,0.323117900006418
1982,"INDIANA",1,87369,66921,155096,"KATIE HALL","THOMAS H KRIEGER","Democrat",0.563322071491206,20448,154290,0.132529651954112
1982,"INDIANA",2,107298,83593,190891,"PHILIP R SHARP","RALPH VANNATTA","Democrat",0.562090407614817,23705,190891,0.124180815229634
1982,"INDIANA",3,83046,86958,170004,"RICHARD CLAY BODINE","JOHN P HILER","Republican",0.511505611632668,-3912,170004,-0.0230112232653349
1982,"INDIANA",4,60054,110115,171198,"ROGER M MILLER","DAN COATS","Republican",0.643202607507097,-50061,170169,-0.294184017065388
1982,"INDIANA",5,67238,105469,172707,"ALLEN B MAXWELL","ELWOOD H ""BUD"" HILLIS","Republican",0.61068167474393,-38231,172707,-0.221363349487861
1982,"INDIANA",6,70764,131100,201864,"GEORGE G GRABIANOWSKI","DAN BURTON","Republican",0.649447152538343,-60336,201864,-0.298894305076685
1982,"INDIANA",7,70249,115884,186133,"STEPHEN S BONNEY","JOHN T MYERS","Republican",0.622587074833587,-45635,186133,-0.245174149667173
1982,"INDIANA",8,100592,94127,195725,"FRANCIS X MCCLOSKEY","JOEL DECKARD","Democrat",0.513945586920424,6465,194719,0.0332016906413858
1982,"INDIANA",9,121094,58532,180539,"LEE HERBERT HAMILTON","FLOYD COATES","Democrat",0.670735962866749,62562,179626,0.348290336588244
1982,"INDIANA",10,114674,56992,171863,"ANDREW JACOBS JR","MICHAEL A CARROLL","Democrat",0.667240767355394,57682,171666,0.336012955390118
1982,"IOWA",1,61734,89595,151342,"WILLIAM E GLUBA","JIM LEACH","Republican",0.592003541647395,-27861,151329,-0.184108796066848
1982,"IOWA",2,69539,99478,169037,"BRENT APPEL","TOM TAUKE","Republican",0.588498376095174,-29939,169017,-0.177136027736855
1982,"IOWA",3,83581,104072,187675,"LYNN G CUTLER","COOPER EVANS","Republican",0.554533102437725,-20491,187653,-0.109196229210298
1982,"IOWA",4,118849,60534,179972,"NEAL SMITH","DAVE READINGER","Democrat",0.660374947214011,58315,179383,0.325086546662727
1982,"IOWA",5,93333,65200,158563,"TOM HARKIN","ARLYN E DANKER","Democrat",0.588617773377143,28133,158533,0.17745832098049
1982,"IOWA",6,101690,56487,158184,"BERKLEY BEDELL","AL BREMER","Democrat",0.642858949071967,45203,158177,0.285774796588632
1982,"KANSAS",1,51079,115749,169133,"KENT ROTH","PAT ROBERTS","Republican",0.684366740967168,-64670,166828,-0.387644759872443
1982,"KANSAS",2,86286,63942,150228,"JIM SLATTERY","MORRIS KAY","Democrat",0.57436696221743,22344,150228,0.148733924434859
1982,"KANSAS",3,53140,82117,138696,"WILLIAM L KOSTAR","LARRY WINN JR","Republican",0.592064659398973,-28977,135257,-0.214236601432828
1982,"KANSAS",4,107326,35478,145167,"DAN GLICKMAN","GERALD ""JERRY"" CAYWOOD","Democrat",0.739327808661748,71848,142804,0.503123161816196
1982,"KANSAS",5,47676,103551,153121,"LEE ROWE","BOB WHITTAKER","Republican",0.676269094376343,-55875,151227,-0.369477672637823
1982,"KENTUCKY",2,49571,17561,67138,"WILLIAM H NATCHER","MARK WATSON","Democrat",0.738344901546069,32010,67132,0.476821783948043
1982,"KENTUCKY",3,92849,45900,142597,"ROMANO L MAZZOLI","CARL BROWN","Democrat",0.651128705372483,46949,138749,0.338373609899891
1982,"KENTUCKY",4,61937,74109,136750,"TERRY L MANN","GENE SNYDER","Republican",0.541930530164534,-12172,136046,-0.0894697381767931
1982,"KENTUCKY",5,28285,52928,81217,"DOYE DAVENPORT","HAROLD ""HAL"" ROGERS","Republican",0.651686223327628,-24643,81213,-0.303436641916934
1982,"KENTUCKY",6,49839,68418,120360,"DON MILLS","LARRY J HOPKINS","Republican",0.568444666001994,-18579,118257,-0.157106978868059
1982,"KENTUCKY",7,82463,21436,103899,"CARL D PERKINS","TOM HAMBY","Democrat",0.793684251051502,61027,103899,0.587368502103004
1982,"MAINE",1,118884,124850,247965,"JOHN M KERRY","JOHN R MCKERNAN JR","Republican",0.503498477607727,-5966,243734,-0.0244775041643759
1982,"MAINE",2,68086,136075,204176,"JAMES PATRICK DUNLEAVY","OLYMPIA J SNOWE","Republican",0.666459329206175,-67989,204161,-0.333016589848208
1982,"MARYLAND",1,89503,39656,129159,"ROY DYSON","C A PORTER HOPKINS","Democrat",0.692967582591999,49847,129159,0.385935165183998
1982,"MARYLAND",2,83318,75062,158380,"CLARENCE D LONG","HELEN DELICH BENTLEY","Democrat",0.526063896956686,8256,158380,0.0521277939133729
1982,"MARYLAND",3,110042,38259,148301,"BARBARA A MIKULSKI","H ROBERT SCHERR","Democrat",0.742017923007937,71783,148301,0.484035846015873
1982,"MARYLAND",4,47947,75617,123564,"PATRICIA O'BRIEN AIKEN","MARJORIE S HOLT","Republican",0.611966268492441,-27670,123564,-0.223932536984882
1982,"MARYLAND",5,83937,21533,105470,"STENY H HOYER","WILLIAM P GUTHRIE","Democrat",0.795837678960842,62404,105470,0.591675357921684
1982,"MARYLAND",6,102596,35321,137917,"BEVERLY B BYRON","ROSCOE BARTLETT","Democrat",0.743896691488359,67275,137917,0.487793382976718
1982,"MARYLAND",7,103496,14203,117699,"PARREN J MITCHELL","M LEONORA JONES","Democrat",0.879327776786549,89293,117699,0.758655553573097
1982,"MARYLAND",8,121761,48910,170671,"MICHAEL D BARNES","ELIZABETH W SPENCER","Democrat",0.713425245062137,72851,170671,0.426850490124274
1982,"MASSACHUSETTS",2,118215,44544,162773,"EDWARD P BOLAND","THOMAS P SWANK","Democrat",0.726256811633379,73671,162759,0.452638563766059
1982,"MASSACHUSETTS",4,121802,82804,204615,"BARNEY FRANK","MARGARET M HECKLER","Democrat",0.595274051267014,38998,204606,0.190600471149429
1982,"MASSACHUSETTS",6,117723,85849,203584,"NICHOLAS MAVROULES","THOMAS H TRIMARCO","Democrat",0.578252711411506,31874,203572,0.15657359558289
1982,"MASSACHUSETTS",7,151305,43063,194369,"EDWARD J MARKEY","DAVID M BASILE","Democrat",0.778442035509778,108242,194368,0.556892081000988
1982,"MASSACHUSETTS",8,123296,41370,164672,"THOMAS P O'NEIL JR","FRANK LUKE MCNAMARA JR","Democrat",0.748736883015935,81926,164666,0.497528330074211
1982,"MASSACHUSETTS",9,102665,55030,160225,"JOHN JOSEPH MOAKLEY","DEBORAH R COCHRAN","Democrat",0.640755188016851,47635,157695,0.30207045245569
1982,"MASSACHUSETTS",10,138418,63014,201436,"GERRY E STUDDS","JOHN E CONWAY","Democrat",0.687156218352231,75404,201432,0.374339727550737
1982,"MICHIGAN",2,53040,106960,163414,"GEORGE WAHR SALLADE","CARL D PURSELL","Republican",0.654533883265816,-53920,160000,-0.337
1982,"MICHIGAN",3,96842,73315,171961,"HOWARD WOLPE","RICHARD L MILLIMAN","Democrat",0.563162577561191,23527,170157,0.138266424537339
1982,"MICHIGAN",4,56877,87489,146605,"DAVID A MASIOKAS","MARK D SILJANDER","Republican",0.596766822413969,-30612,144366,-0.212044387182578
1982,"MICHIGAN",5,87229,98650,185881,"STEPHEN V MONSMA","HAROLD S SAWYER","Republican",0.53071588812197,-11421,185879,-0.0614431969184254
1982,"MICHIGAN",6,84778,78388,164987,"BOB CARR","JIM DUNN","Democrat",0.513846545485402,6390,163166,0.0391625706335879
1982,"MICHIGAN",7,118538,36303,157254,"DALE E KILDEE","GEORGE R DARRAH","Democrat",0.753799585384156,82235,154841,0.531093185913292
1982,"MICHIGAN",9,60932,112504,173439,"GERALD D WARNER","GUY VANDER JAGT","Republican",0.648666101626509,-51572,173436,-0.29735464378791
1982,"MICHIGAN",10,102048,66080,169687,"DON ALBOSTA","LAWRENCE W REED","Democrat",0.601389617354305,35968,168128,0.213932242101256
1982,"MICHIGAN",11,69181,106039,175222,"KENT BOURLAND","BOB DAVIS","Republican",0.605169442193332,-36858,175220,-0.210352699463532
1982,"MICHIGAN",12,103851,52312,157664,"DAVID E BONIOR","RAY CONTESTI","Democrat",0.658685559163791,51539,156163,0.330033362576282
1982,"MICHIGAN",13,108351,13732,123195,"GEO W CROCKETT JR","LETTY GUPTA","Democrat",0.879508096919518,94619,122083,0.775038293619914
1982,"MICHIGAN",15,94950,33904,130409,"WILLIAM D FORD","MITCHELL MORAN","Democrat",0.728093919898167,61046,128854,0.473761000822636
1982,"MICHIGAN",16,114006,39227,154756,"JOHN D DINGELL","DAVID K HASKINS","Democrat",0.736682261107808,74779,153233,0.488008457708196
1982,"MICHIGAN",17,116901,55620,175480,"SANDER LEVIN","GERALD E ROSEN","Democrat",0.666178481878277,61281,172521,0.35520893108665
1982,"MICHIGAN",18,46545,132902,181262,"ALLEN J SIPHER","WILLIAM S BROOMFIELD","Republican",0.733203870640289,-86357,179447,-0.481239586061623
1982,"MINNESOTA",1,109257,102298,213520,"TIMOTHY J ""TIM"" PENNY","TOM HAGEDORN","Democrat",0.511694454852004,6959,211555,0.0328945191557751
1982,"MINNESOTA",2,103243,123508,226751,"JAMES W ""JIM"" NICHOLS","VIN WEBER","Republican",0.544685580217948,-20265,226751,-0.0893711604358966
1982,"MINNESOTA",3,60993,166891,231311,"JOEL SALITERMAN","BILL FRENZEL","Republican",0.721500490681377,-105898,227884,-0.464701339277878
1982,"MINNESOTA",4,153494,56248,209742,"BRUCE F VENTO","BILL JAMES","Democrat",0.731822906237187,97246,209742,0.463645812474373
1982,"MINNESOTA",5,136634,61184,208452,"MARTIN OLAV SABO","KEITH W JOHNSON","Democrat",0.655469844376643,75450,197818,0.381411196149996
1982,"MINNESOTA",6,109246,105734,214980,"GERRY SIKORSKI","ARLEN STANGELAND","Democrat",0.508168201693181,3512,214980,0.0163364033863615
1982,"MINNESOTA",7,107062,108254,215316,"GENE WENSTROM","ARLAN STANGELAND","Republican",0.502768024670717,-1192,215316,-0.00553604934143306
1982,"MINNESOTA",8,176392,53467,229859,"JAMES L OBERSTAR","MARJORY L ""MARNIE"" LUCE","Democrat",0.767392183904046,122925,229859,0.534784367808091
1982,"MISSISSIPPI",1,79726,32750,112476,"JAMIE L WHITTEN","FRAN FAWCETT","Democrat",0.708826771933568,46976,112476,0.417653543867136
1982,"MISSISSIPPI",2,71536,74450,147873,"ROBERT G CLARK","WEBB FRANKLIN","Republican",0.503472574438877,-2914,145986,-0.0199608181606455
1982,"MISSISSIPPI",4,79977,69469,152216,"WAYNE DOWDY","LILES WILLIAMS","Democrat",0.52541782729805,10508,149446,0.0703130227640753
1982,"MISSISSIPPI",5,22634,82884,105518,"ARLON ""BLACKIE"" COATE","TRENT LOTT","Republican",0.785496313425198,-60250,105518,-0.570992626850395
1982,"MISSOURI",1,102656,52599,155255,"WILLIAM ""BILL"" CLAY","WILLIAM E ""BILL"" WHITE","Democrat",0.661208978776851,50057,155255,0.322417957553702
1982,"MISSOURI",2,100770,77433,178203,"ROBERT A YOUNG","HAROLD L DIELMANN","Democrat",0.565478695644854,23337,178203,0.130957391289709
1982,"MISSOURI",3,131566,37388,168954,"RICHARD A GEPHARDT","RICHARD FORISTEL","Democrat",0.778708997715355,94178,168954,0.557417995430709
1982,"MISSOURI",4,96388,79565,175953,"IKE SKELTON","WENDELL BAILEY","Democrat",0.547805379845754,16823,175953,0.0956107596915085
1982,"MISSOURI",5,96059,66664,165989,"ALAN WHEAT","JOHN A SHARP","Democrat",0.57870702275452,29395,162723,0.180644407981662
1982,"MISSOURI",6,79053,97993,177046,"JIM RUSSELL","TOM COLEMAN","Republican",0.55348892378252,-18940,177046,-0.10697784756504
1982,"MISSOURI",7,89549,91391,180940,"DAVID A GEISLER","GENE TAYLOR","Republican",0.505090085111087,-1842,180940,-0.0101801702221731
1982,"MISSOURI",8,76413,86493,162906,"JERRY FORD","BILL EMERSON","Republican",0.530938086994954,-10080,162906,-0.0618761739899083
1982,"MISSOURI",9,99228,63942,163170,"HAROLD L VOLKMER","LARRY E MEAD","Democrat",0.60812649384078,35286,163170,0.216252987681559
1982,"MONTANA",1,100087,62402,167602,"PAT WILLIAMS","BOB DAVIES","Democrat",0.597170678154199,37685,162489,0.231923391737287
1982,"MONTANA",2,65815,79968,148937,"HOWARD F LYMAN","RON MARIENEE","Republican",0.536925008560667,-14153,145783,-0.0970826502404258
1982,"NEBRASKA",1,45676,137675,183368,"CURT DONALDSON","DOUG BEREUTER","Republican",0.750812573622442,-91999,183351,-0.501764375432913
1982,"NEBRASKA",2,70431,92639,163349,"RICHARD M FELLMAN","HAL DAUB","Republican",0.56712315349344,-22208,163070,-0.136186913595388
1982,"NEVADA",1,61901,45675,107576,"HARRY REID","PEGGY CAVNAR","Democrat",0.575416449765747,16226,107576,0.150832899531494
1982,"NEVADA",2,52265,70188,126496,"MARY GOJACK","BARBARA VUCANOVICH","Republican",0.554863394889957,-17923,122453,-0.146366360971148
1982,"NEW HAMPSHIRE",1,76281,61876,138911,"NORMAN E D'AMOURS","ROBERT C SMITH","Democrat",0.549135777584209,14405,138157,0.104265437147593
1982,"NEW HAMPSHIRE",2,37906,92098,130007,"ROBERT L DUPAY","JUDD GREGG","Republican",0.708408008799526,-54192,130004,-0.416848712347312
1982,"NEW JERSEY",1,110570,39501,150891,"JAMES J FLORIO","JOHN A DRAMESI","Democrat",0.732780616471493,71069,150071,0.473569177256099
1982,"NEW JERSEY",2,102826,47069,151128,"WILLIAM J HUGHES","JOHN J MAHONEY","Democrat",0.680390132867503,55757,149895,0.371973714933787
1982,"NEW JERSEY",3,104055,60515,166996,"JAMES J HOWARD","MARIE SHEEHAN MUHLER","Democrat",0.623098756856452,43540,164570,0.264568268821778
1982,"NEW JERSEY",4,75658,85660,162595,"JOSEPH P MERLINO","CHRISTOPHER H SMITH","Republican",0.526830468341585,-10002,161318,-0.0620017604978986
1982,"NEW JERSEY",5,53659,104695,160358,"FRITZ CAMMERZELL","MARGE ROUKEMA","Republican",0.652882924456529,-51036,158354,-0.322290564178991
1982,"NEW JERSEY",6,100419,46095,147434,"BERNARD J DWYER","BERTRAM L BUCKLER","Democrat",0.681111548218186,54324,146514,0.370776854089029
1982,"NEW JERSEY",7,70978,91837,164109,"ADAM K LEVIN","MATTHEW J RINALDO","Republican",0.559609771554272,-20859,162815,-0.128114731443663
1982,"NEW JERSEY",8,89980,36317,127297,"ROBERT A ROE","NORM ROBERTSON","Democrat",0.706850907719742,53663,126297,0.424895286507201
1982,"NEW JERSEY",9,99090,86022,186879,"ROBERT G TORRICELLI","HAROLD C ""CAP"" HOLLENBECK","Democrat",0.530236142102644,13068,185112,0.0705950991831972
1982,"NEW JERSEY",10,76684,14551,92852,"PETER W RODINO JR","TIMOTHY LEE JR","Democrat",0.825873432990135,62133,91235,0.681021537787033
1982,"NEW JERSEY",11,105607,57099,164237,"JOSEPH G MINISH","REY REDINGTON","Democrat",0.643015885579985,48508,162706,0.298132828537362
1982,"NEW JERSEY",12,57049,117793,176452,"JEFF CONNOR","JIM COURTER","Republican",0.667563983406252,-60744,174842,-0.347422244083229
1982,"NEW JERSEY",13,65820,100061,168256,"GEORGE S CALLAS","EDWIN B FORSYTHE","Republican",0.594694988588817,-34241,165881,-0.20641905944623
1982,"NEW JERSEY",14,94021,28257,126606,"FRANK J GUARINI","CHARLES J CATRILLO","Democrat",0.74262673175047,65764,122278,0.53782364775348
1982,"NEW MEXICO",1,67534,74459,141993,"JAN A HARTKE","MANUEL LUJAN JR","Republican",0.524385004894607,-6925,141993,-0.048770009789215
1982,"NEW MEXICO",2,50599,71021,121620,"CALEB J CHANDLER","JOSEPH R SKEEN","Republican",0.583958230554185,-20422,121620,-0.16791646110837
1982,"NEW MEXICO",3,84669,46466,131293,"BILL RICHARDSON","MARJORIE BELL CHAMBERS","Democrat",0.644885865963913,38203,131135,0.29132573302322
1982,"NEW YORK",1,49787,72978,138021,"ETHAN C ELDON","WILLIAM CARNEY","Republican",0.52874562566566,-23191,122765,-0.188905632712907
1982,"NEW YORK",2,78582,36113,126712,"THOMAS J DOWNEY","PAUL G COSTELLO","Democrat",0.62016225771829,42469,114695,0.370277693011901
1982,"NEW YORK",3,93846,71282,181133,"ROBERT J MRAZEK","JOHN LEBOUTILLIER","Democrat",0.518105480503277,22564,165128,0.136645511360884
1982,"NEW YORK",4,60533,90041,174348,"ROBERT P ZIMMERMAN","NORMAN F LENT","Republican",0.516444123247757,-29508,150574,-0.195970087797362
1982,"NEW YORK",5,64085,88033,172888,"ARNOLD J MILLER","RAYMOND J MCGRATH","Republican",0.509190921290084,-23948,152118,-0.157430415861371
1982,"NEW YORK",6,76233,16276,99557,"JOSEPH P ADDABBO","JOSEPH P ADDABBO","Democrat",0.765722149120604,59957,92509,0.648120723389076
1982,"NEW YORK",7,79741,19157,108845,"BENJAMIN S ROSENTHAL","ALBERT LEMISHOW","Democrat",0.732610593045156,60584,98898,0.612590750065724
1982,"NEW YORK",9,75286,20352,102820,"GERALDINE FERRARO","JOHN J WEIGANDT","Democrat",0.732211631978214,54934,95638,0.574395114912483
1982,"NEW YORK",10,85782,17435,113451,"CHARLES E SCHUMER","STEPHEN MARKS","Democrat",0.756114974746807,68347,103217,0.662168053712082
1982,"NEW YORK",11,39357,4449,47010,"EDOLPHUS TOWNS","JAMES W SMITH","Democrat",0.837204850031908,34908,43806,0.796877140117792
1982,"NEW YORK",12,42401,3215,49259,"MAJOR R OWENS","DAVID KATAN","Democrat",0.860776710854869,39186,45616,0.859040687478078
1982,"NEW YORK",13,65390,13392,85130,"STEPHEN J SOLARZ","LEON F NADROWSKI","Democrat",0.768119346881241,51998,78782,0.660023863319032
1982,"NEW YORK",14,51728,52601,120630,"LEO C ZEFERETTI","GUY V MOLINARI","Republican",0.43605239161071,-873,104329,-0.00836775968330953
1982,"NEW YORK",15,48200,62273,123698,"BETTY G LALL","BILL GREEN","Republican",0.503427702953969,-14073,110473,-0.127388592687806
1982,"NEW YORK",16,58134,4964,78605,"CHARLES B RANGEL","CHARLES B RANGEL","Democrat",0.739571274091979,53170,63098,0.842657453485055
1982,"NEW YORK",17,97384,16555,133100,"TED WEISS","LOUIS S ANTONELLI","Democrat",0.731660405709992,80829,113939,0.709405910180009
1982,"NEW YORK",18,50687,3504,57664,"ROBERT GARCIA","ROBERT GARCIA","Democrat",0.879005965593785,47183,54191,0.870679633149416
1982,"NEW YORK",19,77984,37329,126825,"MARIO BIAGGI","MARIO BIAGGI","Democrat",0.614894539720087,40655,115313,0.352562156912057
1982,"NEW YORK",20,98425,62767,174228,"RICHARD L OTTINGER","JON S FOSSEL","Democrat",0.564920678650963,35658,161192,0.22121445233014
1982,"NEW YORK",21,38664,103006,156124,"J MORGAN STRONG","HAMILTON FISH JR","Republican",0.659770438881914,-64342,141670,-0.454168137220301
1982,"NEW YORK",22,69221,92266,174286,"PETER A PEYSER","BENJAMIN A GILMAN","Republican",0.529394214107846,-23045,161487,-0.142704985540632
1982,"NEW YORK",23,164427,39288,216083,"SAMUEL S STRATTON","FRANK WICKS","Democrat",0.760943711444214,125139,203715,0.614284662395994
1982,"NEW YORK",24,49441,126101,189737,"ROY ESIASON","GERALD B SOLOMON","Republican",0.664609433057337,-76660,175542,-0.436704606305044
1982,"NEW YORK",25,70793,93071,166827,"ANITA MAXWELL","SHERWOOD L BOEHLERT","Republican",0.557889310483315,-22278,163864,-0.135954205926866
1982,"NEW YORK",26,43208,101812,152170,"DAVID P LANDY","DAVID O'B MARTIN","Republican",0.669067490306894,-58604,145020,-0.40410977796166
1982,"NEW YORK",27,76045,95290,179186,"ELAINE LYTEL","GEORGE C WORTLEY","Republican",0.531793778531805,-19245,171335,-0.112323810079668
1982,"NEW YORK",28,97068,70115,178659,"MATT MCHUGH","DAVID F CROWLEY","Democrat",0.543314358638524,26953,167183,0.161218544947752
1982,"NEW YORK",29,47463,104412,157245,"WILLIAM C LARSEN","FRANK HORTON","Republican",0.664008394543547,-56949,151875,-0.374972839506173
1982,"NEW YORK",30,48764,119105,174620,"BILL BENET","BARBER B CONABLE JR","Republican",0.682081090367656,-70341,167869,-0.41902316687417
1982,"NEW YORK",31,42204,121266,177305,"JAMES A MARTIN","JACK F KEMP","Republican",0.683940103211979,-79062,163470,-0.48364837584878
1982,"NEW YORK",33,121754,17826,149977,"HENRY J NOVAK","WALTER J PILLICH","Democrat",0.811817812064517,103928,139580,0.744576586903568
1982,"NEW YORK",34,99502,59791,165280,"STANLEY N LUNDINE","JAMES J SNYDER SR","Democrat",0.602020813165537,39711,159293,0.249295323711651
1982,"NORTH CAROLINA",1,79954,17478,98342,"WALTER B JONES","JAMES F ""JIN"" MCINTYRE III","Democrat",0.813019869435236,62476,97432,0.641226701699647
1982,"NORTH CAROLINA",2,75607,34293,111326,"H M MICHAUZ JR","JOHN W ""JACK"" MARIN","Democrat",0.679149524819,41314,109900,0.375923566878981
1982,"NORTH CAROLINA",3,68936,39046,108473,"CHARLES O WHITLEY","EUGENE ""RED"" MCDANIEL","Democrat",0.63551298479806,29890,107982,0.276805393491508
1982,"NORTH CAROLINA",4,70369,64955,137044,"IKE ANDREWS","WILLIAM ""BILL"" COBEY JR","Democrat",0.513477423309302,5414,135324,0.0400076852590819
1982,"NORTH CAROLINA",5,87819,57083,145707,"STEPHEN L ""STEVE"" NEAL","ANNE BAGNAL","Democrat",0.602709547242068,30736,144902,0.21211577479952
1982,"NORTH CAROLINA",6,68696,58244,127619,"ROBIN BRITT","EUGENE ""GENE"" JOHNSTON","Democrat",0.538289753093191,10452,126940,0.0823381124940917
1982,"NORTH CAROLINA",7,68529,27015,96534,"CHARLES G ROSE","EDWARD ""ED"" JOHNSON","Democrat",0.709894959288955,41514,95544,0.434501381562422
1982,"NORTH CAROLINA",8,71691,52417,124938,"WG ""BILL"" HEFNER","HARRIS D BLAKE","Democrat",0.573812611055083,19274,124108,0.155300222386953
1982,"NORTH CAROLINA",9,47258,64297,112786,"PRESTON CORNELIUS","JAMES G MARTIN","Republican",0.570079619810969,-17039,111555,-0.152740800501995
1982,"NORTH CAROLINA",11,85410,84085,171047,"JAMES MCCLURE CLARKE","WILLIAM M ""BILL"" HENDON","Democrat",0.499336439692014,1325,169495,0.00781733974453524
1982,"NORTH DAKOTA",0,186534,72241,260499,"BYRON L DORGAN","KENT JONES","Democrat",0.716064169152281,114293,258775,0.441669403922326
1982,"OHIO",1,99143,52658,156187,"THOMAS A LUKEN","JOHN E HELD","Democrat",0.634771139723536,46485,151801,0.306223279161534
1982,"OHIO",2,53169,97434,155378,"WILLIAM J LUTTMER","WILLIS D GRADISON JR","Republican",0.62707719239532,-44265,150603,-0.293918447839684
1982,"OHIO",4,57564,105087,162651,"BOB MOON","MICHAEL G OXLEY","Republican",0.646088865116108,-47523,162651,-0.292177730232215
1982,"OHIO",5,70120,86450,156570,"JAMES R SHERCK","DELBERT L LATTA","Republican",0.552149198441592,-16330,156570,-0.104298396883183
1982,"OHIO",6,63435,92135,155570,"LYNN ALAN GRIMSHAW","BOB MCEWEN","Republican",0.592241434723919,-28700,155570,-0.184482869447837
1982,"OHIO",7,65543,87842,156146,"ROGER D TACKETT","MICHAEL DEWINE","Republican",0.562563242093938,-22299,153385,-0.145379274374939
1982,"OHIO",8,49877,98527,148404,"JOHN W GRIFFIN","THOMAS N KINDNESS","Republican",0.663910676262095,-48650,148404,-0.327821352524191
1982,"OHIO",9,95162,64459,164217,"MARCY KAPTUR","ED WEBER","Democrat",0.57948933423458,30703,159621,0.192349377588162
1982,"OHIO",10,57983,100044,158027,"JOHN M BUCHANAN","CLARENCE E MILLER","Republican",0.633081688572206,-42061,158027,-0.266163377144412
1982,"OHIO",11,93302,56616,153242,"DENNIS E ECKART","GLEN W WARNER","Democrat",0.608853969538377,36686,149918,0.244707106551582
1982,"OHIO",12,82753,88335,175027,"BOB SHAMANSKY","JOHN R KASICH","Republican",0.504693561564787,-5582,171088,-0.032626484616104
1982,"OHIO",13,92296,53376,150725,"DONALD J PEASE","TIMOTHY PAUL MARTIN","Democrat",0.612346989550506,38920,145672,0.267175572519084
1982,"OHIO",14,115629,48421,164050,"JOHN F SEIBERLING","LOUIS A MANGELS","Democrat",0.704839987808595,67208,164050,0.40967997561719
1982,"OHIO",15,47070,104678,157887,"GREG KOSTELAC","CHALMERS P WYLIE","Republican",0.66299315333118,-57608,151748,-0.379629385560271
1982,"OHIO",16,57386,110485,167871,"JEFFREY R ORENSTEIN","RALPH REGULA","Republican",0.658154177910419,-53099,167871,-0.316308355820839
1982,"OHIO",17,80375,98476,178851,"GEORGE D TABLACK","LYLE WILLIAMS","Republican",0.550603575042913,-18101,178851,-0.101207150085826
1982,"OHIO",19,111760,72682,189942,"EDWARD F FEIGHAN","RICHARD G ANTER II","Democrat",0.588390140148045,39078,184442,0.211871482634107
1982,"OHIO",20,133603,17675,156052,"MARY ROSE OAKAR","PARIS T LEJEUNE","Democrat",0.856144105810884,115928,151278,0.766324250717223
1982,"OHIO",21,132544,21332,153876,"LOUIS STOKES","ALAN G SHATTEEN","Democrat",0.86136889443448,111212,153876,0.722737788868959
1982,"OKLAHOMA",1,76379,64704,141083,"JAMES R JONES","RICHARD C DICK FREEMAN","Democrat",0.541376352927,11675,141083,0.0827527058540008
1982,"OKLAHOMA",2,111895,42298,154193,"MIKE SYNAR","LOU STRIEGEL","Democrat",0.725681451168341,69597,154193,0.451362902336682
1982,"OKLAHOMA",3,121670,26335,148005,"WES WATKINS","PATRICK K MILLER","Democrat",0.822066822066822,95335,148005,0.644133644133644
1982,"OKLAHOMA",4,84205,44351,129504,"DAVE MCCURDY","HOWARD RUTLEDGE","Democrat",0.650211576476402,39854,128556,0.310012757086406
1982,"OKLAHOMA",5,42453,98979,147209,"DAN LANE","MICKEY EDWARDS","Republican",0.672370575168638,-56526,141432,-0.399669098930935
1982,"OKLAHOMA",6,102811,33519,136330,"GLENN ENGLISH","ED MOORE","Democrat",0.754133352893714,69292,136330,0.508266705787428
1982,"OREGON",1,118638,101720,220378,"LES AUCOIN","BILL MOSHOFSKY","Democrat",0.538338672644275,16918,220358,0.0767750660289166
1982,"OREGON",2,85495,106912,192427,"LARRYANN WILLIS","ROBERT F ""BOB"" SMITH","Republican",0.555597707182464,-21417,192407,-0.111310919041407
1982,"OREGON",3,159416,44162,203662,"RON WYDEN","THOMAS H PHELAN","Democrat",0.782747886203612,115254,203578,0.566141724547839
1982,"OREGON",4,115448,80054,195524,"JIM WEAVER","ROSS ANTHONY","Democrat",0.590454368773143,35394,195502,0.181041626172622
1982,"OREGON",5,98952,103906,202901,"RUTH MCFARLAND","DENNY SMITH","Republican",0.512101961054899,-4954,202858,-0.0244210235731398
1982,"PENNSYLVANIA",1,103626,38155,143416,"THOMAS M FOGLIETTA","MICHAEL MARINO","Democrat",0.722555363418308,65471,141781,0.461775555257757
1982,"PENNSYLVANIA",3,97161,94497,193954,"ROBERT A BORSKI JR","CHARLES F DOUGHERTY","Democrat",0.500948678552646,2664,191658,0.0138997589456219
1982,"PENNSYLVANIA",4,100481,64539,167102,"JOSEPH P KOLTER","EUGENE V ATKINSON","Democrat",0.601315364268531,35942,165020,0.217803902557266
1982,"PENNSYLVANIA",5,44170,90648,134818,"BOB BURGER","RICHARD T SCHULZE","Republican",0.672373125250338,-46478,134818,-0.344746250500675
1982,"PENNSYLVANIA",6,108230,42155,150385,"GUS YATRON","HARRY B MARTIN","Democrat",0.719686138910131,66075,150385,0.439372277820261
1982,"PENNSYLVANIA",7,105775,85023,190798,"BOB EDGAR","STEVE JOACHIM","Democrat",0.554382121405885,20752,190798,0.10876424281177
1982,"PENNSYLVANIA",8,83242,80928,165535,"PETER H KOSTMAYER","JAMES K COYNE","Democrat",0.50286646328571,2314,164170,0.014095145276238
1982,"PENNSYLVANIA",9,49583,92322,141905,"EUGENE J DUNCAN","BUD SHUSTER","Republican",0.650590183573517,-42739,141905,-0.301180367147035
1982,"PENNSYLVANIA",10,49868,103617,153485,"ROBERT J RAFALKO","JOSEPH M MCDADE","Republican",0.675095286184318,-53749,153485,-0.350190572368635
1982,"PENNSYLVANIA",11,90371,78485,168856,"FRANK HARRISON","JIM NELLIGAN","Democrat",0.535195669683044,11886,168856,0.0703913393660871
1982,"PENNSYLVANIA",12,96369,54212,157640,"JOHN P MURTHA","WILLIAM N TUSCANO","Democrat",0.611323268206039,42157,150581,0.279962279437645
1982,"PENNSYLVANIA",13,59709,109198,169824,"MARTIN J CUNNINGHAM JR","LAWRENCE COUGHLIN","Republican",0.643006877708687,-49489,168907,-0.292995553766274
1982,"PENNSYLVANIA",14,120980,32780,161577,"WILLIAM J COYNE","JOHN ROBERT CLARK","Democrat",0.748745180316505,88200,153760,0.573621227887617
1982,"PENNSYLVANIA",15,58002,79455,137457,"RICHARD J ORLOSKI","DON RITTER","Republican",0.578035312861477,-21453,137457,-0.156070625722953
1982,"PENNSYLVANIA",16,37364,93034,130398,"JEAN D MOWERY","ROBERT S WALKER","Republican",0.713461862912008,-55670,130398,-0.426923725824016
1982,"PENNSYLVANIA",17,61974,84291,146265,"LARRY J HOCHENDONER","GEORGE W GEKAS","Republican",0.576289611321916,-22317,146265,-0.152579222643831
1982,"PENNSYLVANIA",18,101807,84428,187683,"DOUG WALGREN","TED JACOB","Democrat",0.54244124401251,17379,186235,0.093317582624104
1982,"PENNSYLVANIA",19,41787,101163,142950,"LARRY BECKER","BILL GOODLING","Republican",0.707681007345226,-59376,142950,-0.415362014690451
1982,"PENNSYLVANIA",20,127281,38212,167428,"JOSEPH M GAYDOS","TERRY T RAY","Democrat",0.760213345438039,89069,165493,0.53820403279897
1982,"PENNSYLVANIA",21,79451,80180,159631,"ANTHONY ""BUZZ"" ANDREZESKI","THOMAS J RIDGE","Republican",0.502283391070657,-729,159631,-0.0045667821413134
1982,"PENNSYLVANIA",22,123716,32176,157215,"AUSTIN J MURPHY","FRANK J PATERRA","Democrat",0.786922367458576,91540,155892,0.587201395838144
1982,"PENNSYLVANIA",23,49297,92424,141721,"JOSEPH J CALLA JR","BILL CLINGER","Republican",0.652154585417828,-43127,141721,-0.304309170835656
1982,"RHODE ISLAND",1,97254,61253,160131,"FERNAND J ST GERMAIN","BURTON STALLWOOD","Democrat",0.607340240178354,36001,158507,0.227125615903399
1982,"RHODE ISLAND",2,76769,96282,173051,"JAMES V AUKERMAN","CLAUDINE SCHNEIDER","Republican",0.556379333260137,-19513,173051,-0.112758666520274
1982,"SOUTH CAROLINA",1,52916,63945,117832,"W MULLINS MCLEOD","THOMAS F HARTNETT","Republican",0.54267940797067,-11029,116861,-0.0943770804631143
1982,"SOUTH CAROLINA",2,50749,71569,122318,"KEN MOSELY","FLOYD D SPENCE","Republican",0.585106035088867,-20820,122318,-0.170212070177733
1982,"SOUTH CAROLINA",4,40394,69802,110196,"MARION E TYUS","CARROLL A CAMPBELL","Republican",0.633434970416349,-29408,110196,-0.266869940832698
1982,"SOUTH CAROLINA",5,69345,33191,102536,"JOHN SPRATT","JOHN S WILKERSON","Democrat",0.676299055941328,36154,102536,0.352598111882656
1982,"SOUTH CAROLINA",6,62582,56653,119235,"ROBIN TALLON","JOHN L NAPIER","Democrat",0.524862666163459,5929,119235,0.0497253323269174
1982,"SOUTH DAKOTA",0,142122,133530,275652,"TOM DASCHLE","CLINT ROBERTS","Democrat",0.515584867876888,8592,275652,0.0311697357537765
1982,"TENNESSEE",1,27580,89497,120858,"JESSIE J CABLE","JAMES H ""JIMMY"" QUILLEN","Republican",0.740513660659617,-61917,117077,-0.528857076966441
1982,"TENNESSEE",3,84967,49885,137493,"MARILYN LLOYD BOUQUARD","GLEN BYERS","Democrat",0.61797327863964,35082,134852,0.26015187019844
1982,"TENNESSEE",4,93453,47865,141322,"JIM COOPER","CISSY BAKER","Democrat",0.661277083539718,45588,141318,0.322591601919076
1982,"TENNESSEE",5,109282,27061,136349,"BILL BONER","LAUREL STEINHICE","Democrat",0.801487359643268,82221,136343,0.603045260849475
1982,"TENNESSEE",7,72359,73835,146197,"BOB CLEMENT","DON SUNDQUIST","Republican",0.505037723072293,-1476,146194,-0.010096173577575
1982,"TENNESSEE",8,93945,31527,125472,"ED JONES","BRUCE BENSON","Democrat",0.748732785003826,62418,125472,0.497465570007651
1982,"TENNESSEE",9,112143,40812,154830,"HAROLD E FORD","JOE CRAWFORD","Democrat",0.724297616740942,71331,152955,0.466352848877121
1982,"TEXAS",3,28223,99852,129528,"JIM MCNEES","STEVE BARTLETT","Republican",0.770891235871781,-71629,128075,-0.559273862970916
1982,"TEXAS",4,94134,32221,127496,"RALPH M HALL","PETE COLLUMB","Democrat",0.738329045617117,61913,126355,0.489992481500534
1982,"TEXAS",5,52214,27121,80530,"JOHN BRYANT","JOE DEVANY","Democrat",0.648379485905874,25093,79335,0.316291674544652
1982,"TEXAS",7,17866,108718,127922,"DENNIS G SCOGGINS","BILL ARCHER","Republican",0.849877268960773,-90852,126584,-0.71772103899387
1982,"TEXAS",8,38041,50630,89218,"HENRY E ALLEE","JACK FIELDS","Republican",0.56748638167186,-12589,88671,-0.141974264415649
1982,"TEXAS",9,78965,35422,116897,"JACK BROOKS","JOHN W LEWIS","Democrat",0.675509208961735,43543,114387,0.380663886630474
1982,"TEXAS",10,121030,8735,134276,"JJ ""JAKE"" PICKLE","WILLIAM G KELSEY","Democrat",0.901352438261491,112295,129765,0.865372018649096
1982,"TEXAS",12,78913,34879,114535,"JIM WRIGHT","JIM RYAN","Democrat",0.688985899506701,44034,113792,0.386969206974128
1982,"TEXAS",13,86376,47877,135820,"JACK HIGHTOWER","RON SLOVER","Democrat",0.635959357973789,38499,134253,0.28676454157449
1982,"TEXAS",14,76851,48942,126712,"WILLIAM N ""BILL"" PATMAN","JOE WYATT JR","Democrat",0.606501357408927,27909,125793,0.221864491664878
1982,"TEXAS",16,44024,36064,81671,"RONALD COLEMAN","PAT HAGGERTY","Democrat",0.539040785590969,7960,80088,0.099390670262711
1982,"TEXAS",18,68014,12104,82335,"MICKEY LELAND","C LEON PICKETT","Democrat",0.826064249711544,55910,80118,0.697845677625502
1982,"TEXAS",19,89702,19062,109970,"KENT HANCE","EL HICKS","Democrat",0.815695189597163,70640,108764,0.649479607222978
1982,"TEXAS",21,35112,106515,142872,"CHARLES S STOUGH","TOM LOEFFLER","Republican",0.745527465143625,-71403,141627,-0.504162341926328
1982,"TEXAS",23,51690,41363,93528,"ABRAHAM ""CHICK"" KAZEN JR","JEFF WENTWORTH","Democrat",0.552668719527842,10327,93053,0.110979764220391
1982,"TEXAS",24,63857,22798,87653,"MARTIN FROST","LUCY PATTERSON","Democrat",0.728520415730209,41059,86655,0.473821475967919
1982,"TEXAS",25,63974,40112,105914,"MIKE ANDREWS","MIKE FAUBION","Democrat",0.60401835451404,23862,104086,0.22925273331668
1982,"TEXAS",26,69782,69438,139220,"TOM VANDERGRIFF","JIM BRADSHAW","Democrat",0.501235454676052,344,139220,0.00247090935210458
1982,"TEXAS",27,66604,35209,104044,"SOLOMON P ORTIZ","JASON LUBY","Democrat",0.640152243281689,31395,101813,0.308359443293096
1982,"UTAH",1,66006,111416,177422,"A STEPHEN DIRKS","JAMES V HANSEN","Republican",0.627971728421504,-45410,177422,-0.255943456843007
1982,"UTAH",2,78981,92109,171090,"FRANCES FARLEY","DAN MARRIOTT","Republican",0.538365772400491,-13128,171090,-0.0767315448009819
1982,"VERMONT",0,38296,114191,164951,"MARK A KAPLAN","JIM JEFFORDS","Republican",0.692272250547132,-75895,152487,-0.497714559273905
1982,"VIRGINIA",1,62379,76926,142802,"JOHN J MCGELENNON","HERBERT H BATEMAN","Republican",0.538689934314645,-14547,139305,-0.104425541078928
1982,"VIRGINIA",3,63946,92928,156891,"JOHN A WALDROP JR","THOMAS J ""TOM"" BLILEY JR","Republican",0.592309310285485,-28982,156874,-0.184746994403152
1982,"VIRGINIA",4,80695,67708,148406,"NORMAN SISISKY","ROBERT W ""BOB"" DANIEL JR","Democrat",0.543744862067571,12987,148403,0.0875117079843399
1982,"VIRGINIA",6,68192,66537,137140,"JAMES R ""JIM"" OLIN","KEVIN G MILLER","Democrat",0.497243692576929,1655,134729,0.0122839180874199
1982,"VIRGINIA",7,46514,76752,128224,"LINDSAY G DORRIER JR","J KENNETH ROBINSON","Republican",0.598577489393561,-30238,123266,-0.245306897279055
1982,"VIRGINIA",8,68071,69620,140070,"HERBERT E HARRIS II","STANFORD E ""STAN"" PARRIS","Republican",0.49703719568787,-1549,137691,-0.0112498275123283
1982,"VIRGINIA",9,76227,75009,151238,"FREDERICK C ""RICK"" BOUCHER","WILLIAM C WAMPLER","Democrat",0.504020153665084,1218,151236,0.00805363802269301
1982,"VIRGINIA",10,75361,86506,164035,"IRA M LECHNER","FRANK R WOLF","Republican",0.527363062760996,-11145,161867,-0.0688528236144489
1982,"WASHINGTON",1,59444,123956,183400,"BRIAN LONG","JOEL PRITCHARD","Republican",0.67587786259542,-64512,183400,-0.35175572519084
1982,"WASHINGTON",2,101383,68622,170005,"AL SWIFT","JOAN HOUCHEN","Democrat",0.596353048439752,32761,170005,0.192706096879504
1982,"WASHINGTON",3,97323,59686,162058,"DONALD L BONKER","JT QUIGG","Democrat",0.600544249589653,37637,157009,0.23971237317606
1982,"WASHINGTON",4,45990,112148,160668,"CHARLES D KILBURY","SID MORRISON","Republican",0.698010804889586,-66158,158138,-0.418356119338805
1982,"WASHINGTON",5,109549,60816,170365,"THOMAS S FOLEY","JOHN SONNELAND","Democrat",0.643025269274792,48733,170365,0.286050538549585
1982,"WASHINGTON",6,89985,47720,143898,"NORMAN D DICKS","TED HALEY","Democrat",0.625338781636993,42265,137705,0.306924222068915
1982,"WASHINGTON",7,126313,51759,178072,"MIKE LOWRY","BOB DORSE","Democrat",0.709336672806505,74554,178072,0.41867334561301
1982,"WASHINGTON",8,59824,79209,139033,"BETH BLAND","ROD CHANDLER","Republican",0.569713665101091,-19385,139033,-0.139427330202182
1982,"WEST VIRGINIA",1,79529,70069,149598,"ALAN B MOLLOHAN","JOHN F MCCUSKEY","Democrat",0.531618069760291,9460,149598,0.0632361395205818
1982,"WEST VIRGINIA",2,87904,49413,137317,"HARLEY O STAGGERS JR","JD HINKLE","Democrat",0.640153804700074,38491,137317,0.280307609400147
1982,"WEST VIRGINIA",3,84619,60844,146250,"ROBERT E WISE JR","MICK STATON","Democrat",0.578591452991453,23775,145463,0.163443624839306
1982,"WEST VIRGINIA",4,91184,22054,113238,"NICK JOE RAHALL II","HOMER L HARRIS","Democrat",0.805242056553454,69130,113238,0.610484113106908
1982,"WISCONSIN",1,95055,59309,155804,"LES ASPIN","PETER N JANSSON","Democrat",0.610093450745809,35746,154364,0.231569536938664
1982,"WISCONSIN",2,112677,71989,186045,"ROBERT KASTENMEIER","JIM JOHNSON","Democrat",0.605643795855841,40688,184666,0.220332925389622
1982,"WISCONSIN",3,75132,99304,175465,"PAUL OFFNER","STEVEN C GUNDERSON","Republican",0.565947624882455,-24172,174436,-0.138572313054645
1982,"WISCONSIN",5,99713,54826,156921,"JIM MOODY","ROD K JOHNSTON","Democrat",0.635434390553208,44887,154539,0.290457424986573
1982,"WISCONSIN",6,59922,111348,171283,"GORDON E LOEHR","THOMAS E PETRI","Republican",0.650082027988767,-51426,171270,-0.300262743037309
1982,"WISCONSIN",7,122124,57535,179668,"DAVID R OBEY","BERNARD A ZIMMERMAN","Democrat",0.679720373132667,64589,179659,0.359508847316305
1982,"WISCONSIN",8,74436,101379,177152,"RUTH C CLUSEN","TOBY ROTH","Republican",0.572271269869942,-26943,175815,-0.153246310041805
1982,"WYOMING",0,46041,113236,159277,"TED HOMMEL","DICK CHENEY","Republican",0.710937549049769,-67195,159277,-0.421875098099537
1984,"ALABAMA",1,98455,102479,200934,"FRANK MCWRIGHT","H L ""SONNY"" CALLAHAN","Republican",0.51001323817771,-4024,200934,-0.0200264763554202
1984,"ALABAMA",2,75506,118153,195815,"LARRY LEE","BILL DICKINSON","Republican",0.603390955749049,-42647,193659,-0.220216979329646
1984,"ALABAMA",6,130973,87550,219710,"BEN ERDREICH","J T ""JABO"" WAGGONER","Democrat",0.59611760957626,43423,218523,0.198711348462176
1984,"ALASKA",0,86052,113582,206437,"PEGGE BEGICH","DONALD E YOUNG","Republican",0.550201756468075,-27530,199634,-0.137902361321218
1984,"ARIZONA",1,45609,162418,208027,"HARRY W BRAUN III","JOHN MCCAIN","Republican",0.780754421301081,-116809,208027,-0.561508842602162
1984,"ARIZONA",3,57748,156686,218328,"BOB SCHUSTER","BOB STUMP","Republican",0.71766333223407,-98938,214434,-0.461391383829057
1984,"ARIZONA",5,109871,116075,227938,"JIM MCNULTY","JIM KOLBE","Republican",0.509239354561328,-6204,225946,-0.0274578881679693
1984,"ARKANSAS",2,103165,90841,219079,"TOMMY ROBINSON","JUDY PETTY","Democrat",0.470903190173408,12324,194006,0.0635238085420039
1984,"CALIFORNIA",1,157037,95186,252223,"DOUGLAS H BOSCO","DAVID REDICK","Democrat",0.622611736439579,61851,252223,0.245223472879159
1984,"CALIFORNIA",2,69793,158679,228472,"HARRY COZAD","GENE CHAPPIE","Republican",0.694522742392941,-88886,228472,-0.389045484785882
1984,"CALIFORNIA",4,130109,77773,211921,"VIC FAZIO","ROGER CANFIELD","Democrat",0.613950481547369,52336,207882,0.251758208983943
1984,"CALIFORNIA",5,139692,45930,193204,"SALA BURTON","TOM SPINOSA","Democrat",0.723028508726527,93762,185622,0.505123315124285
1984,"CALIFORNIA",6,162511,71011,239096,"BARBARA BOXER","DOULGAS BINDERUP","Democrat",0.679689329808947,91500,233522,0.391826037803719
1984,"CALIFORNIA",7,158306,78985,237291,"GEORGE MILLER","ROSEMARY THAKAR","Democrat",0.667138660969021,79321,237291,0.334277321938042
1984,"CALIFORNIA",8,144316,94907,239223,"RONALD V DELLUMS","CHARLES CONNOR","Democrat",0.603269752490354,49409,239223,0.206539504980708
1984,"CALIFORNIA",9,136511,51399,195308,"FORTNEY PETER STARK","J T EAGER BEAVER","Democrat",0.698952423863846,85112,187910,0.452940237347666
1984,"CALIFORNIA",10,102469,56256,164177,"DON EDWARDS","ROBERT P HERRIOT","Democrat",0.624137363942574,46213,158725,0.291151362419279
1984,"CALIFORNIA",11,147607,59625,211115,"TOM LANTOS","JOHN J ""JACK"" HICKEY","Democrat",0.699178173033655,87982,207232,0.424557983323039
1984,"CALIFORNIA",12,91026,155795,252693,"MARTIN CARNOY","ED ZSCHAU","Republican",0.616538645708429,-64769,246821,-0.262412841694994
1984,"CALIFORNIA",13,139851,70666,214353,"NORMAN Y MINETA","JOHN D ""JACK"" WILLIAMS","Democrat",0.652433135995298,69185,210517,0.328643292465692
1984,"CALIFORNIA",14,58384,179238,244472,"RUTH ""PAULA"" CARLSON","NORM SHUMWAY","Republican",0.733163716090186,-120854,237622,-0.508597688766192
1984,"CALIFORNIA",15,109590,54730,167406,"TONY COELHO","CAROL HARNER","Democrat",0.654636034550733,54860,164320,0.333860759493671
1984,"CALIFORNIA",16,153377,60065,216687,"LEON E PANETTA","PATRICIA SMITH RAMSEY","Democrat",0.707827419272961,93312,213442,0.437177312806289
1984,"CALIFORNIA",17,48888,128802,177690,"SIMON LAKRITZ","CHARLES ""CHIP"" PASHAYAN","Republican",0.724869154144859,-79914,177690,-0.449738308289718
1984,"CALIFORNIA",18,128186,62339,190525,"RICHARD H LEHMAN","DALE L EWEN","Democrat",0.672804093950925,65847,190525,0.34560818790185
1984,"CALIFORNIA",19,70278,153187,227626,"JAMES C CAREY JR","ROBERT J ""BOB"" LAGOMARSINO","Republican",0.672976724978693,-82909,223465,-0.371015595283378
1984,"CALIFORNIA",20,62307,151732,214039,"MIKE LE SAGE","WILLIAM M THOMAS","Republican",0.708898845537495,-89425,214039,-0.417797691074991
1984,"CALIFORNIA",21,62085,173504,239968,"CHARLES ""CHARLIE"" DAVIS","BOBBI FIEDLER","Republican",0.723029737298306,-111419,235589,-0.472938040400868
1984,"CALIFORNIA",23,140461,84093,228134,"ANTHONY C BEILENSON","CLAUDE PARRISH","Democrat",0.615695161615542,56368,224554,0.251022025882416
1984,"CALIFORNIA",24,97340,51010,153607,"HENRY A WAXMAN","JERRY ZERG","Democrat",0.633695079000306,46330,148350,0.312301988540613
1984,"CALIFORNIA",25,74261,24968,103599,"EDWARD R ROYBAL","ROY D ""BILL"" BLOXOM","Democrat",0.716811938339173,49293,99229,0.49676001975229
1984,"CALIFORNIA",26,117080,69372,186452,"HOWARD L BERMAN","MIRIAM OJEDA","Democrat",0.627936412588763,47708,186452,0.255872825177526
1984,"CALIFORNIA",27,116933,88896,212781,"MEL LEVINE","ROBERT B SCRIBNER","Democrat",0.549546247080331,28037,205829,0.136215013433481
1984,"CALIFORNIA",28,113076,33511,149517,"JULIAN C DIXON","BEATRICE M JETT","Democrat",0.756275206163848,79565,146587,0.542783466473835
1984,"CALIFORNIA",29,108777,16781,125558,"AUGUSTUS F ""GUS"" HAWKINS","ECHO Y GOTO","Democrat",0.866348619761385,91996,125558,0.73269723952277
1984,"CALIFORNIA",30,64378,53900,124333,"MATTHEW G ""MARTY"" MARTINEZ","RICHARD GOMEZ","Democrat",0.517786910956866,10478,118278,0.0885879030758045
1984,"CALIFORNIA",31,100658,41691,142349,"MERVYN M DYMALLY","HENRY C MINTURN","Democrat",0.707121230215878,58967,142349,0.414242460431756
1984,"CALIFORNIA",32,102961,62176,169705,"GLENN M ANDERSON","ROGER E FIOLA","Democrat",0.606705754102708,40785,165137,0.24697675263569
1984,"CALIFORNIA",33,54147,147363,208619,"CLAIRE K MCDONALD","DAVID DREIER","Republican",0.706373820217717,-93216,201510,-0.462587464641953
1984,"CALIFORNIA",34,87060,58467,145527,"ESTEBAN E TORRES","PAUL R JACKSON","Democrat",0.598239501948092,28593,145527,0.196479003896184
1984,"CALIFORNIA",36,104438,80212,184650,"GEORGE E BROWN JR","JOHN PAUL STARK","Democrat",0.565599783373951,24226,184650,0.131199566747901
1984,"CALIFORNIA",37,85908,149955,235863,"DAVID E ""DAVE"" SKINNER","AL MCCANDLESS","Republican",0.635771613182229,-64047,235863,-0.271543226364457
1984,"CALIFORNIA",38,73231,86545,162797,"JERRY M PATTERSON","ROBERT K ""BOB"" DORNAN","Republican",0.531612990411371,-13314,159776,-0.0833291608251552
1984,"CALIFORNIA",39,54889,175788,230677,"ROBERT E WARD","WILLIAM E ""BILL"" DANNEMEYER","Republican",0.762052567009281,-120899,230677,-0.524105134018563
1984,"CALIFORNIA",40,86748,164257,254974,"CAROL ANN BRADFORD","ROBERT E BADHAM","Republican",0.64421078227584,-77509,251005,-0.30879464552499
1984,"CALIFORNIA",41,85475,161068,253846,"BOB SIMMONS","BILL LOWERY","Republican",0.634510687582235,-75593,246543,-0.306611828362598
1984,"CALIFORNIA",42,60025,177783,243619,"MARY LOU BROPHY","DAN LUNGREN","Republican",0.72975835218107,-117758,237808,-0.495180986341923
1984,"CALIFORNIA",43,50996,165643,223517,"LOIS E HUMPHREYS","RON PACKARD","Republican",0.741075622883271,-114647,216639,-0.529207575736594
1984,"CALIFORNIA",44,99378,39977,142561,"JIM BATES","NEILL CAMPBELL","Democrat",0.69709106978767,59401,139355,0.426256682573284
1984,"CALIFORNIA",45,45325,149011,198307,"DAVID W GUTHRIE","DUNCAN HUNTER","Republican",0.751415734189918,-103686,194336,-0.533539848509797
1984,"COLORADO",1,126348,73993,203873,"PATRICIA SCHROEDER","MARY DOWNS","Democrat",0.619738758933257,52355,200341,0.261329433316196
1984,"COLORADO",2,118580,101488,222859,"TIMOTHY E WIRTH","MICHAEL J ""MIKE"" NORTON","Democrat",0.532085309545497,17092,220068,0.0776669029572677
1984,"COLORADO",3,90063,122669,214974,"W MITCHELL","MICHAEL L ""MIKE"" STRANG","Republican",0.570622493882981,-32606,212732,-0.153272662316906
1984,"COLORADO",4,56462,146469,205930,"MARY FAGAN BATES","HANK BROWN","Republican",0.711256252124508,-90007,202931,-0.443534994653355
1984,"COLORADO",5,44588,163654,208242,"WILLIAM GEFFEN","KEN KRAMER","Republican",0.785883731427858,-119066,208242,-0.571767462855716
1984,"CONNECTICUT",1,147748,90823,239362,"BARBARA BAILEY KENNELLY","HERSCHEL A KLEIN","Democrat",0.617257542968391,56925,238571,0.238608213068646
1984,"CONNECTICUT",2,124110,103119,228253,"SAMUEL GEJDENSON","ROBERTA F KOONTZ","Democrat",0.543738746040578,20991,227229,0.0923781735605931
1984,"CONNECTICUT",3,129230,115939,245795,"BRUCE A MORRISON","LAWRENCE J DENARDIS","Democrat",0.525763339368173,13291,245169,0.0542115846620087
1984,"CONNECTICUT",4,69666,165644,235310,"JOHN M ORMAN","STEWART B MCKINNEY","Republican",0.703939484084824,-95978,235310,-0.407878968169649
1984,"CONNECTICUT",5,109425,130700,240657,"WILLIAM R RATCHFORD","JOHN G ROWLAND","Republican",0.543096606373386,-21275,240125,-0.0885996876626757
1984,"CONNECTICUT",6,87489,155422,242911,"ARTHUR H HOUSE","NANCY L JOHNSON","Republican",0.639831049232023,-67933,242911,-0.279662098464046
1984,"DELAWARE",0,142070,100650,243014,"THOMAS R CARPER","ELISE DU PONT","Democrat",0.584616524150872,41420,242720,0.17064930784443
1984,"FLORIDA",4,134694,73218,207912,"BILL CHAPPELL","ALTON H ""BILL"" STARLING","Democrat",0.647841394436108,61476,207912,0.295682788872215
1984,"FLORIDA",7,100430,70280,170710,"SAM M GIBBONS","MICHAEL N ""MIKE"" KAVOUKLIS","Democrat",0.588307656259153,30150,170710,0.176615312518306
1984,"FLORIDA",8,45393,184553,229946,"ROBERT KENT","C W BILL YOUNG","Republican",0.802592782653319,-139160,229946,-0.605185565306637
1984,"FLORIDA",9,52150,191343,243493,"JACK WILSON","MICHAEL BILIRAKIS","Republican",0.785825465208445,-139193,243493,-0.571650930416891
1984,"FLORIDA",10,77635,126206,203841,"PATRICIA M ""PAT"" GLASS","ANDY IRELAND","Republican",0.619139427298728,-48571,203841,-0.238278854597456
1984,"FLORIDA",11,145764,95115,240890,"BILL NELSON","ROB QUARTEL","Democrat",0.605106065008925,50649,240879,0.210267395663383
1984,"FLORIDA",14,153935,123926,277861,"DAN MICA","DON ROSS","Democrat",0.554000021593531,30009,277861,0.108000043187061
1984,"FLORIDA",15,66833,128097,194930,"BILL HUMPHREY","E CLAY SHAW JR","Republican",0.657143590006669,-61264,194930,-0.314287180013338
1984,"FLORIDA",16,108410,83903,192313,"LARRY SMITH","TOM BUSH","Democrat",0.563716441426217,24507,192313,0.127432882852433
1984,"FLORIDA",18,76404,49818,126222,"CLAUDE PEPPER","RICARDO NUNEZ","Democrat",0.605314445976137,26586,126222,0.210628891952275
1984,"FLORIDA",19,115631,64317,179951,"DANTE B FASCELL","BILL FLANAGAN","Democrat",0.642569366105218,51314,179948,0.285160157378798
1984,"GEORGIA",1,126082,28460,154563,"LINDSAY THOMAS","ERIE LEE DOWNING","Democrat",0.815732096297303,97622,154542,0.631685884743306
1984,"GEORGIA",3,111061,25410,136473,"RICHARD RAY","MITCH CANTU","Democrat",0.813794670007987,85651,136471,0.627613192546402
1984,"GEORGIA",4,106376,120456,226835,"ELLIOTT H LEVITAS","PAT SWINDALL","Republican",0.531029162166332,-14080,226832,-0.0620723707413416
1984,"GEORGIA",6,52061,116655,168717,"GERALD L JOHNSON","NEWT GINGRICH","Republican",0.691424100713028,-64594,168716,-0.382856397733469
1984,"GEORGIA",7,106586,86431,193020,"GEORGE ""BUDDY"" DARDEN","BILL BRONSON","Democrat",0.552201844368459,20155,193017,0.104420854121658
1984,"GEORGIA",9,109422,52731,162165,"ED JENKINS","FRANK H COFER JR","Democrat",0.674757191749144,56691,162153,0.349614253205306
1984,"HAWAII",1,114884,20608,138865,"CEC HEFTEL","WILL BEARD","Democrat",0.827307096820653,94276,135492,0.695804918371564
1984,"HAWAII",2,112377,20000,136741,"DANIEL K AKAKA","A D ""AL"" SHIPLEY","Democrat",0.821823739770808,92377,132377,0.697832705077166
1984,"IDAHO",1,63591,139085,202676,"BILL HELLER","LARRY CRAIG","Republican",0.686243067753459,-75494,202676,-0.372486135506917
1984,"IDAHO",2,101266,101133,202399,"RICHARD STALLINGS","GEORGE HANSEN","Democrat",0.500328558935568,133,202399,0.000657117871135727
1984,"ILLINOIS",2,155349,31865,187215,"GUS SAVAGE","DALE F HARMAN","Democrat",0.829789279705152,123484,187214,0.659587424017435
1984,"ILLINOIS",3,143363,79218,222582,"MARTIN A RUSSO","RICHARD D MURPHY","Democrat",0.644090717128968,64145,222581,0.288187221730516
1984,"ILLINOIS",4,68547,121744,190291,"DENNIS E MARLOW","GEORGE M O'BRIEN","Republican",0.639778024184013,-53197,190291,-0.279556048368026
1984,"ILLINOIS",5,106597,61109,167708,"WILLIAM O LIPINSKI","JOHN M PACZKOWSKI","Democrat",0.635610704319412,45488,167706,0.27123656875723
1984,"ILLINOIS",6,52189,157370,209562,"ROBERT H RENSHAW","HENRY J HYDE","Republican",0.75094721371241,-105181,209559,-0.501915928211148
1984,"ILLINOIS",7,135493,37411,172908,"CARDISS COLLINS","JAMES L BEVEL","Democrat",0.783613250977398,98082,172904,0.567262758524962
1984,"ILLINOIS",8,114385,46030,160417,"DAN ROSTENKOWSKI","SPIRO F GEORGESON","Democrat",0.713047868991441,68355,160415,0.426113518062525
1984,"ILLINOIS",9,144879,69613,214495,"SIDNEY R YATES","HERBERT SOHN","Democrat",0.675442318002751,75266,214492,0.350903530201593
1984,"ILLINOIS",10,57809,153330,211140,"RUTH C BRAVER","JOHN E PORTER","Republican",0.726200625177607,-95521,211139,-0.452408129241874
1984,"ILLINOIS",11,138171,82518,220690,"FRANK ANNUNZIO","CHARLES J THEUSCH","Democrat",0.626086365490054,55653,220689,0.25217840490464
1984,"ILLINOIS",12,45537,159582,205119,"EDWARD J LAFLAMME","PHILIP M CRANE","Republican",0.777997162622673,-114045,205119,-0.555994325245345
1984,"ILLINOIS",13,77623,157603,235234,"MICHAEL J DONOHUE","HARRIS W FAWELL","Republican",0.669983930894343,-79980,235226,-0.340013433889111
1984,"ILLINOIS",14,82756,135967,218738,"DAN MCCRATH","JOHN E GROTBERG","Republican",0.621597527635802,-53211,218723,-0.243280313455832
1984,"ILLINOIS",15,54516,149096,203613,"JOHN M HOFFMANN","EDWARD R MADIGAN","Republican",0.73225186996901,-94580,203612,-0.464510932558002
1984,"ILLINOIS",16,90850,127684,218538,"CARL R ""SKIP"" SCHWERDTFEGER","LYNN MARTIN","Republican",0.584264521501981,-36834,218534,-0.168550431511801
1984,"ILLINOIS",17,128273,98069,226345,"LANE EVANS","KENNETH G MCMILLAN","Democrat",0.566714528706179,30204,226342,0.133444080197224
1984,"ILLINOIS",18,86884,136183,223106,"GERALD A BRADLEY","ROBERT H MICHEL","Republican",0.610395955285828,-49299,223067,-0.221005348168936
1984,"ILLINOIS",19,117634,107463,225103,"TERRY L BRUCE","DANIEL B CRANE","Democrat",0.522578552929104,10171,225097,0.0451849647041053
1984,"ILLINOIS",20,145092,91728,236821,"RICHARD J DURBIN","RICHARD G AUSTIN","Democrat",0.612665261948898,53364,236820,0.22533569799848
1984,"ILLINOIS",21,127046,84148,211194,"MELVIN PRICE","ROBERT H ""BOB"" GAFFNER","Democrat",0.601560650397265,42898,211194,0.20312130079453
1984,"ILLINOIS",22,116952,115775,232728,"KENNETH J GRAY","RANDY PATCHETT","Democrat",0.502526554604517,1177,232727,0.00505742780167321
1984,"INDIANA",1,147035,59986,207964,"PETER J VISCLOSKY","JOSEPH B GRENCHIK","Democrat",0.707021407551307,87049,207021,0.420483912260109
1984,"INDIANA",2,118965,103061,222663,"PHILIP R SHARP","KEN MACKENZIE","Democrat",0.534282750165048,15904,222026,0.071631250394098
1984,"INDIANA",3,103961,115139,219752,"MICHAEL P BARNES","JOHN HILER","Republican",0.523949725144709,-11178,219100,-0.0510178000912825
1984,"INDIANA",4,82053,129674,213119,"MICHAEL H BARNARD","DANIEL R COATS","Republican",0.608458185333077,-47621,211727,-0.224916992164438
1984,"INDIANA",5,66631,143560,211355,"ALLEN B MAXWELL","ELWOOD H HILLIS","Republican",0.679236355894112,-76929,210191,-0.365995689634666
1984,"INDIANA",6,65772,178814,245864,"HOWARD O CAMPBELL","DAN BURTON","Republican",0.727288256922526,-113042,244586,-0.46217690301162
1984,"INDIANA",7,69097,147787,219694,"ARTHUR E SMITH","JOHN T MYERS","Republican",0.672694748149699,-78690,216884,-0.362820678334962
1984,"INDIANA",8,116645,116641,234092,"FRANK MCCLOSKEY","RICHARD D MCINTYRE","Democrat",0.498286998274183,4,233286,1.71463353994667e-05
1984,"INDIANA",9,137018,72652,210340,"LEE H HAMILTON","FLOYD E COATES","Democrat",0.651411999619663,64366,209670,0.306987170315257
1984,"INDIANA",10,115274,79342,195493,"ANDREW JACOBS JR","JOSEPH P WATKINS","Democrat",0.589657941716583,35932,194616,0.18463024622847
1984,"IOWA",1,65293,131182,196475,"KEVIN READY","JIM LEACH","Republican",0.667677821605802,-65889,196475,-0.335355643211605
1984,"IOWA",2,77335,136893,214228,"JOE WELSH","TOM TAUKE","Republican",0.639006105644454,-59558,214228,-0.278012211288907
1984,"IOWA",3,86574,133737,220311,"JOE JOHNSTON","COOPER EVANS","Republican",0.607037324509443,-47163,220311,-0.214074649018887
1984,"IOWA",4,136922,88717,225639,"NEAL SMITH","ROBERT R LOCKARD","Democrat",0.606818856669281,48205,225639,0.213637713338563
1984,"IOWA",5,101435,104632,206067,"JERRY FITZGERALD","JIM ROSS LIGHTFOOT","Republican",0.507757185769677,-3197,206067,-0.0155143715393537
1984,"IOWA",6,127706,78182,205888,"BERKLEY BEDELL","DARREL RENSINK","Democrat",0.620269272614237,49524,205888,0.240538545228474
1984,"KANSAS",1,49015,159931,210763,"DARRELL T RINGER","PAT ROBERTS","Republican",0.758819147573341,-110916,208946,-0.530835718319566
1984,"KANSAS",2,112263,73045,187052,"JIM SLATTERY","JIM VAN SLYKE","Democrat",0.600170006201484,39218,185308,0.21163684244609
1984,"KANSAS",3,85441,117159,213902,"JOHN E ""JACK"" REARDON","JAN MEYERS","Republican",0.54772278894073,-31718,202600,-0.156554787759131
1984,"KANSAS",4,138917,47776,186693,"DAN GLICKMAN","WILLIAM V KRAUSE","Democrat",0.744093243988794,91141,186693,0.488186487977589
1984,"KANSAS",5,49435,144075,195915,"JOHN A BARNES","BOB WHITTAKER","Republican",0.735395452109333,-94640,193510,-0.489070332282569
1984,"KENTUCKY",2,93042,56700,149742,"WILLIAM H NATCHER","TIMOTHY A MORRISON","Democrat",0.621348719798053,36342,149742,0.242697439596105
1984,"KENTUCKY",3,145680,68185,215138,"ROMANO L MAZZOLI","SUZANNE M WARNER","Democrat",0.677146761613476,77495,213865,0.362354756505272
1984,"KENTUCKY",4,93640,108398,202038,"WM PATRICK MULLOY II","GENE SNYDER","Republican",0.536522832338471,-14758,202038,-0.073045664676942
1984,"KENTUCKY",5,39783,125164,164947,"SHERMAN WILSON MCINTOSH","HAROLD ""HAL"" ROGERS","Republican",0.758813437043414,-85381,164947,-0.517626874086828
1984,"KENTUCKY",6,49657,126525,177108,"JERRY HAMMOND","LARRY J HOPKINS","Republican",0.714394606680669,-76868,176182,-0.436298827348991
1984,"KENTUCKY",7,122679,43890,166569,"CARL C PERKINS","AUBREY ""AUB"" RUSSELL","Democrat",0.736505592277074,78789,166569,0.473011184554149
1984,"MAINE",1,104972,182785,287765,"BARRY J HOBBINS","JOHN R MCKERNAN JR","Republican",0.635188435007732,-77813,287757,-0.270412188061455
1984,"MAINE",2,57347,192166,253773,"CHIPMAN C BULL","OLYMPIA J SNOWE","Republican",0.757235797346447,-134819,249513,-0.540328560034948
1984,"MARYLAND",1,96673,68865,165538,"ROB DYSON","HARLAN C WILLIAMS","Democrat",0.583992799236429,27808,165538,0.167985598472858
1984,"MARYLAND",2,105571,111517,217089,"CLARENCE D LONG","HELEN DELICH BENTLEY","Republican",0.513692540847302,-5946,217088,-0.0273898142688679
1984,"MARYLAND",3,133189,59493,195261,"BARBARA A MIKULSKI","ROSS Z PIERPONT","Democrat",0.68210753811565,73696,192682,0.382474751144373
1984,"MARYLAND",4,58312,114430,172743,"HOWARD M GREENEBAUM","MARJORIE S HOLT","Republican",0.662429157766161,-56118,172742,-0.324865985110743
1984,"MARYLAND",5,116310,44839,161149,"STENY H HOYER","JOHN E RITCHIE","Democrat",0.721754401206337,71471,161149,0.443508802412674
1984,"MARYLAND",6,123383,66056,189442,"BEVERLY B BYRON","ROBIN FICKER","Democrat",0.651296966881684,57327,189439,0.302614561943422
1984,"MARYLAND",8,181947,70715,254569,"MICHAEL D BARNES","ALBERT CECCONE","Democrat",0.714725673589479,111232,252662,0.440240321061339
1984,"MASSACHUSETTS",1,60372,162646,223037,"MARY L WENTWORTH","SILVIO O CONTE","Republican",0.72923326622937,-102274,223018,-0.458590786393923
1984,"MASSACHUSETTS",2,132693,60463,193254,"EDWARD P BOLAND","THOMAS P SWANK","Democrat",0.686624856406594,72230,193156,0.373946447431092
1984,"MASSACHUSETTS",3,148461,71765,220254,"JOSEPH D EARLY","KENNETH J REDDING","Democrat",0.674044512244954,76696,220226,0.348260423383252
1984,"MASSACHUSETTS",4,172903,60121,233032,"BARNEY FRANK","JIM FORTE","Democrat",0.741971059768615,112782,233024,0.483993065092008
1984,"MASSACHUSETTS",5,120008,104912,224927,"CHESTER G ATKINS","GREGORY S HYATT","Democrat",0.533541993624598,15096,224920,0.0671171972256802
1984,"MASSACHUSETTS",6,168662,63363,239649,"NICHOLAS MAVROULES","FREDERICK S LEBER","Democrat",0.703787622731578,105299,232025,0.453826096325827
1984,"MASSACHUSETTS",7,167211,66930,234190,"EDWARD J MARKEY","S LESTER RALPH","Democrat",0.713997181775481,100281,234141,0.428293207938806
1984,"MASSACHUSETTS",10,143062,113745,256824,"GERRY E STUDDS","LEWIS CRAMPTON","Democrat",0.557042955487026,29317,256807,0.114159660756911
1984,"MICHIGAN",1,152432,17393,170510,"JOHN CONYERS JR","EDWARD J MACK","Democrat",0.893976892850859,135039,169825,0.795165611659061
1984,"MICHIGAN",2,62374,140688,205132,"MIKE MCCAULEY","CARL D PURSELL","Republican",0.685841311935729,-78314,203062,-0.385665461780146
1984,"MICHIGAN",3,106505,94714,201224,"HOWARD WOLPE","JACKIE MCGREGOR","Democrat",0.529285771080984,11791,201219,0.0585978461278508
1984,"MICHIGAN",4,63159,127907,191087,"CHARLES S RODEBAUGH","MARK D SILJANDER","Republican",0.669365262943057,-64748,191066,-0.33887766530937
1984,"MICHIGAN",5,85232,140131,226678,"GARY J MCINERNEY","PAUL B HENRY","Republican",0.618194090295485,-54899,225363,-0.243602543452119
1984,"MICHIGAN",6,106705,95113,203530,"BOB CARR","TOM RITTER","Democrat",0.524271606151427,11592,201818,0.0574378895836843
1984,"MICHIGAN",8,126161,69683,195845,"BOB TRAXLER","JOHN HEUSSNER","Democrat",0.64418800582093,56478,195844,0.288382590224873
1984,"MICHIGAN",9,61233,150885,212805,"JOHN MICHAEL SENGER","GUY VANDER JAGT","Republican",0.709029393106365,-89652,212118,-0.42265154300908
1984,"MICHIGAN",10,103636,104950,209645,"DON ALBOSTA","BILL SCHUETTE","Republican",0.500608170955663,-1314,208586,-0.00629955989376085
1984,"MICHIGAN",11,89640,126992,216634,"TOM STEWART","BOB DAVIS","Republican",0.586205304799801,-37352,216632,-0.172421433583219
1984,"MICHIGAN",12,113772,79824,194984,"DAVID E BONIOR","EUGENE J TYZA","Democrat",0.583494030279407,33948,193596,0.175354862703775
1984,"MICHIGAN",13,132222,20416,152638,"GEO W CROCKETT JR","ROBERT MURPHY","Democrat",0.866245626908109,111806,152638,0.732491253816219
1984,"MICHIGAN",14,113610,77427,192142,"DENNIS M HERTEL","JOHN LAUVE","Democrat",0.591281448095679,36183,191037,0.189403099923052
1984,"MICHIGAN",15,98973,66172,165152,"WILLIAM D FORD","GERALD R CARLSON","Democrat",0.599284295679132,32801,165145,0.198619395077054
1984,"MICHIGAN",16,121463,68116,190622,"JOHN D DINGELL","FRANK GRZYWACKI","Democrat",0.637192978774748,53347,189579,0.281397201166796
1984,"MICHIGAN",18,46191,186505,234884,"VIVIAN H SMARGON","WILLIAM S BROOMFIELD","Republican",0.794030244716541,-140314,232696,-0.60299274590023
1984,"MINNESOTA",1,140095,105723,245837,"TIMOTHY J ""TIM"" PENNY","KEITH SPICER","Democrat",0.569869466353722,34372,245818,0.13982702649928
1984,"MINNESOTA",2,89770,153308,243097,"TODD LUNDQUIST","VIN WEBER","Republican",0.630645380239164,-63538,243078,-0.261389348275039
1984,"MINNESOTA",3,76132,207819,283978,"DAVE PETERSON","BILL FRENZEL","Republican",0.731813732049666,-131687,283951,-0.463766635792795
1984,"MINNESOTA",4,167678,57450,228071,"BRUCE F VENTO","MARY JANE RACHNER","Democrat",0.735200880427586,110228,225128,0.489623680750506
1984,"MINNESOTA",5,165075,62642,235442,"MARTIN OLAV SABO","RICHARD ""DICK"" D WEIBLEN","Democrat",0.70112809099481,102433,227717,0.449825880369055
1984,"MINNESOTA",6,154603,101058,255692,"GERRY SIKORSKI","PATRICK TRUEMAN","Democrat",0.604645432786321,53545,255661,0.209437497310892
1984,"MINNESOTA",7,101720,135087,236839,"COLLIN C PETERSON","ARLAN STANGELAND","Republican",0.570374811580863,-33367,236807,-0.140903773959385
1984,"MINNESOTA",8,165727,79181,246483,"JAMES L OBERSTAR","DAVE RUED","Democrat",0.672366856943481,86546,244908,0.353381678017868
1984,"MISSISSIPPI",2,89154,92392,182420,"ROBERT CLARK","WEBB FRANKLIN","Republican",0.506479552680627,-3238,181546,-0.0178357000429643
1984,"MISSISSIPPI",4,113635,91797,205432,"WAYNE DOWDY","DAVID ARMSTRONG","Democrat",0.5531514077651,21838,205432,0.1063028155302
1984,"MISSISSIPPI",5,25840,142637,168477,"ARLON ""BLACKIE"" COATE","TRENT LOTT","Republican",0.846625948942586,-116797,168477,-0.693251897885171
1984,"MISSOURI",1,147436,68538,215974,"WILLIAM ""BILL"" CLAY SR","ERIC RATHBONE","Democrat",0.6826562456592,78898,215974,0.365312491318399
1984,"MISSOURI",2,139123,127710,268616,"ROBERT A YOUNG","JOHN ""JACK"" BUECHNER","Democrat",0.51792521666617,11413,266833,0.0427720709207632
1984,"MISSOURI",4,150624,74434,225058,"IKE SKELTON","CARL D RUSSELL","Democrat",0.669267477716855,76190,225058,0.33853495543371
1984,"MISSOURI",5,150675,72477,228220,"ALAN WHEAT","JIM KENWORTHY","Democrat",0.660218210498642,78198,223152,0.350424822542482
1984,"MISSOURI",6,81917,150996,232913,"KENNETH C HENSLEY","TOM COLEMAN","Republican",0.648293568843302,-69079,232913,-0.296587137686604
1984,"MISSOURI",7,71867,164586,236453,"KEN YOUNG","GENE TAYLOR","Republican",0.696062219553146,-92719,236453,-0.392124439106292
1984,"MISSOURI",8,70922,134186,205108,"BILL BLUE","BILL EMERSON","Republican",0.654221190787293,-63264,205108,-0.308442381574585
1984,"MISSOURI",9,123588,110100,233688,"HAROLD L VOLKMER","CARRIE FRANCKE","Democrat",0.528858991475814,13488,233688,0.0577179829516278
1984,"MONTANA",1,126998,61794,193452,"PAT WILLIAMS","GARY K CARLSON","Democrat",0.656483261997808,65204,188792,0.345374804017119
1984,"MONTANA",2,60445,116932,177377,"CHET BLAYLOCK","RON MARLENEE","Republican",0.659228648584653,-56487,177377,-0.318457297169306
1984,"NEBRASKA",1,55508,158836,214364,"MONICA BAUER","DOUG BEREUTER","Republican",0.740963967830419,-103328,214344,-0.482066211323853
1984,"NEBRASKA",2,75210,139384,214883,"THOMAS F CAVANAUGH","HAL DAUB","Republican",0.648650661057413,-64174,214594,-0.299048435650577
1984,"NEBRASKA",3,36899,183901,220814,"TOM VICKERS","VIRGINIA SMITH","Republican",0.832832157381325,-147002,220800,-0.665769927536232
1984,"NEVADA",1,73242,55391,130518,"HARRY REID","PEGGY CAVNAR","Democrat",0.56116397738243,17851,128633,0.138774653471504
1984,"NEVADA",2,36130,99775,140106,"ANDREW BARBANO","BARBARA F VUCANOVICH","Republican",0.712139380183575,-63645,135905,-0.468305066038777
1984,"NEW HAMPSHIRE",1,76854,111627,190486,"DUDLEY DUDLEY","ROBERT C SMITH","Republican",0.586011570404124,-34773,188481,-0.184490744425168
1984,"NEW HAMPSHIRE",2,42257,138975,182411,"LARRY CONVERSE","JUDD GREGG","Republican",0.7618783954915,-96718,181232,-0.533669550631235
1984,"NEW JERSEY",1,152125,58800,211711,"JAMES J FLORIO","FREDERICK A BUSCH JR","Democrat",0.718550287892457,93325,210925,0.44245584923551
1984,"NEW JERSEY",2,132841,77231,210072,"WILLIAM J HUGHES","RAYMOND G MASSIE","Democrat",0.632359381545375,55610,210072,0.26471876309075
1984,"NEW JERSEY",3,122291,105028,229422,"JAMES J HOWARD","BRIAN T KENNEDY","Democrat",0.533039551568725,17263,227319,0.0759417382620898
1984,"NEW JERSEY",4,87908,139295,227203,"JAMES C HEDDEN","CHRISTOPHER H SMITH","Republican",0.613086094813889,-51387,227203,-0.226172189627778
1984,"NEW JERSEY",5,69666,171979,241645,"ROSE BRUNETTO","MARGE ROUKEMA","Republican",0.711701049059571,-102313,241645,-0.423402098119142
1984,"NEW JERSEY",6,118532,90862,212080,"BERNARD J DWYER","DENNIS ADAMS","Democrat",0.558902301018484,27670,209394,0.132143232375331
1984,"NEW JERSEY",7,56798,165685,223282,"JOHN F FEELEY","MATTHEW J RINALDO","Republican",0.742043693625102,-108887,222483,-0.489417168952235
1984,"NEW JERSEY",8,118793,69973,189395,"ROBERT A ROE","MARGUERITE A PAGE","Democrat",0.627223527548246,48820,188766,0.258627083267114
1984,"NEW JERSEY",9,149493,89166,238659,"ROBERT G TORRICELLI","NEIL ROMANO","Democrat",0.626387439819994,60327,238659,0.252774879639988
1984,"NEW JERSEY",10,111244,21712,132956,"PETER W RODINO JR","HOWARD E BERKELEY","Democrat",0.83669785492945,89532,132956,0.673395709858901
1984,"NEW JERSEY",11,106038,133662,239700,"JOSEPH G MINISH","DEAN A GALLO","Republican",0.557622027534418,-27624,239700,-0.115244055068836
1984,"NEW JERSEY",12,78167,148042,227833,"PETER BEARSE","JIM COURTER","Republican",0.649782955059188,-69875,226209,-0.308895755694955
1984,"NEW JERSEY",13,89307,141136,232483,"JAMES B SMITH","H JAMES SAXTON","Republican",0.607080947854252,-51829,230443,-0.224910281501282
1984,"NEW JERSEY",14,115117,58265,175217,"FRANK J GUARINI","EDWARD T MAGEE","Democrat",0.656996752598207,56852,173382,0.327900243393201
1984,"NEW MEXICO",1,60598,115808,178342,"CHARLES TED ASHBURY","MANUEL LUJAN JR","Republican",0.64935909656727,-55210,176406,-0.312971214131039
1984,"NEW MEXICO",2,40063,116006,156069,"PETER R YORK","JOSEPH R SKEEN","Republican",0.743299438069059,-75943,156069,-0.486598876138118
1984,"NEW MEXICO",3,100470,62351,165209,"BILL RICHARDSON","LOUIS H GALLEGOS","Democrat",0.608138781785496,38119,162821,0.234115992408842
1984,"NEW YORK",1,84058,92262,201580,"GEORGE J HOCHBRUECKNER","WILLIAM CARNEY","Republican",0.457694215696002,-8204,176320,-0.0465290381125227
1984,"NEW YORK",2,92329,69247,178503,"THOMAS J DOWNEY","PAUL ANIBOLI","Democrat",0.517240606600449,23082,161576,0.142855374560578
1984,"NEW YORK",3,120191,100591,235751,"ROBERT J MRAZEK","ROBERT P QUINN","Democrat",0.509821803513029,19600,220782,0.0887753530632026
1984,"NEW YORK",4,63213,138209,224679,"SHELDON ENGELHARD","NORMAN F LENT","Republican",0.615139821701183,-74996,201422,-0.372332714400612
1984,"NEW YORK",5,77743,125236,222191,"MICHAEL D'INNOCENZO","RAYMOND J MCGRATH","Republican",0.563641191587418,-47493,202979,-0.233979869838752
1984,"NEW YORK",6,116411,18195,145138,"JOSEPH P ADDABBO","PHILIP J VELTRE","Democrat",0.802071132301671,98216,134606,0.729655438836307
1984,"NEW YORK",7,92478,37784,141044,"GARY L ACKERMAN","GUSTAVE A REIFENKUGEL","Democrat",0.65566773489124,54694,130262,0.419876863551918
1984,"NEW YORK",8,99046,54264,166573,"JAMES H SCHEUER","ROBERT L BRANDOFINO","Democrat",0.594610170916055,44782,153310,0.292100971887026
1984,"NEW YORK",9,71420,54089,135330,"THOMAS J MANTON","SERPHIN R MALTESE","Democrat",0.52774698884209,17331,125509,0.138085714968648
1984,"NEW YORK",10,110308,36876,159992,"CHARLES E SCHUMER","JOHN H FOX","Democrat",0.689459472973649,73432,147184,0.498912925317969
1984,"NEW YORK",11,77169,12494,95064,"EDOLPHUS TOWNS","NATHANIEL HENDRICKS","Democrat",0.811758394344862,64675,89663,0.721312023911759
1984,"NEW YORK",12,78364,7053,90656,"MAJOR R OWENS","JOSEPH N CAESAR","Democrat",0.864410518884575,71311,85417,0.834857229825445
1984,"NEW YORK",13,78455,37408,125347,"STEPHEN J SOLARZ","LEW Y LEVIN","Democrat",0.625902494674783,41047,115863,0.354271855553542
1984,"NEW YORK",14,49776,98148,166817,"KEVIN L SHEEHY","GUY V MOLINARI","Republican",0.588357301713854,-48372,147924,-0.327005759714448
1984,"NEW YORK",15,78575,102317,192048,"ANDREW J STEIN","BILL GREEN","Republican",0.532767849704241,-23742,180892,-0.131249585387966
1984,"NEW YORK",16,104337,13422,121398,"CHARLES B RANGEL","CHARLES B RANGEL","Democrat",0.85946226461721,90915,117759,0.772042901179528
1984,"NEW YORK",17,151534,33316,199479,"TED WEISS","KENNETH KATZMAN","Democrat",0.759648885346327,118218,184850,0.63953475791182
1984,"NEW YORK",18,81260,8970,96328,"ROBERT GARCIA","CURTIS JOHNSON","Democrat",0.84357611494062,72290,90230,0.801174775573534
1984,"NEW YORK",19,83339,66025,163539,"MARIO BIAGGI","MARIO BIAGGI","Democrat",0.509597099162891,17314,149364,0.11591815966364
1984,"NEW YORK",20,102842,93518,213349,"OREN J TEICHER","JOSEPH J DIOGUARDI","Democrat",0.482036475446334,9324,196360,0.047484212670605
1984,"NEW YORK",21,44274,141091,204327,"LAWRENCE W GRUNBERGER","HAMILTON FISH JR","Republican",0.690515692982327,-96817,185365,-0.522304642192431
1984,"NEW YORK",22,55008,144278,210486,"BRUCE M LEVINE","BENJAMIN A GILMAN","Republican",0.685451764012808,-89270,199286,-0.447949178567486
1984,"NEW YORK",23,188144,49092,241846,"SAMUEL S STRATTON","FRANK WICKS","Democrat",0.777949604293641,139052,237236,0.5861336390767
1984,"NEW YORK",24,60188,147150,224207,"EDWARD JAMES BLOCH","GERALD B SOLOMON","Republican",0.65631313919726,-86962,207338,-0.419421427813522
1984,"NEW YORK",25,52434,140256,192690,"JAMES J BALL","SHERWOOD L BOEHLERT","Republican",0.72788416627744,-87822,192690,-0.455768332554881
1984,"NEW YORK",26,54663,122168,185920,"BERNARD J LAMMERS","DAVID O'B MARTIN","Republican",0.65709982788296,-67505,176831,-0.381748675288835
1984,"NEW YORK",27,88121,112247,215816,"THOMAS C BUCKEL JR","GEORGE C WORTLEY","Republican",0.520105089520703,-24126,200368,-0.120408448454843
1984,"NEW YORK",28,123334,90324,218061,"MATT MCHUGH","CONSTANCE E COOK","Democrat",0.565594031028015,33010,213658,0.154499246459295
1984,"NEW YORK",29,48301,138362,198662,"JAMES R TOOLE","FRANK HORTON","Republican",0.696469380153225,-90061,186663,-0.482479120125574
1984,"NEW YORK",30,100066,109184,220273,"W DOUGLAS CALL","FRED J ECKERT","Republican",0.495675820459157,-9118,209250,-0.0435746714456392
1984,"NEW YORK",31,53513,152810,224488,"PETER J MARTINELLI","JACK F KEMP","Republican",0.680704536545383,-99297,206323,-0.481269659708321
1984,"NEW YORK",32,132826,54320,201776,"JOHN J LAFALCE","ANTHONY J MURTY","Democrat",0.65828443422409,78506,187146,0.419490665042266
1984,"NEW YORK",33,148085,37411,200078,"HENRY J NOWAK","DAVID S LEWANDOWSKI","Democrat",0.740136346824738,110674,185496,0.596638202441023
1984,"NEW YORK",34,110902,84520,204478,"STAN LUNDINE","JILL HOUGHTON EMERY","Democrat",0.542366415946948,26382,195422,0.135000153513934
1984,"NORTH CAROLINA",1,122815,60153,182968,"WALTER B JONES","HERBERT W LEE","Democrat",0.671237593458965,62662,182968,0.342475186917931
1984,"NORTH CAROLINA",2,122292,58312,180604,"I T ""TIM"" VALENTINE JR","FRANK H HILL","Democrat",0.677127859848065,63980,180604,0.354255719696131
1984,"NORTH CAROLINA",3,100185,56096,156281,"CHARLES O WHITLEY","DANNY G MOODY","Democrat",0.641056814328037,44089,156281,0.282113628656075
1984,"NORTH CAROLINA",4,114462,117436,231898,"IKE ANDREWS","WILLIAM W ""BILL"" COBEY JR","Republican",0.506412301960345,-2974,231898,-0.0128246039206893
1984,"NORTH CAROLINA",5,109831,106599,216430,"STEPHEN L ""STEVE"" NEAL","STUART ""STU"" EPPERSON","Democrat",0.507466617382063,3232,216430,0.014933234764127
1984,"NORTH CAROLINA",6,100263,102925,203473,"ROBIN BRITT","HOWARD COBLE","Republican",0.505841069822532,-2662,203188,-0.0131011673917751
1984,"NORTH CAROLINA",7,92157,63625,155782,"CHARLES G ROSE III","S THOMAS ""TOMMY"" RHODES","Democrat",0.591576690503396,28532,155782,0.183153381006792
1984,"NORTH CAROLINA",8,99731,96354,196085,"WG ""BILL"" HEFNER","HARRIS D BLAKE","Democrat",0.508611061529439,3377,196085,0.0172221230588775
1984,"NORTH CAROLINA",9,109099,109420,218519,"D G MARTIN","J ALEX MCMILLAN","Republican",0.500734489907056,-321,218519,-0.00146897981411227
1984,"NORTH CAROLINA",10,51860,142873,194733,"TED A POOVEY","JAMES T ""JIM"" BROYHILL","Republican",0.733686637601228,-91013,194733,-0.467373275202457
1984,"NORTH CAROLINA",11,108284,112598,220882,"JAMES MCCLURE CLARKE","WILLIAM M ""BILL"" HENDON","Republican",0.509765395097835,-4314,220882,-0.0195307901956701
1984,"NORTH DAKOTA",0,242968,65761,308729,"BYRON L DORGAN","LOIS IVERS ALTENBURG","Democrat",0.786994419053604,177207,308729,0.573988838107207
1984,"OHIO",1,121577,88859,220658,"THOMAS A LUKEN","NORMAN A MURDOCK","Democrat",0.550974811699553,32718,210436,0.155477199718679
1984,"OHIO",2,68597,149856,218453,"THOMAS J PORTER","WILLIS D GRADISON JR","Republican",0.685987374858665,-81259,218453,-0.371974749717331
1984,"OHIO",4,47018,162199,209217,"WILLIAM O SUTTON","MICHAEL G OXLEY","Republican",0.775266828221416,-115181,209217,-0.550533656442832
1984,"OHIO",5,78809,132582,211391,"JAMES R SHERCK","DELBERT L LATTA","Republican",0.627188480115047,-53773,211391,-0.254376960230095
1984,"OHIO",6,52727,150101,202828,"BOB SMITH","BOB MCEWAN","Republican",0.740040822766088,-97374,202828,-0.480081645532175
1984,"OHIO",7,40621,147885,192858,"DONALD E SCOTT","MICHAEL DEWINE","Republican",0.766807703076875,-107264,188506,-0.56902167570263
1984,"OHIO",8,46673,155200,201873,"JOHN T FRANCIS","THOMAS N KINDNESS","Republican",0.768800186255715,-108527,201873,-0.53760037251143
1984,"OHIO",9,117985,93210,214909,"MARCY KAPTUR","FRANK VENNER","Democrat",0.548999809221578,24775,211195,0.117308648405502
1984,"OHIO",10,55172,149337,204509,"JOHN M BUCHANAN","CLARENCE E MILLER","Republican",0.73022214181283,-94165,204509,-0.46044428362566
1984,"OHIO",11,133096,66278,199374,"DENNIS E ECKART","DEAN BEAGLE","Democrat",0.667569492511561,66818,199374,0.335138985023122
1984,"OHIO",12,65215,148899,214114,"RICHARD S SLOAN","JOHN R KASICH","Republican",0.695419262635792,-83684,214114,-0.390838525271584
1984,"OHIO",13,131923,59610,198756,"DONALD J PEASE","WILLIAM G SCHAFFNER","Democrat",0.663743484473425,72313,191533,0.377548516443642
1984,"OHIO",14,155729,62366,218095,"JOHN F SEIBERLING","JEAN E BENDER","Democrat",0.71404204589743,93363,218095,0.42808409179486
1984,"OHIO",15,58870,148311,207181,"DUANE JAGER","CHALMERS P WYLIE","Republican",0.715852322365468,-89441,207181,-0.431704644730936
1984,"OHIO",16,58048,152399,210447,"JAMES GWIN","RALPH REGULA","Republican",0.724168080324262,-94351,210447,-0.448336160648524
1984,"OHIO",17,123014,105449,230661,"JAMES A TRAFICANT JR","LYLE WILLIAMS","Democrat",0.533310789426908,17565,228463,0.0768833465375137
1984,"OHIO",18,155759,49356,205115,"DOUGLAS APPLEGATE","KENNETH P BURT JR","Democrat",0.759374009701875,106403,205115,0.518748019403749
1984,"OHIO",19,139605,107957,252839,"EDWARD F FEIGHAN","MATTHEW J HATCHADORIAN","Democrat",0.552149787018617,31648,247562,0.127838682835007
1984,"OHIO",21,165247,29500,200648,"LOUIS STOKES","ROBERT L WOODALL","Democrat",0.823566644073203,135747,194747,0.697042829928061
1984,"OKLAHOMA",1,113919,103098,218093,"JAMES R JONES","FRANK KEATING","Democrat",0.522341386472743,10821,217017,0.0498624531718713
1984,"OKLAHOMA",2,148124,51889,200013,"MIKE SYNAR","GARY K RICE","Democrat",0.740571862828916,96235,200013,0.481143725657832
1984,"OKLAHOMA",3,137964,39454,177418,"WES WATKINS","PATRICK K MILLER","Democrat",0.777621210925611,98510,177418,0.555242421851221
1984,"OKLAHOMA",4,109447,60844,172039,"DAVE MCCURDY","JERRY SMITH","Democrat",0.636175518341771,48603,170291,0.285411442765619
1984,"OKLAHOMA",5,39089,135167,178726,"ALLEN GREESON","MICKEY EDWARDS","Republican",0.756280563544196,-96078,174256,-0.551361215682674
1984,"OKLAHOMA",6,96994,67601,164595,"GLENN ENGLISH","CRAIG DODD","Democrat",0.589288860536468,29393,164595,0.178577721072937
1984,"OREGON",1,138393,122247,260667,"LES AUCOIN","BILL MOSHOFSKY","Democrat",0.53091875841591,16146,260640,0.0619475138121547
1984,"OREGON",2,100152,132649,232826,"LARRYANN C WILLIS","ROBERT F ""BOB"" SMITH","Republican",0.569734479826136,-32497,232801,-0.139591324779533
1984,"OREGON",3,173438,66394,239897,"RON WYDEN","DREW DAVIS","Democrat",0.722968607360659,107044,239832,0.446329097034591
1984,"OREGON",4,134190,96487,230687,"JIM WEAVER","BRUCE LONG","Democrat",0.581697278130107,37703,230677,0.163444990181076
1984,"OREGON",5,108919,130424,239414,"RUTH MCFARLAND","DENNY SMITH","Republican",0.544763464124905,-21505,239343,-0.0898501314013779
1984,"PENNSYLVANIA",1,148123,49559,197682,"THOMAS M FOGLIETTA","CARMINE DI BIASE","Democrat",0.749299379812021,98564,197682,0.498598759624043
1984,"PENNSYLVANIA",2,200484,18224,220295,"WILLIAM H GRAY III","RONALD J SHARPER","Democrat",0.910070587167208,182260,218708,0.833348574354848
1984,"PENNSYLVANIA",3,152598,85358,238786,"ROBERT A BORSKI","FLORA L BECKER","Democrat",0.639057566188973,67240,237956,0.282573248835919
1984,"PENNSYLVANIA",4,114040,86769,200809,"JOSEPH P KOLTER","JIM KUNDER","Democrat",0.567902833040352,27271,200809,0.135805666080704
1984,"PENNSYLVANIA",5,53586,141965,195551,"LOUIS J FANTI","RICHARD T SCHULZE","Republican",0.725974298264903,-88379,195551,-0.451948596529806
1984,"PENNSYLVANIA",7,124458,124046,248504,"BOB EDGAR","CURT WELDON","Democrat",0.50082896049963,412,248504,0.00165792099925957
1984,"PENNSYLVANIA",8,112648,108696,221344,"PETER H KOSTMAYER","DAVID A CHRISTIAN","Democrat",0.508927280612983,3952,221344,0.017854561225965
1984,"PENNSYLVANIA",9,59549,118437,177986,"NANCY KULP","BUD SHUSTER","Republican",0.665428741586417,-58888,177986,-0.330857483172834
1984,"PENNSYLVANIA",10,44571,150166,194737,"GENE BASALYGA","JOSEPH M MCDADE","Republican",0.771122077468586,-105595,194737,-0.542244154937172
1984,"PENNSYLVANIA",11,108430,76692,185122,"PAUL E KANJORSKI","ROBERT P HUDOCK","Democrat",0.585721848294638,31738,185122,0.171443696589276
1984,"PENNSYLVANIA",12,134384,57446,194494,"JOHN P MURTHA","THOMAS J FULLARD III","Democrat",0.690941622877827,76938,191830,0.401073867486837
1984,"PENNSYLVANIA",13,104756,133948,238704,"JOSEPH M HOEFFEL","LAWRENCE COUGHLIN","Republican",0.561146859709096,-29192,238704,-0.122293719418192
1984,"PENNSYLVANIA",14,163818,42616,213797,"WILLIAM J COYNE","JOHN ROBERT CLARK","Democrat",0.766231518683611,121202,206434,0.587122276369203
1984,"PENNSYLVANIA",15,79490,110338,189828,"JANE WELLS-SCHOOLEY","DON RITTER","Republican",0.581252502265209,-30848,189828,-0.162505004530417
1984,"PENNSYLVANIA",16,39515,138477,177992,"MARTIN L BARD","ROBERT S WALKER","Republican",0.777995640253495,-98962,177992,-0.555991280506989
1984,"PENNSYLVANIA",17,48935,129716,178651,"STEPHEN A ANDERSON","GEORGE W GEKAS","Republican",0.726086056053423,-80781,178651,-0.452172112106845
1984,"PENNSYLVANIA",18,149628,87521,238489,"DOUG WALGREN","JOHN G MAXWELL","Democrat",0.627400005870292,62107,237149,0.261890204048931
1984,"PENNSYLVANIA",19,44117,141196,186742,"JOHN RARIG","BILL GOODLING","Republican",0.756102001692174,-97079,185313,-0.523865028357428
1984,"PENNSYLVANIA",20,158751,50247,208998,"JOSEPH M GAYDOS","DANIEL LLOYD","Democrat",0.759581431401257,108504,208998,0.519162862802515
1984,"PENNSYLVANIA",21,65594,125730,192109,"JAMES A YOUNG","TOM RIDGE","Republican",0.65447220067774,-60136,191324,-0.314314984006188
1984,"PENNSYLVANIA",22,153514,39752,194428,"AUSTIN J MURPHY","NANCY S PRYOR","Democrat",0.789567346266999,113762,193266,0.58862914325334
1984,"PENNSYLVANIA",23,88957,94952,183909,"BILL WACHOB","BILL CLINGER","Republican",0.516298821699862,-5995,183909,-0.0325976433997249
1984,"RHODE ISLAND",1,130584,60026,190610,"FERNAND J ST GERMAIN","ALFRED R REGO JR","Democrat",0.685084727978595,70558,190610,0.37016945595719
1984,"RHODE ISLAND",2,64341,134282,198623,"RICHARD SINAPI","CLAUDINE SCHNEIDER","Republican",0.676064705497349,-69941,198623,-0.352129410994699
1984,"SOUTH CAROLINA",1,64022,103288,167310,"ED PENDARVIS","THOMAS F HARTNETT","Republican",0.617345048114279,-39266,167310,-0.234690096228558
1984,"SOUTH CAROLINA",2,63932,108085,174027,"KEN MOSELY","FLOYD D SPENCE","Republican",0.621081786159619,-44153,172017,-0.25667811902312
1984,"SOUTH CAROLINA",3,88917,61739,152166,"BUTLER DERRICK","CLARENCE E TAYLOR","Democrat",0.584342100074918,27178,150656,0.180397727272727
1984,"SOUTH CAROLINA",4,57854,105139,164424,"JEFF SMITH","CARROLL A CAMPBELL","Republican",0.63943828151608,-47285,162993,-0.290104483014608
1984,"SOUTH CAROLINA",6,97329,63005,162384,"ROBIN TALLON","LOIS EARGLE","Democrat",0.599375554241797,34324,160334,0.214078111941322
1984,"SOUTH DAKOTA",0,181401,134821,316222,"TOM DASCHLE","DALE BELL","Democrat",0.57365078963513,46580,316222,0.147301579270259
1984,"TENNESSEE",2,38846,132604,171453,"JOHN F BOWEN","JOHN J DUNCAN","Republican",0.773413121963454,-93758,171450,-0.546853310002916
1984,"TENNESSEE",3,99465,90216,189683,"MARILYN LLOYD","JOHN DAVIS","Democrat",0.52437487808607,9249,189681,0.0487608142091195
1984,"TENNESSEE",4,93848,31011,124863,"JIM COOPER","JAMES BEAU SEIGNEUR","Democrat",0.75160776210727,62837,124859,0.503263681432656
1984,"TENNESSEE",6,103989,61559,165565,"BART GORDON","JOE SIMPKINS","Democrat",0.628085646120859,42430,165548,0.256300287529901
1984,"TENNESSEE",9,133428,53064,186497,"HAROLD E FORD","WILLIAM BRYAN THOMPSON JR","Democrat",0.715443143857542,80364,186492,0.430924650923364
1984,"TEXAS",2,113225,77842,191067,"CHARLES WILSON","LOUIS DUGAS JR","Democrat",0.592593174122167,35383,191067,0.185186348244333
1984,"TEXAS",3,46890,228819,275709,"JIM WESTBROOK","STEVE BARTLETT","Republican",0.829929382065874,-181929,275709,-0.659858764131748
1984,"TEXAS",4,120749,87553,208341,"RALPH M HALL","THOMAS BLOW","Democrat",0.579573871681522,33196,208302,0.159364768461177
1984,"TEXAS",6,100799,131482,232281,"DAN KUBIAK","JOE BARTON","Republican",0.566047158398664,-30683,232281,-0.132094316797327
1984,"TEXAS",7,32835,213480,246315,"BILLY WILLIBEY","BILL ARCHER","Republican",0.866695085561172,-180645,246315,-0.733390171122343
1984,"TEXAS",8,62072,113031,175103,"DON BUFORD","JACK FIELDS","Republican",0.645511498946334,-50959,175103,-0.291022997892669
1984,"TEXAS",9,120559,84306,204865,"JACK BROOKS","JIM MAHAN","Democrat",0.588480218680595,36253,204865,0.176960437361189
1984,"TEXAS",13,95367,107600,202967,"JACK HIGHTOWER","BEAU BOULTER","Republican",0.530135440736672,-12233,202967,-0.060270881473343
1984,"TEXAS",14,98885,104181,203066,"BILL PATMAN","MAC SWEENEY","Republican",0.513040095338461,-5296,203066,-0.0260801906769228
1984,"TEXAS",16,76375,56589,132964,"RONALD COLEMAN","JACK HAMMOND","Democrat",0.574403597966367,19786,132964,0.148807195932734
1984,"TEXAS",18,109626,26400,139110,"MICKEY LELAND","GLEN E BEAMAN","Democrat",0.788052620228596,83226,136026,0.611838913148957
1984,"TEXAS",19,74044,102805,176849,"DON R RICHARDS","LARRY COMBEST","Republican",0.581315133249269,-28761,176849,-0.162630266498538
1984,"TEXAS",21,48039,199909,247980,"JOE SULLIVAN","TOM LOEFFLER","Republican",0.806149689491088,-151870,247948,-0.612507461241873
1984,"TEXAS",22,66495,125225,191751,"DOUG WILLIAMS","TOM DELAY","Republican",0.653060479475987,-58730,191720,-0.30633215105362
1984,"TEXAS",24,105210,71703,176918,"MARTIN FROST","BOB BURK","Democrat",0.594682282187228,33507,176913,0.189398178765834
1984,"TEXAS",25,113946,63974,177920,"MIKE ANDREWS","JERRY PATTERSON","Democrat",0.640433902877698,49972,177920,0.280867805755396
1984,"TEXAS",26,120451,126641,247094,"TOM VANDERGRIFF","RICHARD ""DICK"" ARMEY","Republican",0.512521550503047,-6190,247092,-0.0250513978599064
1984,"TEXAS",27,105516,60283,165799,"SOLOMON P ORTIZ","RICHARD MOORE","Democrat",0.63640914601415,45233,165799,0.272818292028299
1984,"UTAH",1,56619,142952,200717,"MILTON C ABRAMS","JAMES V HANSEN","Republican",0.712206738841254,-86333,199571,-0.432592911795802
1984,"UTAH",2,105044,105540,213793,"FRANCES FARLEY","DAVID SMITH MONSON","Republican",0.493655077575038,-496,210584,-0.0023553546328306
1984,"UTAH",3,46560,138918,186572,"BRUCE R BAIRD","HOWARD C NIELSON","Republican",0.744581180455803,-92358,185478,-0.497945848025103
1984,"VERMONT",0,60360,148025,226297,"ANTHONY POLLINA","JAMES M JEFFORDS","Republican",0.654118260516047,-87665,208385,-0.420687669457974
1984,"VIRGINIA",1,79577,118085,199822,"JOHN J MCGLENNON","HERBERT H ""HERB"" BATEMAN","Republican",0.590950946342245,-38508,197662,-0.194817415588226
1984,"VIRGINIA",6,105207,91344,196560,"JAMES R ""JIM"" OLIN","RAY L GARLAND","Democrat",0.535241147741148,13863,196551,0.0705313124837828
1984,"VIRGINIA",7,77624,109110,193156,"LEWIS M COSTELLO","D FRENCH SLAUGHTER JR","Republican",0.564880200459732,-31486,186734,-0.168614178457057
1984,"VIRGINIA",8,97250,125015,224091,"RICHARD L ""DICK"" SASLAW","STANFORD E ""STAN"" PARRIS","Republican",0.557876041429598,-27765,222265,-0.124918453197759
1984,"VIRGINIA",9,102446,94510,196956,"FREDERICK C ""RICK"" BOUCHER","C JEFFERSON STAFFORD","Democrat",0.520146631735007,7936,196956,0.0402932634700136
1984,"VIRGINIA",10,95074,158528,253625,"JOHN P FLANNERY II","FRANK R WOLF","Republican",0.625048792508625,-63454,253602,-0.250210960481384
1984,"WASHINGTON",1,115001,147926,262927,"BROCK EVANS","JOHN MILLER","Republican",0.562612436151479,-32925,262927,-0.125224872302959
1984,"WASHINGTON",2,142065,93472,242392,"AL SWIFT","JIM KLAUDER","Democrat",0.586096075778078,48593,235537,0.206307289300619
1984,"WASHINGTON",3,150432,61219,211651,"DON BONKER","HERB ELDER","Democrat",0.710754969265442,89213,211651,0.421509938530883
1984,"WASHINGTON",4,47158,150322,197480,"MARK EPPERSON","SID MORRISON","Republican",0.76120113429208,-103164,197480,-0.52240226858416
1984,"WASHINGTON",5,154988,67438,222426,"THOMAS S FOLEY","JACK HEBNER","Democrat",0.696807027955365,87550,222426,0.39361405591073
1984,"WASHINGTON",6,124367,60721,188041,"NORM DICKS","MIKE LONGERGAN","Democrat",0.661382358102754,63646,185088,0.343868862378977
1984,"WASHINGTON",7,174560,71576,247846,"MIKE LOWRY","ROBERT O DORSE","Democrat",0.704308320489336,102984,246136,0.41840283420548
1984,"WASHINGTON",8,88379,146891,235270,"BOB LAMSON","ROD CHANDLER","Republican",0.62435074595146,-58512,235270,-0.24870149190292
1984,"WEST VIRGINIA",1,104639,87622,192261,"ALAN B MOLLOHAN","JIM ALTMEYER","Democrat",0.54425494510067,17017,192261,0.0885098902013409
1984,"WEST VIRGINIA",2,100345,78936,179281,"HARLEY O STAGGERS JR","CLEVE BENEDICT","Democrat",0.559707944511688,21409,179281,0.119415889023377
1984,"WEST VIRGINIA",3,125306,59128,184434,"ROBERT E WISE JR","MARGARET ""PEGGY"" MILLER","Democrat",0.679408352039212,66178,184434,0.358816704078424
1984,"WEST VIRGINIA",4,98919,49474,148393,"NICK JOE RAHALL II","JESS T SHUMATE","Democrat",0.666601524330662,49445,148393,0.333203048661325
1984,"WISCONSIN",1,127184,99080,226264,"LES ASPIN","PETE JANSSON","Democrat",0.562104444365873,28104,226264,0.124208888731747
1984,"WISCONSIN",2,159987,91345,251357,"ROBERT KASTENMEIER","ALBERT LEE WILEY JR","Democrat",0.636493115369773,68642,251332,0.273112854710105
1984,"WISCONSIN",3,74253,160437,234695,"CHARLES F DAHL","STEVEN C GUNDERSON","Republican",0.683597861053708,-86184,234690,-0.367224849801866
1984,"WISCONSIN",4,158722,78056,238222,"GERALD D KLECZKA","ROBERT V NOLAN","Democrat",0.666277673766487,80666,236778,0.340681989036144
1984,"WISCONSIN",6,54266,170271,224546,"DAVID L IAQUINTA","THOMAS E PETRI","Republican",0.75829006083386,-116005,224537,-0.516640909961387
1984,"WISCONSIN",7,146131,92507,238652,"DAVID R OBEY","MARK G MICHAELSEN","Democrat",0.612318354759231,53624,238638,0.224708554379437
1984,"WISCONSIN",8,73090,161005,237107,"PAUL WILLEMS","TOBY ROTH","Republican",0.679039421020889,-87915,234095,-0.375552660244772
1984,"WISCONSIN",9,64157,180247,245716,"JOHN KRAUSE","F JAMES SENSENBRENNER JR","Republican",0.733558254244738,-116090,244404,-0.474992225986481
1984,"WYOMING",0,45857,138234,187904,"HUGH B MCFADDEN JR","DICK CHENEY","Republican",0.735662891689373,-92377,184091,-0.501800739851487
1986,"ALABAMA",2,57568,115302,172870,"MERCER STONE","BILL DICKINSON","Republican",0.666986753051426,-57734,172870,-0.333973506102852
1986,"ALABAMA",3,115127,27769,142896,"BILL NICHOLS","WHITE GUERIN","Democrat",0.805669857798679,87358,142896,0.611339715597358
1986,"ALABAMA",4,132881,38588,171469,"TOM BEVILL","AL DESHAZO","Democrat",0.774956406114225,94293,171469,0.549912812228449
1986,"ALABAMA",5,125406,33528,158934,"RONNIE FLIPPO","HERB MCCARLEY","Democrat",0.789044509041489,91878,158934,0.578089018082978
1986,"ALABAMA",6,139608,51924,191976,"BEN ERDREICH","L MORGAN WILLIAM","Democrat",0.727215901987748,87684,191532,0.457803395777207
1986,"ALABAMA",7,108126,72777,180903,"CLAUDE HARRIS","BILL MCFARLAND","Democrat",0.59770153065455,35349,180903,0.195403061309099
1986,"ALASKA",0,74053,101799,180277,"PEGGE BEGICH","DON YOUNG","Republican",0.564681018654626,-27746,175852,-0.157780406250711
1986,"ARIZONA",1,51163,127370,178533,"HARRY BRAUN III","JOHN J RHODES III","Republican",0.713425529173878,-76207,178533,-0.426851058347756
1986,"ARIZONA",2,77239,24522,105407,"MORRIS K UDALL","SHELDON CLARK","Democrat",0.732769170927927,52717,101761,0.51804718900168
1986,"ARIZONA",4,66894,121939,188833,"PHILIP R DAVIS","JON KYL","Republican",0.64575047793553,-55045,188833,-0.291500955871061
1986,"ARIZONA",5,64848,119647,184495,"JOEL IRELAND","JIM KOLBE","Republican",0.648510799750671,-54799,184495,-0.297021599501341
1986,"ARKANSAS",1,105782,58937,164719,"BILL ALEXANDER","RICK H ALBIN","Democrat",0.642196710761964,46845,164719,0.284393421523929
1986,"ARKANSAS",2,128822,41247,170146,"TOMMY F ROBINSON","KEITH HAMAKER","Democrat",0.757126232764802,87575,170069,0.514938054554328
1986,"ARKANSAS",3,36729,145127,181856,"SU SARGENT","JOHN PAUL HAMMERSCHMIDT","Republican",0.798032509238078,-108398,181856,-0.596065018476157
1986,"ARKANSAS",4,115339,22980,148924,"BERYL ANTHONY JR","LAMAR KEELS","Democrat",0.774482286266821,92359,138319,0.667724607609945
1986,"CALIFORNIA",1,138174,54436,204759,"DOUGLAS H BOSCO","FLOYD G SAMPSON","Democrat",0.674812828740129,83738,192610,0.43475416645034
1986,"CALIFORNIA",2,74602,109758,188414,"STEPHEN C ""STEVE"" SWENDIMAN","WALLY HERGER","Republican",0.582536329572112,-35156,184360,-0.190692124105012
1986,"CALIFORNIA",3,158709,50265,208974,"ROBERT T MATSUI","LOWELL LANDOWSKI","Democrat",0.759467684975164,108444,208974,0.518935369950329
1986,"CALIFORNIA",4,128364,54596,182960,"VIC FAZIO","JACK D HITE","Democrat",0.70159597726279,73768,182960,0.403191954525579
1986,"CALIFORNIA",5,122688,36039,163214,"SALA BURTON","MIKE GARZA","Democrat",0.751700221794699,86649,158727,0.545899563401312
1986,"CALIFORNIA",6,142946,50606,193552,"BARBARA BOXER","FRANKLIN ""HARRY"" ERNST III","Democrat",0.738540547243118,92340,193552,0.477081094486236
1986,"CALIFORNIA",7,124174,62379,186553,"GEORGE MILLER","ROSEMARY THAKAR","Democrat",0.665623174111379,61795,186553,0.331246348222757
1986,"CALIFORNIA",8,121790,76850,202935,"RONALD V DELLUMS","STEVEM EIGENBERG","Democrat",0.600142902899943,44940,198640,0.226238421264599
1986,"CALIFORNIA",9,159109,49300,208409,"FORTNEY PETE STARK","DAVID M WILLIAMS","Democrat",0.763445916443148,109809,208409,0.526891832886296
1986,"CALIFORNIA",10,84240,31826,119564,"DON EDWARDS","MICHAEL R LA CRONE","Democrat",0.704559900973537,52414,116066,0.451587889648993
1986,"CALIFORNIA",11,112380,39315,151695,"TOM LANTOS","G M ""BILL"" QURAISHI","Democrat",0.740828636408583,73065,151695,0.481657272817166
1986,"CALIFORNIA",12,69564,111252,187043,"LANCE T WEIL","ERNEST L KONNYU","Republican",0.594793710537149,-41688,180816,-0.230554818157685
1986,"CALIFORNIA",13,107696,46754,154450,"NORMAN Y MINETA","BOB NASH","Democrat",0.697287147944319,60942,154450,0.394574295888637
1986,"CALIFORNIA",14,53597,146906,205161,"BILL STEELE","NORM SHUMWAY","Republican",0.716052271143151,-93309,200503,-0.465374582923946
1986,"CALIFORNIA",15,93600,35793,131775,"TONY COELHO","CAROL HARNER","Democrat",0.710301650540694,57807,129393,0.446755234054392
1986,"CALIFORNIA",16,128151,31386,163498,"LEON E PANETTA","LOUIS DARRIGO","Democrat",0.783807753000037,96765,159537,0.606536414750183
1986,"CALIFORNIA",17,58682,88787,147469,"JOHN HARTNETT","CHARLES ""CHIP"" PASHAYAN","Republican",0.602072299941005,-30105,147469,-0.204144599882009
1986,"CALIFORNIA",18,101480,40907,142387,"RICHARD H LEHMAN","DAVID C CREVELT","Democrat",0.712705513846067,60573,142387,0.425411027692135
1986,"CALIFORNIA",20,49027,129989,179016,"JULES H MOQUIN","WILLIAM M THOMAS","Republican",0.726130625195513,-80962,179016,-0.452261250391026
1986,"CALIFORNIA",21,54497,132090,193091,"GILBERT R SALDANA","ELTON GALLEGLY","Republican",0.684081598831639,-77593,186587,-0.415854266374399
1986,"CALIFORNIA",22,44036,141096,191176,"JOHN G SIMMONS","CARLOS J MOORHEAD","Republican",0.738042432104448,-97060,185132,-0.52427457165698
1986,"CALIFORNIA",23,121468,58746,184754,"ANTHONY C BEILENSON","GEORGE WOOLVERTON","Democrat",0.657458025266029,62722,180214,0.348041772559291
1986,"CALIFORNIA",25,62692,17558,82413,"EDWARD R ROYBAL","GREGORY L HARDY","Democrat",0.76070522854404,45134,80250,0.562417445482866
1986,"CALIFORNIA",26,98091,52662,150753,"HOWARD L BERMAN","ROBERT M KERNS","Democrat",0.650673618435454,45429,150753,0.301347236870908
1986,"CALIFORNIA",27,110403,59410,173320,"MEL LEVINE","ROB SCRIBNER","Democrat",0.636989383798754,50993,169813,0.300289141585155
1986,"CALIFORNIA",28,92635,25858,121330,"JULIAN C DIXON","GEORGE ADAMS","Democrat",0.763496249896975,66777,118493,0.563552277349717
1986,"CALIFORNIA",29,78132,13432,92415,"AUGUSTUS F ""GUS"" HAWKINS","JOH VAN DE BROOKE","Democrat",0.845447167667586,64700,91564,0.706609584552881
1986,"CALIFORNIA",30,59369,33705,94985,"MATTHEW G ""MARTY"" MARTINEZ","JOHN W ALMQUIST","Democrat",0.625035531926094,25664,93074,0.275737585147302
1986,"CALIFORNIA",31,77126,30322,109781,"MERVYN M DYMALLY","JACK MCMURRAY","Democrat",0.702544156092584,46804,107448,0.435596753778572
1986,"CALIFORNIA",32,90739,39003,132541,"GLENN M ANDERSON","JOYCE M ROBERTSON","Democrat",0.684610799677081,51736,129742,0.398760617224954
1986,"CALIFORNIA",33,44312,118541,165353,"MONTY HEMPEL","DAVID DREIER","Republican",0.716896578834373,-74229,162853,-0.455803700269568
1986,"CALIFORNIA",34,66404,43659,110063,"ESTEBAN E TORRES","CHARLES M HOUSE","Democrat",0.603327185339306,22745,110063,0.206654370678611
1986,"CALIFORNIA",35,38322,127235,165557,"R ""SARGE"" HALL","JERRY LEWIS","Republican",0.768526851779146,-88913,165557,-0.537053703558291
1986,"CALIFORNIA",36,78118,58660,136778,"GEORGE E BROWN JR","BOB HANLEY","Democrat",0.571129860065215,19458,136778,0.14225972013043
1986,"CALIFORNIA",37,69808,122416,192224,"DAVID E ""DAVE"" SKINNER","AL MCCANDLESS","Republican",0.636840352921591,-52608,192224,-0.273680705843183
1986,"CALIFORNIA",38,50625,66032,119464,"RICHARD ROBINSON","ROBERT K ""BOB"" DORNAN","Republican",0.55273555213286,-15407,116657,-0.132070943020993
1986,"CALIFORNIA",39,42377,131603,176732,"DAVID D VEST","WILLIAM E ""BILL""DANNEMEYER","Republican",0.744647262521784,-89226,173980,-0.512852051959995
1986,"CALIFORNIA",40,75664,119829,200518,"BRUCE W SUMMER","ROBERT E BADHAM","Republican",0.597597223191933,-44165,195493,-0.22591601745331
1986,"CALIFORNIA",41,59816,133566,196923,"DAN KRIPKE","BILL LOWERY","Republican",0.678265108697308,-73750,193382,-0.381369517328397
1986,"CALIFORNIA",42,47586,140364,192711,"MICHAEL P BLACKBURN","DANIEL E LUNGREN","Republican",0.728365272350826,-92778,187950,-0.493631284916201
1986,"CALIFORNIA",43,45078,137341,187789,"JOSEPH CHIRRA","RON PACKARD","Republican",0.731358066766424,-92263,182419,-0.505775165964072
1986,"CALIFORNIA",44,70557,36359,109836,"JIM BATES","BILL MITCHELL","Democrat",0.642385010379111,34198,106916,0.319858580567922
1986,"CALIFORNIA",45,32800,118900,154675,"HEWITT FITTS RYAN","DUNCAN HUNTER","Republican",0.768708582511718,-86100,151700,-0.567567567567568
1986,"COLORADO",1,106113,49095,155208,"PATRICIA SCHROEDER","JOY WOOD","Democrat",0.683682542137003,57018,155208,0.367365084274006
1986,"COLORADO",2,91223,86032,177255,"DAVID SKAGGS","MICHAEL J ""MIKE"" NORTON","Democrat",0.514642746325915,5191,177255,0.0292854926518293
1986,"COLORADO",3,95353,88508,183861,"BEN NIGHTHOUSE CAMPBELL","MICHAEL L ""MIKE"" STRANG","Democrat",0.518614605598795,6845,183861,0.0372292111975895
1986,"COLORADO",4,50672,117089,167761,"DAVID SPRAGUE","HANK BROWN","Republican",0.69795125207885,-66417,167761,-0.395902504157701
1986,"COLORADO",5,52488,121153,173641,"BILL STORY","JOEL HEFLEY","Republican",0.697721160325038,-68665,173641,-0.395442320650077
1986,"COLORADO",6,53834,104359,160531,"CHUCK NORRIS","DAN SCHAEFER","Republican",0.650086276170958,-50525,158193,-0.319388342088462
1986,"CONNECTICUT",1,128930,44122,173787,"BARBARA BAILEY KENNELLY","HERSCHEL A KLEIN","Democrat",0.741885181285136,84808,173052,0.490072348195918
1986,"CONNECTICUT",2,109229,52869,162098,"SAMUEL GEJDENSON","BUD MULLEN","Democrat",0.673845451516984,56360,162098,0.347690903033967
1986,"CONNECTICUT",3,114276,49806,164087,"BRUCE A MORRISON","ERNEST J DIETTE JR","Democrat",0.696435427547581,64470,164082,0.392913299447837
1986,"CONNECTICUT",4,66999,77212,144211,"CHRISTINE M NIEDERMEIER","STEWART B MCKINNEY","Republican",0.535409920186394,-10213,144211,-0.0708198403727871
1986,"CONNECTICUT",5,63371,98664,162035,"JIM COHEN","JOHN G ROWLAND","Republican",0.60890548338322,-35293,162035,-0.217810966766439
1986,"CONNECTICUT",6,62133,111304,173437,"PAUL S AMENTA","NANCY L JOHNSON","Republican",0.641754642896268,-49171,173437,-0.283509285792536
1986,"DELAWARE",0,106351,53767,160757,"THOMAS R CARPER","THOMAS S NEUBERGER","Democrat",0.661563726618437,52584,160118,0.328407799248055
1986,"FLORIDA",1,97532,55459,152991,"EARL HUTTO","GREG NEUBECK","Democrat",0.637501552378898,42073,152991,0.275003104757796
1986,"FLORIDA",6,143598,61069,204667,"BUDDY MACKAY","LARRY GALLAGHER","Democrat",0.701617749808225,82529,204667,0.40323549961645
1986,"FLORIDA",9,68578,166540,235118,"GABE CAZARES","MICHAEL BILIRAKIS","Republican",0.708325181398277,-97962,235118,-0.416650362796553
1986,"FLORIDA",10,49571,122395,171966,"DAVID B HIGGINBOTTOM","ANDY IRELAND","Republican",0.711739529907075,-72824,171966,-0.423479059814149
1986,"FLORIDA",11,149109,55952,205061,"BILL NELSON","SCOTT ELLIS","Democrat",0.727144605751459,93157,205061,0.454289211502919
1986,"FLORIDA",13,62709,187846,250555,"ADDISON S GILBERT III","CONNIE MACK","Republican",0.749719622438187,-125137,250555,-0.499439244876374
1986,"FLORIDA",14,171976,61189,233165,"DAN MICA","RICK MARTIN","Democrat",0.737572105590462,110787,233165,0.475144211180923
1986,"FLORIDA",16,121219,52809,174028,"LARRY SMITH","MARY COLLINS","Democrat",0.696548831222562,68410,174028,0.393097662445124
1986,"FLORIDA",18,80062,28814,108876,"CLAUDE PEPPER","TOM BRODIE","Democrat",0.735350306771006,51248,108876,0.470700613542011
1986,"FLORIDA",19,99215,44463,143678,"DANTE B FASCELL","BILL FLANAGAN","Democrat",0.690537173401634,54752,143678,0.381074346803268
1986,"GEORGIA",4,75892,86366,162266,"BEN JONES","PAT SWINDALL","Republican",0.532249516226443,-10474,162258,-0.064551516720285
1986,"GEORGIA",5,93229,30562,123800,"JOHN LEWIS","PORTIA A SCOTT","Democrat",0.753061389337641,62667,123791,0.506232278598606
1986,"GEORGIA",6,51352,75583,126941,"CRANDLE BRAY","NEWT GINGRICH","Republican",0.595418343955066,-24231,126935,-0.190892976720369
1986,"GEORGIA",7,88636,44891,133534,"GEORGE ""BUDDY"" DARDEN","JOE MORECRAFT","Democrat",0.663771024607965,43745,133527,0.327611644086964
1986,"GEORGIA",8,82254,12952,95206,"J ROY ROWLAND","EDDIE MCDOWELL","Democrat",0.863958153897864,69302,95206,0.727916307795727
1986,"GEORGIA",10,79548,38714,118267,"DOUG BARNARD JR","JIM HILL","Democrat",0.672613662306476,40834,118262,0.34528419948927
1986,"HAWAII",1,63061,99683,168377,"MUFI HANNEMANN","PATRICIA SAIKI","Republican",0.592022663427903,-36622,162744,-0.225028265250946
1986,"HAWAII",2,123830,35371,162819,"DANIEL K AKAKA","MARIA M HUSTACE","Democrat",0.76053777507539,88459,159201,0.555643494701666
1986,"IDAHO",1,59723,120553,185124,"BILL CURRIE","LARRY E CRAIG","Republican",0.651201356928329,-60830,180276,-0.337427056291464
1986,"IDAHO",2,103035,86528,189563,"RICHARD STALLINGS","MEL RICHARDSON","Democrat",0.543539614798247,16507,189563,0.087079229596493
1986,"ILLINOIS",1,122376,4572,126948,"CHARLES A HAYES","JOSEPH C FAULKNER","Democrat",0.963985253804707,117804,126948,0.927970507609415
1986,"ILLINOIS",2,99268,19149,118417,"GUS SAVAGE","RON TAYLOR","Democrat",0.838291799319354,80119,118417,0.676583598638709
1986,"ILLINOIS",3,102949,52618,155567,"MARTIN A RUSSO","JAMES J TIERNEY","Democrat",0.661766312906979,50331,155567,0.323532625813958
1986,"ILLINOIS",4,57773,61583,119356,"SHAWN COLLINS","JACK DAVIS","Republican",0.515960655517946,-3810,119356,-0.0319213110358926
1986,"ILLINOIS",5,82466,34738,117204,"WILLIAM O LIPINSKI","DANIEL JOHN SOBIESKI","Democrat",0.703610798266271,47728,117204,0.407221596532542
1986,"ILLINOIS",6,32064,98196,130260,"ROBERT H RENSHAW","HENRY J HYDE","Republican",0.753846153846154,-66132,130260,-0.507692307692308
1986,"ILLINOIS",7,90761,21055,113164,"CARDISS COLLINS","CAROLINE K KALLAS","Democrat",0.802030681135343,69706,111816,0.623399155755885
1986,"ILLINOIS",8,82873,22383,105256,"DAN ROSTENKOWSKI","THOMAS J DEFAZIO","Democrat",0.787347039598693,60490,105256,0.574694079197385
1986,"ILLINOIS",9,92738,36715,129453,"SIDNEY R YATES","HERBERT SOHN","Democrat",0.716383552331734,56023,129453,0.432767104663469
1986,"ILLINOIS",10,28990,87530,116520,"ROBERT A CLELAND","JOHN E PORTER","Republican",0.751201510470305,-58540,116520,-0.502403020940611
1986,"ILLINOIS",11,106970,44341,151311,"FRANK ANNUNZIO","GEORGE S GOTTLIEB","Democrat",0.706954550561426,62629,151311,0.413909101122853
1986,"ILLINOIS",12,25536,89044,114580,"JOHN A LEONARDI","PHILIP M CRANE","Republican",0.777133880258335,-63508,114580,-0.55426776051667
1986,"ILLINOIS",13,38874,107227,146101,"DOMINICK J JEFFREY","HARRIS W FAREWELL","Republican",0.733923792444952,-68353,146101,-0.467847584889905
1986,"ILLINOIS",14,70293,77288,147581,"MARY LOU KEARNS","J DENNIS HASTERT","Republican",0.523698850122983,-6995,147581,-0.0473977002459666
1986,"ILLINOIS",16,46087,92982,139069,"KENNETH F BOHNSACK","LYNN MORLEY MARTIN","Republican",0.668603355169017,-46895,139069,-0.337206710338034
1986,"ILLINOIS",17,85442,68101,153543,"LANE EVANS","SAM MCHARD","Democrat",0.556469523195457,17341,153543,0.112939046390913
1986,"ILLINOIS",18,56331,94308,150639,"JIM DAWSON","ROBERT H MICHEL","Republican",0.62605301415968,-37977,150639,-0.25210602831936
1986,"ILLINOIS",19,111105,56186,167291,"TERRY L BRUCE","AL SALVI","Democrat",0.664142123604976,54919,167291,0.328284247209952
1986,"ILLINOIS",20,126556,59291,185847,"RICHARD J DURBIN","KEVIN B MCCARTHY","Democrat",0.680968753867429,67265,185847,0.361937507734857
1986,"ILLINOIS",21,65722,64779,130501,"MELVIN PRICE","ROBERT H ""BOB"" GAFFNER","Democrat",0.503612999134106,943,130501,0.0072259982682125
1986,"ILLINOIS",22,97585,85733,183318,"KENNETH J GRAY","RANDY PATCHETT","Democrat",0.532326340021165,11852,183318,0.0646526800423308
1986,"INDIANA",1,86983,30395,118441,"PETER J VISCLOSKY","WILLIAM COSTAS","Democrat",0.734399405611233,56588,117378,0.482100563989845
1986,"INDIANA",2,102456,62013,165625,"PHILIP R SHARP","DONALD J LYNCH","Democrat",0.618602264150943,40443,164469,0.245900443244624
1986,"INDIANA",3,75932,75979,152509,"THOMAS W WARD","JOHN HILER","Republican",0.49819354923316,-47,151911,-0.000309391683288241
1986,"INDIANA",4,43105,99865,143572,"GREGORY ALAN SCHER","DAN COATS","Republican",0.695574345972752,-56760,142970,-0.397006364971672
1986,"INDIANA",5,80772,75507,157006,"JAMES JONTZ","JAMES R BUTCHER","Democrat",0.514451677005974,5265,156279,0.0336897471829228
1986,"INDIANA",6,53431,118363,173165,"THOMAS F MCKENNA","DAN BURTON","Republican",0.683527271677302,-64932,171794,-0.377964306087523
1986,"INDIANA",7,49675,104965,157163,"L EUGENE SMITH","JOHN T MYERS","Republican",0.667873481671895,-55290,154640,-0.357540093119503
1986,"INDIANA",8,106662,93586,201157,"FRANK MCCLOSKEY","RICHARD D MCINTYRE","Democrat",0.530242546866378,13076,200248,0.0652990292037873
1986,"INDIANA",9,120586,46398,167703,"LEE H HAMILTON","ROBERT WALTER KILROY","Democrat",0.719044978324777,74188,166984,0.44428208690653
1986,"INDIANA",10,68817,49064,119166,"ANDREW JACOBS JR","JIM EYNON","Democrat",0.577488545390464,19753,117881,0.167567292438985
1986,"IOWA",1,43985,86834,130825,"JOHN R WHITAKER","JIM LEACH","Republican",0.663741639594879,-42849,130819,-0.327544164074026
1986,"IOWA",2,55903,88708,144630,"ERIC TABOR","TOM TAUKE","Republican",0.613344396045081,-32805,144611,-0.226849963004197
1986,"IOWA",3,83504,69386,152920,"DAVID R NAGLE","JOHN MCINTEE","Democrat",0.546063301072456,14118,152890,0.0923408986853293
1986,"IOWA",4,107271,49641,156952,"NEAL SMITH","BOB LOCKARD","Democrat",0.683463734135277,57630,156912,0.367275925359437
1986,"IOWA",5,58552,85025,143589,"SCOTT HUGHES","JIM ROSS LIGHTFOOT","Republican",0.592141459303986,-26473,143577,-0.184381899607876
1986,"IOWA",6,78807,81861,160679,"CLAYTON HODGSON","FRED GRANDY","Republican",0.509469190124409,-3054,160668,-0.0190081410112779
1986,"KANSAS",1,43359,141297,184656,"DALE LYON","PAT ROBERTS","Republican",0.765190408110216,-97938,184656,-0.530380816220432
1986,"KANSAS",2,110737,46029,156766,"JIM SLATTERY","PHILL KLINE","Democrat",0.706384037355039,64708,156766,0.412768074710077
1986,"KANSAS",4,111164,61178,172342,"DAN GLICKMAN","BOB KNIGHT","Democrat",0.64501978623899,49986,172342,0.29003957247798
1986,"KANSAS",5,47540,116800,164340,"KIM E MYERS","BOB WHITTAKER","Republican",0.710721674577096,-69260,164340,-0.421443349154193
1986,"KENTUCKY",3,81943,29348,112233,"ROMANO L MAZZOLI","LEE HOLMES","Democrat",0.730115028556663,52595,111291,0.472589876989155
1986,"KENTUCKY",4,53906,67626,122763,"TERRY L MANN","JIM BUNNING","Republican",0.55086630336502,-13720,121532,-0.112892077806668
1986,"KENTUCKY",6,26315,75906,102224,"JERRY W HAMMONS","LARRY J HOPKINS","Republican",0.74254578181249,-49591,102221,-0.485135148355035
1986,"KENTUCKY",7,90619,23209,113828,"CARL C PERKINS","JAMES T ""JIM"" POLLEY","Democrat",0.796104649119724,67410,113828,0.592209298239449
1986,"LOUISIANA",8,96864,102276,199140,"FAYE WILLIAMS","CLYDE C HOLLOWAY","Republican",0.513588430250075,-5412,199140,-0.0271768605001506
1986,"MAINE",1,121848,100260,229233,"JOSEPH E BRENNAN","H ROLLIN IVES","Democrat",0.531546505084347,21588,222108,0.0971959587227835
1986,"MAINE",2,43614,148770,192397,"RICHARD R CHARETTE","OLYMPIA J SNOWE","Republican",0.773244905066087,-105156,192384,-0.546594311377245
1986,"MARYLAND",1,88113,43764,131877,"ROY DYSON","HARLAN C WILLIAMS","Democrat",0.668145317227416,44349,131877,0.336290634454833
1986,"MARYLAND",2,68200,96745,164946,"KATHLEEN KENNEDY TOWNSEND","HELEN DELICH BENTLEY","Republican",0.586525287063645,-28545,164945,-0.173057685895298
1986,"MARYLAND",3,100161,26452,126613,"BENJAMIN L CARDIN","ROSS Z PIERPONT","Democrat",0.791079904907079,73709,126613,0.582159809814158
1986,"MARYLAND",4,65071,64643,129714,"THOMAS MCMILLEN","ROBERT R NEALL","Democrat",0.501649783369567,428,129714,0.00329956673913379
1986,"MARYLAND",5,82098,18102,100200,"STENY H HOYER","JOHN EUGENE SELLNER","Democrat",0.819341317365269,63996,100200,0.638682634730539
1986,"MARYLAND",6,102975,39600,142575,"BEVERLY B BYRON","JOHN VANDENBERGE","Democrat",0.722251446607049,63375,142575,0.444502893214098
1986,"MARYLAND",7,79226,12170,91398,"KWEISI MFUME","SAINT GEORGE IB CROSSE III","Democrat",0.866824219348345,67056,91396,0.733686375771369
1986,"MARYLAND",8,82825,92917,175742,"STEWART BAINUM JR","CONSTANCE A MORELLA","Republican",0.528712544525498,-10092,175742,-0.0574250890509952
1986,"MASSACHUSETTS",1,32396,113653,151960,"ROBERT S WEINER","SILVIO O CONTE","Republican",0.747913924717031,-81257,146049,-0.556368068251066
1986,"MASSACHUSETTS",2,91033,47022,147005,"EDWARD P BOLAND","BRIAN P LEES","Democrat",0.619251045882793,44011,138055,0.318793234580421
1986,"MASSACHUSETTS",8,104651,40259,154984,"JOSEPH P KENNEDY II","CLARK C ABT","Democrat",0.675237443865173,64392,144910,0.444358567386654
1986,"MASSACHUSETTS",10,121578,49451,194076,"GERRY E STUDDS","RICARDO M BARROS","Democrat",0.626445310084709,72127,171029,0.421723801226693
1986,"MICHIGAN",1,94307,10407,105784,"JOHN CONYERS JR","BILL ASHE","Democrat",0.891505331619148,83900,104714,0.801230016998682
1986,"MICHIGAN",2,55204,79567,134778,"DEAN BAKER","CARL D PURSELL","Republican",0.590355992817819,-24363,134771,-0.180773311765884
1986,"MICHIGAN",3,78720,51678,130400,"HOWARD WOLPE","JACKIE MCGREGOR","Democrat",0.603680981595092,27042,130398,0.207380481295725
1986,"MICHIGAN",4,41624,70331,113633,"DAN ROCHE","FRED UPTON","Republican",0.618931120361163,-28707,111955,-0.256415524094502
1986,"MICHIGAN",5,40608,100577,141186,"TERESA S DECKER","PAUL B HENRY","Republican",0.712372331534288,-59969,141185,-0.424754754400255
1986,"MICHIGAN",6,74927,57283,132217,"BOB CARR","JIM DUNN","Democrat",0.566697172073183,17644,132210,0.133454352923379
1986,"MICHIGAN",7,101225,24848,127172,"DALE E KILDEE","TRUDIE CALLIHAN","Democrat",0.795969238511622,76377,126073,0.605815678218175
1986,"MICHIGAN",8,97406,36695,134101,"BOB TRAXLER","JOHN A LEVI","Democrat",0.726362965227701,60711,134101,0.452725930455403
1986,"MICHIGAN",9,49702,89991,139693,"RICHARD J ANDERSON","GUY VANDER JAGT","Republican",0.644205507792087,-40289,139693,-0.288411015584174
1986,"MICHIGAN",10,74941,78475,153424,"DON ALBOSTA","BILL SCHUETTE","Republican",0.511491031390135,-3534,153416,-0.0230354069979663
1986,"MICHIGAN",11,53180,91575,145404,"ROBERT C ANDERSON","BOB DAVIS","Republican",0.629796979450359,-38395,144755,-0.265241269731615
1986,"MICHIGAN",12,87643,44442,132089,"DAVID E BONIOR","CANDICE S MILLER","Democrat",0.663514751417605,43201,132085,0.327069689972366
1986,"MICHIGAN",13,76435,12395,89746,"GEO W CROCKETT JR","MARY GRIFFIN","Democrat",0.851681411984935,64040,88830,0.720927614544636
1986,"MICHIGAN",14,92328,33831,126667,"DENNIS M HERTEL","STANLEY T GROT","Democrat",0.728903344991197,58497,126159,0.463676788814116
1986,"MICHIGAN",15,77950,25078,103612,"WILLIAM D FORD","GLEN KASSEL","Democrat",0.752325985407096,52872,103028,0.513180882866794
1986,"MICHIGAN",16,101659,28971,130636,"JOHN D DINGELL","FRANK W GRZYWACKI","Democrat",0.778185186319238,72688,130630,0.556441858684835
1986,"MICHIGAN",17,105031,30879,137390,"SANDER LEVIN","CALVIN WILLIAMS","Democrat",0.764473396899338,74152,135910,0.545596350526083
1986,"MICHIGAN",18,39144,110099,149244,"GARY L KOHUT","WILLIAM S BROOMFIELD","Republican",0.737711398783201,-70955,149243,-0.475432683609952
1986,"MINNESOTA",1,125115,47750,172877,"TIMOTHY J ""TIM"" PENNY","PAUL H GRAWE","Democrat",0.723722646737276,77365,172865,0.447545772712811
1986,"MINNESOTA",2,94048,100249,194315,"DAVE JOHNSON","VIN WEBER","Republican",0.515909734194478,-6201,194297,-0.0319150578753146
1986,"MINNESOTA",3,54261,127434,181729,"RAY STOCK","BILL FRENZEL","Republican",0.701230953782831,-73173,181695,-0.402724345744242
1986,"MINNESOTA",4,112662,41926,154635,"BRUCE F VENTO","HAROLD STASSEN","Democrat",0.728567271316326,70736,154588,0.457577561000854
1986,"MINNESOTA",5,105410,37583,144997,"MARTIN OLAV SABO","RICK SERRA","Democrat",0.726980558218446,67827,142993,0.474337904652675
1986,"MINNESOTA",6,110598,57460,168077,"GERRY SIKORSKI","BARBARA ZWACH SYKORA","Democrat",0.658019836146528,53138,168058,0.316188458746385
1986,"MINNESOTA",7,93903,94024,189264,"COLLIN C PETERSON","ARLAN STANGELAND","Republican",0.496787556006425,-121,187927,-0.000643867033475764
1986,"MINNESOTA",8,135718,51315,187045,"JAMES L OBERSTAR","DAVE RUED","Democrat",0.725590098639365,84403,187033,0.451273304710933
1986,"MISSISSIPPI",1,59870,30267,90137,"JAMIE L WHITTEN","LARRY COBB","Democrat",0.664211145256665,29603,90137,0.32842229051333
1986,"MISSISSIPPI",2,73119,68292,141411,"MIKE ESPY","WEBB FRANKLIN","Democrat",0.517067271994399,4827,141411,0.0341345439887986
1986,"MISSISSIPPI",4,85819,34190,120009,"WAYNE DOWDY","GAIL HEALY","Democrat",0.715104700480797,51629,120009,0.430209400961595
1986,"MISSISSIPPI",5,16143,75288,91431,"LARRY L ALBRITTON","TRENT LOTT","Republican",0.823440627358336,-59145,91431,-0.646881254716672
1986,"MISSOURI",1,91044,46599,137643,"WILLIAM ""BILL"" CLAY","ROBERT J WITTMANN","Democrat",0.661450273533707,44445,137643,0.322900547067414
1986,"MISSOURI",2,93538,101010,194548,"ROBERT A YOUNG","JACK BUECHNER","Republican",0.519203487057179,-7472,194548,-0.0384069741143574
1986,"MISSOURI",3,116403,52382,168785,"RICHARD A GEPHARDT","ROY AMELUNG","Democrat",0.689652516515093,64021,168785,0.379305033030186
1986,"MISSOURI",5,101030,39340,142574,"ALAN WHEAT","GREG FISHER","Democrat",0.708614473887245,61690,140370,0.439481370663247
1986,"MISSOURI",6,73155,95865,169020,"DOUG R HUGHES","TOM COLEMAN","Republican",0.567181398651047,-22710,169020,-0.134362797302094
1986,"MISSOURI",7,56291,114210,170501,"KEN YOUNG","GENE TAYLOR","Republican",0.669849443698277,-57919,170501,-0.339698887396555
1986,"MISSOURI",8,71532,79142,150674,"WAYNE CRYTS","BILL EMERSON","Republican",0.52525319564092,-7610,150674,-0.0505063912818403
1986,"MISSOURI",9,95939,70972,166911,"HAROLD L VOLKMER","RALPH UTHLAUT","Democrat",0.574791355872291,24967,166911,0.149582711744582
1986,"MONTANA",1,98501,61230,159731,"PAT WILLIAMS","DON ALLEN","Democrat",0.61666802311386,37271,159731,0.23333604622772
1986,"MONTANA",2,73583,84548,158131,"BUCK O'BRIEN","RON MARLENEE","Republican",0.53467062119382,-10965,158131,-0.0693412423876406
1986,"NEBRASKA",1,67137,121772,188986,"STEVE BURNS","DOUG BEREUTER","Republican",0.644344025483369,-54635,188909,-0.289213324934228
1986,"NEBRASKA",2,70372,99569,170267,"WALTER M CALINGER","HAL DAUB","Republican",0.584781548978957,-29197,169941,-0.171806685849795
1986,"NEBRASKA",3,59182,136985,196184,"SCOTT E SIDWELL","VIRGINIA SMITH","Republican",0.698247563511805,-77803,196167,-0.396616148485729
1986,"NEVADA",1,61830,50342,114317,"JAMES H BILBRAY","BOB RYAN","Democrat",0.540864438359999,11488,112172,0.102414149698677
1986,"NEVADA",2,59433,83479,142912,"PETE SFERRAZZA","BARBARA F VUCANOVICH","Republican",0.584128694581281,-24046,142912,-0.168257389162562
1986,"NEW HAMPSHIRE",1,54787,70739,125547,"JAMES M DEMERS","ROBERT C SMITH","Republican",0.563446358734179,-15952,125526,-0.127081242133104
1986,"NEW HAMPSHIRE",2,29688,85479,115200,"LAWRENCE CRAIG-GREEN","JUDD GREGG","Republican",0.742005208333333,-55791,115167,-0.484435645627654
1986,"NEW JERSEY",1,93497,29173,123601,"JAMES J FLORIO","FRED A BUSCH","Democrat",0.75644209998301,64324,122670,0.524366185701476
1986,"NEW JERSEY",2,83821,35167,122800,"WILLIAM J HUGHES","ALFRED J BENNINGTON JR","Democrat",0.682581433224756,48654,118988,0.408898376306854
1986,"NEW JERSEY",3,73743,51882,125625,"JAMES J HOWARD","BRIAN T KENNEDY","Democrat",0.587008955223881,21861,125625,0.174017910447761
1986,"NEW JERSEY",4,49290,78699,128778,"JEFFREY LAURENTI","CHRISTOPHER H SMITH","Republican",0.61112146484648,-29409,127989,-0.229777559008977
1986,"NEW JERSEY",5,40449,85949,126398,"H VERNON JOLLEY","MARGE ROUKEMA","Republican",0.679987025111157,-45500,126398,-0.359974050222314
1986,"NEW JERSEY",6,67460,28286,97769,"BERNARD J DWYER","JOHN D SCALAMONTI","Democrat",0.689993760803527,39174,95746,0.409145029557371
1986,"NEW JERSEY",7,24462,92254,116716,"JUNE S FISCHER","MATTHEW J RINALDO","Republican",0.790414339079475,-67792,116716,-0.58082867815895
1986,"NEW JERSEY",8,57820,34269,92089,"ROBERT A ROE","THOMAS P ZAMPINO","Democrat",0.627870864055425,23551,92089,0.255741728110849
1986,"NEW JERSEY",9,89634,40226,129860,"ROBERT G TORRICELLI","ARTHUR F JONES","Democrat",0.690235638379794,49408,129860,0.380471276759587
1986,"NEW JERSEY",11,35280,75037,110317,"FRANK ASKIN","DEAN A GALLO","Republican",0.680194349012392,-39757,110317,-0.360388698024783
1986,"NEW JERSEY",12,41967,72966,114933,"DAVID B CRABIEL","JIM COURTER","Republican",0.634856829631176,-30999,114933,-0.269713659262353
1986,"NEW JERSEY",13,43920,82866,126786,"JOHN WYDRA","H JAMES SAXTON","Republican",0.653589513037717,-38946,126786,-0.307179026075434
1986,"NEW JERSEY",14,63057,23822,89229,"FRANK J GUARINI","ALBIO SIRES","Democrat",0.706687287765188,39235,86879,0.451605105951956
1986,"NEW MEXICO",1,37138,90476,127632,"MANNY GARCIA","MANUEL LUJAN JR","Republican",0.708881785132255,-53338,127614,-0.417963546319369
1986,"NEW MEXICO",2,45924,77787,123711,"MIKE RUNNELS","JOE SKEEN","Republican",0.628779979144943,-31863,123711,-0.257559958289885
1986,"NEW MEXICO",3,95760,38552,134312,"BILL RICHARDSON","DAVID F CARGO","Democrat",0.712966823515397,57208,134312,0.425933647030794
1986,"NEW YORK",1,64217,53502,131031,"GEORGE J HOCHBRUECKNER","GREGORY J BLASS","Democrat",0.490090131342965,10715,117719,0.0910218401447515
1986,"NEW YORK",2,66443,29937,108554,"THOMAS J DOWNEY","JEFFREY A BUTZKE","Democrat",0.612073253864436,36506,96380,0.378771529362938
1986,"NEW YORK",3,83985,51664,148792,"ROBERT J MRAZEK","JOSEPH A GUARINO","Democrat",0.564445669121996,32321,135649,0.238269356943287
1986,"NEW YORK",4,41117,80578,142288,"PATRICIA SULLIVAN","NORMAN F LENT","Republican",0.566302147756663,-39461,121695,-0.32426147335552
1986,"NEW YORK",5,41456,83511,143201,"MICHAEL T SULLIVAN","RAYMOND J MCGRATH","Republican",0.583173301862417,-42055,124967,-0.336528843614714
1986,"NEW YORK",6,58317,22980,86090,"FLOYD H FLAKE","RICHARD DIETL","Democrat",0.677395748635149,35337,81297,0.434665485811285
1986,"NEW YORK",7,62836,14459,81220,"GARY L ACKERMAN","EDWARD NELSON RODRIGUEZ","Democrat",0.77365180989904,48377,77295,0.62587489488324
1986,"NEW YORK",9,50738,18040,73126,"THOMAS J MANTON","SALVATORE J CALISE","Democrat",0.693843502994831,32698,68778,0.475413649713571
1986,"NEW YORK",11,36199,4053,46616,"EDOLPHUS TOWNS","NATHANIEL HENDRICKS","Democrat",0.776535953320748,32146,40252,0.798618702176289
1986,"NEW YORK",12,37695,2752,46058,"MAJOR R OWENS","OWEN AUGUSTIN","Democrat",0.818424595075774,34943,40447,0.863920686330259
1986,"NEW YORK",13,57704,10941,74136,"STEPHEN J SOLARZ","LEON NADROWSKI","Democrat",0.778353296644006,46763,68645,0.681229514167092
1986,"NEW YORK",14,27950,53861,93972,"BARBARA WALLA","GUY V MOLINARI","Republican",0.573160090239646,-25911,81811,-0.316717800784736
1986,"NEW YORK",15,38436,54949,100361,"GEORGE A HIRSCH","BILL GREEN","Republican",0.547513476350375,-16513,93385,-0.176827113562135
1986,"NEW YORK",16,52521,4962,63545,"CHARLES B RANGEL","CHARLES B RANGEL","Democrat",0.826516641749941,47559,57483,0.827357653567142
1986,"NEW YORK",17,86653,13725,111262,"TED WEISS","THOMAS A CHORBA","Democrat",0.778819363304632,72928,100378,0.726533702604156
1986,"NEW YORK",18,39833,2479,46353,"ROBERT GARCIA","MELANIE CHASE","Democrat",0.859340280025025,37354,42312,0.882822839856305
1986,"NEW YORK",19,54274,29909,97349,"MARIO BIAGGI","MARIO BIAGGI","Democrat",0.557519851256818,24365,84183,0.289428982098523
1986,"NEW YORK",20,66359,69495,148920,"BELLA S ABZUG","JOSEPH J DIOGUARDI","Republican",0.466659951651894,-3136,135854,-0.0230836044577267
1986,"NEW YORK",21,28339,89334,133397,"LAWRENCE W GRUNBERGER","HAMILTON FISH JR","Republican",0.669685225304917,-60995,117673,-0.518343205323226
1986,"NEW YORK",22,36852,94244,135656,"ELEANOR F BURLINGHAM","BENJAMIN A GILMAN","Republican",0.694727841009613,-57392,131096,-0.437786049917618
1986,"NEW YORK",24,49225,103867,166510,"ED BLOCH","GERALD B SOLOMON","Republican",0.623788361059396,-54642,153092,-0.356922634755572
1986,"NEW YORK",25,33864,104216,151079,"KEVIN J CONWAY","SHERWOOD L BOEHLERT","Republican",0.689811290781644,-70352,138080,-0.509501738122827
1986,"NEW YORK",27,81133,77175,168026,"ROSEMARY S POOLER","GEORGE C WORTLEY","Democrat",0.482859795507838,3958,158308,0.0250018950400485
1986,"NEW YORK",28,103908,41430,152121,"MATT MCHUGH","MARK R MASTERSON","Democrat",0.683061510245134,62478,145338,0.429880691904388
1986,"NEW YORK",29,34194,99704,141008,"JAMES R VOGEL","FRANK HORTON","Republican",0.707080449336208,-65510,133898,-0.489253013487879
1986,"NEW YORK",30,86777,74635,170179,"LOUISSE M SLAUGHTER","FRED J ECKERT","Democrat",0.50991602959237,12142,161412,0.0752236512774763
1986,"NEW YORK",31,66956,80904,160995,"JAMES P KEANE","JACK F KEMP","Republican",0.502524923134259,-13948,147860,-0.0943324766671175
1986,"NEW YORK",33,104028,16533,128403,"HENRY J NOWAK","CHARLES A WALKER","Democrat",0.810167986729282,87495,120561,0.725732201955856
1986,"NEW YORK",34,56898,80100,142754,"LARRY M HIMELEIN","AMORY HOUGHTON JR","Republican",0.56110511789512,-23202,136998,-0.169360136644331
1986,"NORTH CAROLINA",1,91122,39912,131034,"WALTER B JONES","HOWARD MOYE","Democrat",0.695407298868996,51210,131034,0.390814597737992
1986,"NORTH CAROLINA",2,95320,32515,127835,"I T ""TIM"" VALENTINE JR","BUD MCELHANEY","Democrat",0.745648687761568,62805,127835,0.491297375523135
1986,"NORTH CAROLINA",3,71460,39408,110868,"MARTIN LANCASTER","GERALD B HURST","Democrat",0.644550276003896,32052,110868,0.289100552007793
1986,"NORTH CAROLINA",4,92216,73469,165685,"DAVID E PRICE","WILLIAM W ""BILL"" COBEY JR","Democrat",0.556574222168573,18747,165685,0.113148444337146
1986,"NORTH CAROLINA",5,86410,73261,159671,"STEPHEN L ""STEVE"" NEAL","STUART ""STU"" EPPERSON","Democrat",0.541175291693545,13149,159671,0.0823505833870897
1986,"NORTH CAROLINA",6,72250,72329,144579,"ROBIN BRITT","HOWARD COBLE","Republican",0.5002732070356,-79,144579,-0.000546414071199828
1986,"NORTH CAROLINA",7,70471,39289,109760,"CHARLES G ROSE III","THOMAS J HARRELSON","Democrat",0.642046282798834,31182,109760,0.284092565597668
1986,"NORTH CAROLINA",8,80959,58941,139900,"W G ""BILL"" HEFNER","WILLIAM G HAMBY JR","Democrat",0.578691922802001,22018,139900,0.157383845604003
1986,"NORTH CAROLINA",9,76240,80352,156592,"D G MARTIN","J ALEX MCMILLAN","Republican",0.51312966179626,-4112,156592,-0.0262593235925207
1986,"NORTH CAROLINA",10,62035,83902,145937,"LESTER D ""LES"" ROARK","CASS BALLENGER","Republican",0.574919314498722,-21867,145937,-0.149838628997444
1986,"NORTH CAROLINA",11,91575,89069,180644,"JAMES MCCLURE CLARKE","WILLIAM M HENDON","Democrat",0.506936294590465,2506,180644,0.0138725891809304
1986,"NORTH DAKOTA",0,216258,66989,286361,"BYRON L DORGAN","SYVER VINJE","Democrat",0.755193619242844,149269,283247,0.526992342372558
1986,"OHIO",1,90477,56100,146577,"THOMAS A LUKEN","FRED E MORR","Democrat",0.617266010356331,34377,146577,0.234532020712663
1986,"OHIO",2,43448,105061,148509,"WILLIAM F STINEMAN","WILLIS D GRADISON JR","Republican",0.707438606414426,-61613,148509,-0.414877212828852
1986,"OHIO",3,98311,35167,133478,"TONY P HALL","RON CRUTCHER","Democrat",0.736533361302986,63144,133478,0.473066722605973
1986,"OHIO",4,26320,115751,154068,"CLEM T CRATTY","MICHAEL G OXLEY","Republican",0.751298128099281,-89431,142071,-0.629481034130822
1986,"OHIO",5,54864,102016,156880,"TOM MURRAY","DELBERT L LATTA","Republican",0.650280469148394,-47152,156880,-0.300560938296787
1986,"OHIO",6,42155,106354,151338,"GORDON R ROBERTS","BOB MCEWEN","Republican",0.702758064729281,-64199,148509,-0.432290298904443
1986,"OHIO",8,46195,98475,144670,"JOHN W GRIFFIN","DONALD E LUKENS","Republican",0.680687080942835,-52280,144670,-0.361374161885671
1986,"OHIO",9,105646,30643,136289,"MARCY KAPTUR","MIKE SHUFELDT","Democrat",0.775161605118535,75003,136289,0.55032321023707
1986,"OHIO",10,44847,106870,151717,"JOHN M BUCHANAN","CLARENCE E MILLER","Republican",0.704403593532696,-62023,151717,-0.408807187065391
1986,"OHIO",11,104740,35944,144568,"DENNIS E ECKART","MARGARET R MUELLER","Democrat",0.724503347905484,68796,140684,0.489010832788377
1986,"OHIO",12,42727,117905,160632,"TIMOTHY C JOCHIM","JOHN R KASICH","Republican",0.734006922655511,-75178,160632,-0.468013845311021
1986,"OHIO",13,88612,52452,141064,"DONALD J PEASE","WILLIAM D NIELSEN JR","Democrat",0.628168774456984,36160,141064,0.256337548913968
1986,"OHIO",14,83257,71713,154970,"THOMAS C SAWYER","LYNN SLABY","Democrat",0.537245918564884,11544,154970,0.074491837129767
1986,"OHIO",15,55750,97745,153495,"DAVID L JACKSON","CHALMERS P WYLIE","Republican",0.636795986839962,-41995,153495,-0.273591973679924
1986,"OHIO",16,36639,118206,154845,"WILLIAM J KENNICK","RALPH REGULA","Republican",0.763382737576286,-81567,154845,-0.526765475152572
1986,"OHIO",17,112855,43334,156189,"JAMES A TRAFICANT JR","JAMES H FULKS","Democrat",0.722554085114829,69521,156189,0.445108170229658
1986,"OHIO",19,97814,80743,178557,"EDWARD F FEIGHAN","GARY C SUHADOLNIK","Democrat",0.547802662455126,17071,178557,0.0956053249102528
1986,"OHIO",20,110976,19794,130770,"MARY ROSE OAKAR","BILL SMITH","Democrat",0.848635008029365,91182,130770,0.697270016058729
1986,"OHIO",21,99878,22594,122472,"LOUIS STOKES","FRANKLINE H ROSKI","Democrat",0.8155170161343,77284,122472,0.6310340322686
1986,"OKLAHOMA",1,61663,78919,144037,"GARY D ALLISON","JAMES M INHOFE","Republican",0.547907829238321,-17256,140582,-0.122746866597431
1986,"OKLAHOMA",2,114543,41795,156338,"MIKE SYNAR","GARY K RICE","Democrat",0.732662564443705,72748,156338,0.465325128887411
1986,"OKLAHOMA",3,114008,31913,145921,"WES WATKINS","PATRICK K MILLER","Democrat",0.781299470261306,82095,145921,0.562598940522612
1986,"OKLAHOMA",4,94984,29697,124681,"DAVE MCCURDY","LARRY HUMPHREYS","Democrat",0.761816154827119,65287,124681,0.523632309654238
1986,"OKLAHOMA",5,45256,108774,154030,"DONNA COMPTON","MCKEY EDWARDS","Republican",0.706187106407843,-63518,154030,-0.412374212815685
1986,"OREGON",1,141585,87874,229495,"LES AUCOIN","ANTHONY ""TONY"" MEEKER","Democrat",0.616941545567442,53711,229459,0.234076676007478
1986,"OREGON",2,75124,113566,188716,"LARRY TUTTLE","ROBERT F ""BOB"" SMITH","Republican",0.601782572754827,-38442,188690,-0.203730987333722
1986,"OREGON",3,180067,29321,209581,"RON WYDEN","THOMAS H PHELAN","Democrat",0.859176165778386,150746,209388,0.7199361950064
1986,"OREGON",4,105697,89795,195548,"PETER A DEFAZIO","BRUCE LONG","Democrat",0.540516906335017,15902,195492,0.0813434820862235
1986,"OREGON",5,82290,125906,208204,"BARBARA ROSS","DENNY SMITH","Republican",0.604724212791301,-43616,208196,-0.209494899037445
1986,"PENNSYLVANIA",1,88224,29811,118035,"THOMAS M FOGLIETTA","ANTHONY J MUCCIOLO","Democrat",0.747439318846105,58413,118035,0.49487863769221
1986,"PENNSYLVANIA",3,107804,66693,174497,"ROBERT A BORSKI","ROBERT A ROVNER","Democrat",0.617798586795189,41111,174497,0.235597173590377
1986,"PENNSYLVANIA",4,86133,55165,142594,"JOSEPH P KOLTER","AL LINDSAY","Democrat",0.604043648400353,30968,141298,0.219167999547057
1986,"PENNSYLVANIA",5,45648,87593,133241,"TIM RINGGOLD","RICHARD T SCHULZE","Republican",0.657402751405348,-41945,133241,-0.314805502810696
1986,"PENNSYLVANIA",6,98142,43858,142000,"GUS YATRON","NORM BERTASAVAGE","Democrat",0.691140845070423,54284,142000,0.382281690140845
1986,"PENNSYLVANIA",7,69557,110118,179675,"BILL SPINGLER","CURT WELDON","Republican",0.61287324335606,-40561,179675,-0.225746486712119
1986,"PENNSYLVANIA",8,85731,70047,155778,"PETER H KOSTMAYER","DAVID A CHRISTIAN","Democrat",0.550340869699187,15684,155778,0.100681739398375
1986,"PENNSYLVANIA",10,40248,118603,158851,"ROBERT C BOLUS","JOSEPH MICHAEL MCDADE","Republican",0.746630490207805,-78355,158851,-0.49326098041561
1986,"PENNSYLVANIA",11,112405,46785,159190,"PAUL E KANJORSKI","MARC HOLTZMAN","Democrat",0.706105911175325,65620,159190,0.41221182235065
1986,"PENNSYLVANIA",12,97135,46937,144072,"JOHN P MURTHA","KATHY HOLTZMAN","Democrat",0.674211505358432,50198,144072,0.348423010716864
1986,"PENNSYLVANIA",13,71381,100701,172082,"JOSEPH M HOEFFEL","LAWRENCE COUGHLIN","Republican",0.585191943375832,-29320,172082,-0.170383886751665
1986,"PENNSYLVANIA",15,56972,74829,131801,"JOE SIMONETTA","DON RITTER","Republican",0.567742278131425,-17857,131801,-0.135484556262851
1986,"PENNSYLVANIA",16,34399,100784,135183,"JAMES D HAGELGANS","ROBERT S WALKER","Republican",0.745537530606659,-66385,135183,-0.491075061213318
1986,"PENNSYLVANIA",17,36157,101027,137184,"MICHAEL S OGDEN","GEORGE W GEKAS","Republican",0.736434278049918,-64870,137184,-0.472868556099837
1986,"PENNSYLVANIA",18,104164,61164,165328,"DOUG WALGREN","ERNIE BUCKMAN","Democrat",0.630044517565083,43000,165328,0.260089035130166
1986,"PENNSYLVANIA",19,37223,100055,137278,"RICHARD F THORNTON","BILL GOODLING","Republican",0.728849487900465,-62832,137278,-0.457698975800929
1986,"PENNSYLVANIA",21,26324,111148,137472,"JOYLYN BLACKWELL","TOM RIDGE","Republican",0.808513733705773,-84824,137472,-0.617027467411546
1986,"PENNSYLVANIA",23,63875,79595,143470,"BILL WACHOB","BILL CLINGER","Republican",0.554784972468112,-15720,143470,-0.109569944936224
1986,"RHODE ISLAND",1,85077,62397,147474,"FERNAND J ST GERMAIN","JOHN A HOLMES JR","Democrat",0.576894910289271,22680,147474,0.153789820578543
1986,"RHODE ISLAND",2,44586,113603,158189,"DONALD J FERRY","CLAUDINE SCHNEIDER","Republican",0.718147279520068,-69017,158189,-0.436294559040136
1986,"SOUTH CAROLINA",1,55262,59969,115232,"JIMMY STUCKEY","ARTHUR RAVENEL JR","Republican",0.520419675090253,-4707,115231,-0.0408483828136526
1986,"SOUTH CAROLINA",2,63592,73455,137052,"FRED ZEIGLER","FLOYD D SPENCE","Republican",0.535964451449085,-9863,137047,-0.0719680109743373
1986,"SOUTH CAROLINA",3,79109,36495,115683,"BUTLER DERRICK","RICHARD DICKISON","Democrat",0.683842915553711,42614,115604,0.368620462959759
1986,"SOUTH CAROLINA",4,67012,61648,130407,"LIZ J PATTERSON","BILL WORKMAN","Democrat",0.513868120576349,5364,128660,0.0416912793408985
1986,"SOUTH CAROLINA",6,92398,29922,122343,"ROBIN TALLON","ROBBIE CUNNINGHAM","Democrat",0.755237324571083,62476,122320,0.510758665794637
1986,"SOUTH DAKOTA",0,171462,118261,289723,"TIM JOHNSON","DALE BELL","Democrat",0.591813559848545,53201,289723,0.18362711969709
1986,"TENNESSEE",1,36278,80289,116570,"JOHN B RUSSELL","JAMES H ""JIMMY"" QUILLEN","Republican",0.688762117182809,-44011,116567,-0.377559686703784
1986,"TENNESSEE",2,30088,96396,126486,"JOHN F BOWEN","JOHN J DUNCAN","Republican",0.762108059389972,-66308,126484,-0.524240220106891
1986,"TENNESSEE",3,75034,64084,139120,"MARILYN LLOYD","JIM GOLDEN","Democrat",0.539347326049454,10950,139118,0.078710159720525
1986,"TENNESSEE",5,85126,58701,147147,"BILL BONER","TERRY HOLCOMB","Democrat",0.578509925448701,26425,143827,0.183727672829163
1986,"TENNESSEE",6,102180,30823,133004,"BART GORDON","FRED VAIL","Democrat",0.768247571501609,71357,133003,0.536506695337699
1986,"TENNESSEE",7,35966,93902,129878,"M LLOYD HILER","DON SUNDQUIST","Republican",0.723001586103882,-57936,129868,-0.446114516278067
1986,"TENNESSEE",8,101699,24792,126503,"ED JONES","DAN H CAMPBELL","Democrat",0.803925598602405,76907,126491,0.608003731490778
1986,"TENNESSEE",9,83006,16221,99516,"HAROLD E FORD","ISAAC RICHMOND","Democrat",0.834097029623377,66785,99227,0.67305269735052
1986,"TEXAS",2,78529,55986,138353,"CHARLES WILSON","JULIAN GORDON","Democrat",0.56759882329982,22543,134515,0.167587257926625
1986,"TEXAS",4,97540,38578,136118,"RALPH M HALL","THOMAS BLOW","Democrat",0.71658414023127,58962,136118,0.43316828046254
1986,"TEXAS",5,57410,39945,98104,"JOHN BRYANT","TOM CARTER","Democrat",0.585195302943815,17465,97355,0.179394997688871
1986,"TEXAS",6,68270,86190,154460,"PETE GEREN","JOE BARON","Republican",0.558008545901852,-17920,154460,-0.116017091803703
1986,"TEXAS",7,17635,129673,148395,"HARRY KNIFFEN","BILL ARCHER","Republican",0.873836719566023,-112038,147308,-0.760569690716051
1986,"TEXAS",8,30617,66280,96903,"BLAINE MANN","JACK FIELDS","Republican",0.683982952024189,-35663,96897,-0.368050610442016
1986,"TEXAS",9,73285,45834,119119,"JACK BROOKS","LISA D DUPERIER","Democrat",0.61522511102343,27451,119119,0.230450222046861
1986,"TEXAS",10,135863,52000,187863,"J J ""JAKE"" PICKLE","CAROLE KEETON RYLANDER","Democrat",0.723202546536572,83863,187863,0.446405093073144
1986,"TEXAS",12,84831,38620,123451,"JIM WRIGHT","DON MCNEIL","Democrat",0.687163327960081,46211,123451,0.374326655920163
1986,"TEXAS",13,45907,84980,130887,"DOUG SEAL","BEAU BOULTER","Republican",0.649262340797787,-39073,130887,-0.298524681595575
1986,"TEXAS",14,67852,74471,142323,"GREG LAUGLIN","MAC SWEENEY","Republican",0.52325344462947,-6619,142323,-0.0465068892589392
1986,"TEXAS",16,50590,26421,77011,"RONALD COLEMAN","ROY GILLIA","Democrat",0.656919141421355,24169,77011,0.313838282842711
1986,"TEXAS",19,42129,68695,110824,"GERALD MCCATHERN","LARRY COMBEST","Republican",0.619856709737963,-26566,110824,-0.239713419475926
1986,"TEXAS",21,63779,100346,165567,"PETE SNELSON","LAMAR SMITH","Republican",0.606074882071911,-36567,164125,-0.222799695354151
1986,"TEXAS",22,30079,76459,106538,"SUSAN DIRECTOR","TOM DELAY","Republican",0.717668813005688,-46380,106538,-0.435337626011376
1986,"TEXAS",24,69368,33819,103191,"MARTIN FROST","BOB BURK","Democrat",0.67222916727234,35549,103187,0.34451045189801
1986,"TEXAS",26,47651,101735,149386,"GEORGE RICHARDSON","DICK ARMEY","Republican",0.681020979208226,-54084,149386,-0.362041958416451
1986,"UTAH",1,77180,82151,159331,"GUNN MCKAY","JAMES V HANSEN","Republican",0.515599600830975,-4971,159331,-0.031199201661949
1986,"UTAH",2,76921,60967,139390,"WAYNE OWENS","M TOM SHIMIZU","Democrat",0.551840160700194,15954,137888,0.115702599210954
1986,"UTAH",3,42582,86599,130074,"DALE F GARDINER","HOWARD C NIELSON","Republican",0.665767178682904,-44017,129181,-0.340738963160217
1986,"VIRGINIA",1,63364,80713,144086,"ROBERT C ""BOBBY"" SCOTT","HERBERT H ""HERB"" BATEMAN","Republican",0.560172397040656,-17349,144077,-0.120414778208874
1986,"VIRGINIA",2,54491,46137,110169,"OWEN B PICKETT","A J ""JOE"" CANADA JR","Democrat",0.494612822118745,8354,100628,0.083018642922447
1986,"VIRGINIA",3,32961,74525,111179,"KENNETH E POWELL","THOMAS J ""TOM"" BLILEY JR","Republican",0.670315437267829,-41564,107486,-0.386692220382189
1986,"VIRGINIA",6,88230,38051,126310,"JAMES R ""JIM"" OLIN","FLO NEHER TRAYWICK","Democrat",0.698519515477793,50179,126281,0.397359856193727
1986,"VIRGINIA",8,44965,72670,117655,"JAMES H BOREN","STANFORD E ""STAN"" PARRIS","Republican",0.617653308401683,-27705,117635,-0.235516640455647
1986,"VIRGINIA",10,63292,95724,159023,"JOHN G MILLIKEN","FRANK R WOLF","Republican",0.601950661225106,-32432,159016,-0.203954319062233
1986,"WASHINGTON",1,92697,97969,190666,"REESE M LINDQUIST","JOHN MILLER","Republican",0.513825223165116,-5272,190666,-0.0276504463302319
1986,"WASHINGTON",2,124840,48077,172917,"AL SWIFT","THOMAS S TALMAN","Democrat",0.721964873320726,76763,172917,0.443929746641452
1986,"WASHINGTON",3,114775,41275,156050,"DON BONKER","JOSEPH R ILLING","Democrat",0.735501441845562,73500,156050,0.471002883691125
1986,"WASHINGTON",4,41709,107593,149302,"ROBERT GOEDECKE","SID MORRISON","Republican",0.720640045009444,-65884,149302,-0.441280090018888
1986,"WASHINGTON",5,121732,41179,162911,"THOMAS S FOLEY","FLOYD LEE WAKEFIELD","Democrat",0.747230082683183,80553,162911,0.494460165366366
1986,"WASHINGTON",6,90063,36410,126473,"NORM DICKS","KENNETH W BRAATEN","Democrat",0.712112466692496,53653,126473,0.424224933384991
1986,"WASHINGTON",7,124317,46831,171148,"MIKE LOWRY","DON MCDONALD","Democrat",0.726371327739734,77486,171148,0.452742655479468
1986,"WASHINGTON",8,57545,107824,165369,"DAVID E GILES","ROD CHANDLER","Republican",0.65202063264578,-50279,165369,-0.30404126529156
1986,"WEST VIRGINIA",2,76355,33554,109909,"HARLEY O STAGGERS JR","MICHELE GOLDEN","Democrat",0.694711079165491,42801,109909,0.389422158330983
1986,"WEST VIRGINIA",3,73669,39820,113489,"BOB WISE","TIM SHARP","Democrat",0.649128990474848,33849,113489,0.298257980949696
1986,"WEST VIRGINIA",4,58217,23490,81707,"NICK JOE RAHALL II","MARTIN MILLER SR","Democrat",0.712509332125767,34727,81707,0.425018664251533
1986,"WISCONSIN",1,106288,34495,143139,"LES ASPIN","IRIS PETERSON","Democrat",0.742550946981605,71793,140783,0.509955037184887
1986,"WISCONSIN",2,106919,85156,192535,"ROBERT KASTENMEIER","ANN J HANEY","Democrat",0.555322408912665,21763,192075,0.113304698685409
1986,"WISCONSIN",3,58445,104393,162869,"LELAND E MULDER","STEVEN C GUNDERSON","Republican",0.640962982519694,-45948,162838,-0.282170009457252
1986,"WISCONSIN",7,106700,63408,171712,"DAVID R OBEY","KEVIN J HERMENING","Democrat",0.621389303019009,43292,170108,0.254497142991511
1986,"WISCONSIN",8,57265,118162,175432,"PAUL F WILLEMS","TOBY ROTH","Republican",0.673548725432076,-60897,175427,-0.347135845679399
1986,"WISCONSIN",9,38636,138766,177408,"THOMAS G POPP","F JAMES SENSENBRENNER JR","Republican",0.782185696248196,-100130,177402,-0.564424301868074
1986,"WYOMING",0,48780,111007,159787,"RICK GILMORE","DICK CHENEY","Republican",0.694718594128434,-62227,159787,-0.389437188256867
1988,"ALABAMA",1,77670,115173,194363,"JOHN M TYSON JR","H L ""SONNY"" CALLAHAN","Republican",0.59256648641974,-37503,192843,-0.194474261445839
1988,"ALABAMA",5,120142,64491,186623,"RONNIE G FLIPPO","STAN MCDONALD","Democrat",0.643768452977393,55651,184633,0.301414156732545
1988,"ALABAMA",6,138920,68788,209026,"BEN ERDREICH","CHARLES CADDIS","Democrat",0.664606316917513,70132,207708,0.33764708147977
1988,"ALABAMA",7,136074,63372,200966,"CLAUDE HARRIS","JAMES E ""JIM"" BACON","Democrat",0.677099608889066,72702,199446,0.364519719623357
1988,"ALASKA",0,71881,120595,192955,"PETER GRUENSTEIN","DON YOUNG","Republican",0.624990282708404,-48714,192476,-0.253091294499054
1988,"ARIZONA",1,71388,184639,256027,"JOHN M FILLMORE","JOHN J RHODES III","Republican",0.721170032848098,-113251,256027,-0.442340065696196
1988,"ARIZONA",2,99895,36309,136204,"MORRIS K UDALL","JOSEPH D SWEENEY","Democrat",0.733421925934628,63586,136204,0.466843851869255
1988,"ARIZONA",3,72417,174453,253330,"DAVE MOSS","BOB STUMP","Republican",0.688639324201634,-102036,246870,-0.413318750759509
1988,"ARIZONA",5,78115,164462,242577,"JUDITH E BELCHER","JIM KOLBE","Republican",0.677978538773256,-86347,242577,-0.355957077546511
1988,"ARKANSAS",2,168889,33475,202364,"TOMMY F ROBINSON","WARREN D CARPENTER","Democrat",0.8345802613113,135414,202364,0.669160522622601
1988,"ARKANSAS",3,54767,161623,216390,"DAVID STEWART","JOHN PAUL HAMMERSCHMIDT","Republican",0.746906049262905,-106856,216390,-0.49381209852581
1988,"ARKANSAS",4,129508,57658,187166,"BERYL ANTHONY JR","ROGER N BELL","Democrat",0.691941912526848,71850,187166,0.383883825053696
1988,"CALIFORNIA",1,159815,72189,254154,"DOUGLAS H BOSCO","SAMUEL ""MAR"" VANDERBILT","Democrat",0.628811665368241,87626,232004,0.377691763935105
1988,"CALIFORNIA",2,91088,139010,236351,"WAYNE MEYER","WALLY HERGER","Republican",0.588150674209121,-47922,230098,-0.208267781553947
1988,"CALIFORNIA",3,183470,74296,257766,"ROBERT T MATSUI","LOWELL PATICK LANDOWSKI","Democrat",0.711769589472622,109174,257766,0.423539178945245
1988,"CALIFORNIA",5,133530,33692,174758,"NANCY PELOSI","BRUCE MICHAEL O'NEILL","Democrat",0.76408519209421,99838,167222,0.597038667161019
1988,"CALIFORNIA",6,176645,64174,240819,"BARBARA BOXER","WILLIAM STEINMETZ","Democrat",0.733517704167861,112471,240819,0.467035408335721
1988,"CALIFORNIA",7,170006,78478,248484,"GEORGE MILLER","JEAN LAST","Democrat",0.684172824004765,91528,248484,0.36834564800953
1988,"CALIFORNIA",8,163221,76531,245196,"RONALD V DELLUMS","JOHN J CUDDIHY JR","Democrat",0.665675622767092,86690,239752,0.361581968033635
1988,"CALIFORNIA",9,152866,56656,209522,"FORTNEY PETE STARK","HOWARD HERTZ","Democrat",0.729594028312063,96210,209522,0.459188056624125
1988,"CALIFORNIA",11,145484,50050,205016,"TOM LANTOS","G M ""BILL"" QURAISHI","Democrat",0.709622663596988,95434,195534,0.488068571194779
1988,"CALIFORNIA",12,121523,136384,263930,"ANNA G ESHOO","TOM CAMPBELL","Republican",0.516743075815557,-14861,257907,-0.0576215457509878
1988,"CALIFORNIA",13,143980,63959,214522,"NORMAN Y MINETA","LUKE SOMMER","Democrat",0.671166593636084,80021,207939,0.384829204718692
1988,"CALIFORNIA",14,103899,173876,277775,"PATRICIA MALBERG","NORMAN D SHUMWAY","Republican",0.625959859598596,-69977,277775,-0.251919719197192
1988,"CALIFORNIA",15,118710,47957,170193,"TONY COELHO","CAROL HARNER","Democrat",0.697502247448485,70753,166667,0.424517150965698
1988,"CALIFORNIA",16,177452,48375,225827,"LEON E PANETTA","STANLEY MONTEITH","Democrat",0.785787350493962,129077,225827,0.571574700987924
1988,"CALIFORNIA",17,51730,129568,181298,"VINCENT LAVERY","CHARLES ""CHIP"" PASHAYAN","Republican",0.714668667056448,-77838,181298,-0.429337334112897
1988,"CALIFORNIA",18,125715,54034,179749,"RICHARD H LEHMAN","DAVID A LINN","Democrat",0.699391929857746,71681,179749,0.398783859715492
1988,"CALIFORNIA",19,112033,116026,230924,"GARY K HART","ROBERT J ""BOB"" LAGOMARSINO","Republican",0.502442361989226,-3993,228059,-0.0175086271534998
1988,"CALIFORNIA",20,62037,162779,229006,"LITA REID","WILLIAM M THOMAS","Republican",0.710806703754487,-100742,224816,-0.448108675539108
1988,"CALIFORNIA",21,75739,181413,262671,"DONALD E STEVENS","ELTON GALLEGLY","Republican",0.69064723551515,-105674,257152,-0.410939833250373
1988,"CALIFORNIA",22,61555,164699,236811,"JOHN G SIMMONS","CARLOS J MOORHEAD","Republican",0.69548711841933,-103144,226254,-0.455877023168651
1988,"CALIFORNIA",23,147858,77184,232879,"ANTHONY C BEILENSON","JIM SALOMON","Democrat",0.634913409968267,70674,225042,0.314048044365052
1988,"CALIFORNIA",24,112038,36835,155071,"HENRY A WAXMAN","JOHN N COWLES","Democrat",0.722494857194446,75203,148873,0.505148683777448
1988,"CALIFORNIA",26,126930,53518,180448,"HOWARD L BERMAN","G C ""BRODIE"" BRODERSON","Democrat",0.703415942543004,73412,180448,0.406831885086008
1988,"CALIFORNIA",27,148814,65307,220335,"MEL LEVINE","DENNIS GALBRAITH","Democrat",0.675398824517212,83507,214121,0.389999112651258
1988,"CALIFORNIA",28,109801,28645,144337,"JULIAN C DIXON","GEORGE ZALDIVAR ADAMS","Democrat",0.760726632810714,81156,138446,0.58619245048611
1988,"CALIFORNIA",29,88169,14543,106436,"AUGUSTUS F ""GUS"" HAWKINS","REUBEN D FRANCO","Democrat",0.828375737532414,73626,102712,0.716819845782382
1988,"CALIFORNIA",30,72253,43833,120644,"MATTHEW G ""MARTY"" MARTINEZ","RALPH R RAMIREZ","Democrat",0.598894267431451,28420,116086,0.244818496631807
1988,"CALIFORNIA",31,100919,36017,141027,"MERVYN M DYMALLY","ARNOLD C MAY","Democrat",0.715600558758252,64902,136936,0.473958637611731
1988,"CALIFORNIA",32,114666,50710,171349,"GLENN M ANDERSON","SANFORD W KAHN","Democrat",0.669195618299494,63956,165376,0.386730843653251
1988,"CALIFORNIA",33,57586,151704,219383,"NELSON GENTRY","DAVID DREIER","Republican",0.691502987925227,-94118,209290,-0.449701371302977
1988,"CALIFORNIA",34,92087,50954,145727,"ESTEBAN E TORRES","CHARLES M HOUSE","Democrat",0.631914470207992,41133,143041,0.287560909109975
1988,"CALIFORNIA",35,71186,181203,257268,"PAUL SWEENEY","JERRY LEWIS","Republican",0.704335556695741,-110017,252389,-0.435902515561296
1988,"CALIFORNIA",36,103493,81413,191648,"GEORGE E BROWN JR","JOHN PAUL STARK","Democrat",0.540016071130406,22080,184906,0.119412025569749
1988,"CALIFORNIA",37,89666,174284,271242,"JOHNNY PEARSON","AL MCCANDLESS","Republican",0.64254060949263,-84618,263950,-0.320583443834059
1988,"CALIFORNIA",38,52399,87690,147369,"JERRY YUDELSON","ROBERT K ""BOB"" DORNAN","Republican",0.595036948069133,-35291,140089,-0.251918423288053
1988,"CALIFORNIA",39,52162,169360,229359,"DON E MARQUIS","WILLIAM E ""BILL"" DANNEMEYER","Republican",0.738405730753971,-117198,221522,-0.529058061953215
1988,"CALIFORNIA",40,80782,181269,270376,"LIDA LENNEY","CHRISTOPHER COX","Republican",0.670433026599994,-100487,262051,-0.383463524275809
1988,"CALIFORNIA",41,88192,187380,285761,"DAN KRIPKE","BILL LOWERY","Republican",0.655722789323946,-99188,275572,-0.359934971622661
1988,"CALIFORNIA",42,78778,153280,238621,"GUY C KIMBROUGH","DANA ROHRABACHER","Republican",0.642357546066775,-74502,232058,-0.321049048082807
1988,"CALIFORNIA",43,72499,202478,282529,"HOWARD GREENEBAUM","RON PACKARD","Republican",0.71666271427004,-129979,274977,-0.472690443200704
1988,"CALIFORNIA",44,90796,55511,152089,"JIM BATES","ROB BUTTERFIELD","Democrat",0.59699255041456,35285,146307,0.241170962428319
1988,"CALIFORNIA",45,54012,166451,224903,"PETE LEPISCOPO","DUNCAN HUNTER","Republican",0.740101288110875,-112439,220463,-0.510013018057452
1988,"COLORADO",1,133922,57587,191509,"PATRICIA SCHROEDER","JOY WOOD","Democrat",0.699298727474949,76335,191509,0.398597454949898
1988,"COLORADO",2,147437,87578,235015,"DAVID E SKAGGS","DAVE BATH","Democrat",0.627351445652405,59859,235015,0.25470289130481
1988,"COLORADO",3,169284,47625,216909,"BEN NIGHTHORSE CAMPBELL","JIM ZARTMAN","Democrat",0.780437879479413,121659,216909,0.560875758958826
1988,"COLORADO",4,57552,156202,213754,"CHARLES S VIGIL","HANK BROWN","Republican",0.730755915678771,-98650,213754,-0.461511831357542
1988,"COLORADO",5,60116,181612,241728,"JOHN J MITCHELL","JOEL HEFLEY","Republican",0.751307254434737,-121496,241728,-0.502614508869473
1988,"COLORADO",6,77158,136487,216556,"MARTHA M EZZARD","DAN SCHAEFER","Republican",0.630261918395242,-59329,213645,-0.27769898663671
1988,"CONNECTICUT",1,176463,51985,228448,"BARBARA B KENNELLY","MARIO ROBLES JR","Democrat",0.772442744081804,124478,228448,0.544885488163608
1988,"CONNECTICUT",2,143326,81965,225291,"SAM GEJDENSON","GLENN CARBERRY","Democrat",0.636181649511077,61361,225291,0.272363299022154
1988,"CONNECTICUT",3,147394,74275,221669,"BRUCE A MORRISON","GERARD B PATTON","Democrat",0.66492833910019,73119,221669,0.32985667820038
1988,"CONNECTICUT",4,55751,147843,205973,"ROGER PEARSON","CHRISTOPHER SHAYS","Republican",0.71777854378972,-92092,203594,-0.452331601127735
1988,"CONNECTICUT",5,58612,163729,222341,"JOSEPH MARINAN JR","JOHN G ROWLAND","Republican",0.736386901201308,-105117,222341,-0.472773802402616
1988,"CONNECTICUT",6,78814,157020,236888,"JAMES L GRIFFIN","NANCY L JOHNSON","Republican",0.662844888723785,-78206,235834,-0.33161461027672
1988,"DELAWARE",0,158338,76179,234517,"THOMAS R CARPER","JAMES P KRAPF","Democrat",0.675166405846911,82159,234517,0.350332811693822
1988,"FLORIDA",1,142449,70534,212983,"EARL HUTTO","E D ARMBRUSTER","Democrat",0.668828028528099,71915,212983,0.337656057056197
1988,"FLORIDA",4,124817,125608,250425,"BILL CHAPPELL","CRAIG T JAMES","Republican",0.501579315164221,-791,250425,-0.00315863032844165
1988,"FLORIDA",6,118756,136415,255171,"JON MILLS","CLIFF STEARNS","Republican",0.534602286309965,-17659,255171,-0.0692045726199294
1988,"FLORIDA",8,62539,169165,231704,"C BETTE WIMBISH","C W BILL YOUNG","Republican",0.730090978144529,-106626,231704,-0.460181956289058
1988,"FLORIDA",10,56536,156563,213099,"DAVID B HIGGINBOTTOM","ANDY IRELAND","Republican",0.734696080225623,-100027,213099,-0.469392160451246
1988,"FLORIDA",11,168390,108373,276763,"BILL NELSON","BILL TOLLEY","Democrat",0.608426704436648,60017,276763,0.216853408873296
1988,"FLORIDA",13,93700,231170,324870,"JACK CONWAY","PORTER J GOSS","Republican",0.711576938467695,-137470,324870,-0.42315387693539
1988,"FLORIDA",14,173292,142635,315927,"HARRY A JOHNSTON","KEN ADAMS","Democrat",0.548519119923273,30657,315927,0.0970382398465468
1988,"FLORIDA",15,67746,132090,199836,"MICHAEL A ""MIKE"" KUHLE","E CLAY SHAW","Republican",0.66099201345103,-64344,199836,-0.32198402690206
1988,"FLORIDA",16,153032,67461,220493,"LARRY SMITH","JOSEPH SMITH","Democrat",0.694044708902323,85571,220493,0.388089417804647
1988,"FLORIDA",19,135355,51628,186983,"DANTE B FASCELL","RALPH CARLOS ROCHETEAU","Democrat",0.723889337533359,83727,186983,0.447778675066717
1988,"GEORGIA",1,94531,46552,141083,"LINDSAY THOMAS","JOHN CHRISTIAN ""CHRIS"" MEREDITH","Democrat",0.670038204461204,47979,141083,0.340076408922407
1988,"GEORGIA",2,85029,52807,137836,"CHARLES HATCHER","RALPH T HUDGENS","Democrat",0.616885283960649,32222,137836,0.233770567921298
1988,"GEORGIA",4,148394,97745,246139,"BEN JONES","PAT SWINDALL","Democrat",0.602886986621381,50649,246139,0.205773973242761
1988,"GEORGIA",5,135194,37693,172887,"JOHN LEWIS","J W TIBBS JR","Democrat",0.781978980490147,97501,172887,0.563957960980293
1988,"GEORGIA",6,76824,110169,187011,"DAVID WORLEY","NEWT GINGRICH","Republican",0.589104384234083,-33345,186993,-0.178322183183328
1988,"GEORGIA",7,135056,73425,208481,"GEORGE ""BUDDY"" DARDEN","ROBERT LAMUTT","Democrat",0.647809632532461,61631,208481,0.295619265064922
1988,"GEORGIA",9,121800,71905,193705,"ED JENKINS","JOE HOFFMAN","Democrat",0.628791203118144,49895,193705,0.257582406236287
1988,"GEORGIA",10,118156,66521,184677,"DOUG BARNARD JR","MARK MYERS","Democrat",0.639798134039431,51635,184677,0.279596268078862
1988,"HAWAII",1,76394,96848,177020,"MARY BITTERMAN","PATRICIA SAIKI","Republican",0.547102022370354,-20454,173242,-0.118066057884347
1988,"IDAHO",1,70328,135221,205549,"JEANNE GIVENS","LARRY E CRAIG","Republican",0.657852872064569,-64893,205549,-0.315705744129137
1988,"IDAHO",2,127956,68226,201885,"RICHARD H STALLINGS","DANE WATKINS","Democrat",0.633806374916413,59730,196182,0.3044621830749
1988,"ILLINOIS",1,164125,6753,170878,"CHARLES A HAYES","STEPHEN J EVANS","Democrat",0.960480576785777,157372,170878,0.920961153571554
1988,"ILLINOIS",2,138256,28831,167087,"GUS SAVAGE","WILLIAM T HESPEL","Democrat",0.827449173185227,109425,167087,0.654898346370454
1988,"ILLINOIS",3,132111,80181,212292,"MARTY RUSSO","JOSEPH J MCCARTHY","Democrat",0.622307953196541,51930,212292,0.244615906393081
1988,"ILLINOIS",4,91282,90243,181525,"GEORGE E SANGMEISTER","JACK DAVIS","Democrat",0.502861864756921,1039,181525,0.00572372951384107
1988,"ILLINOIS",5,93567,59128,152695,"WILLIAM O LIPINSKI","JOHN J HOLOWINSKI","Democrat",0.612770555682897,34439,152695,0.225541111365795
1988,"ILLINOIS",6,54804,153425,208229,"WILLIAM J ANDRLE","HENRY J HYDE","Republican",0.736808993944167,-98621,208229,-0.473617987888334
1988,"ILLINOIS",8,107728,34659,144324,"DAN ROSTENKOWSKI","V STEPHEN VETTER","Democrat",0.746431639921288,73069,142387,0.51317184855359
1988,"ILLINOIS",9,135583,67604,205187,"SIDNEY R YATES","HERBERT SOHN","Democrat",0.660777729583258,67979,203187,0.334563727010094
1988,"ILLINOIS",10,60187,158519,218706,"EUGENE F FRIEDMAN","JOHN EDWARD PORTER","Republican",0.724804074876775,-98332,218706,-0.44960814975355
1988,"ILLINOIS",11,131753,72489,204242,"FRANK ANNUNZIO","GEORGE S GOTTLIEB","Democrat",0.645082793940522,59264,204242,0.290165587881043
1988,"ILLINOIS",12,54769,165913,220682,"JOHN A LEONARDI","PHILIP M CRANE","Republican",0.751819359984049,-111144,220682,-0.503638719968099
1988,"ILLINOIS",13,74424,174992,249416,"EVELYN E CRAIG","HARRIS W FAWELL","Republican",0.70160695384418,-100568,249416,-0.40321390768836
1988,"ILLINOIS",14,57482,161146,218628,"STEPHEN YOUHANAIE","J DENNIS HASTERT","Republican",0.737078507784913,-103664,218628,-0.474157015569826
1988,"ILLINOIS",15,55260,140171,195431,"THOMAS J ""TOM"" CURL","EDWARD R MADIGAN","Republican",0.717240355931249,-84911,195431,-0.434480711862499
1988,"ILLINOIS",16,72431,128365,200796,"STEVEN E MAHAN","LYNN MARTIN","Republican",0.639280662961414,-55934,200796,-0.278561325922827
1988,"ILLINOIS",17,132130,71560,203690,"LANE EVANS","WILLIAM E STEWART","Democrat",0.648681820413373,60570,203690,0.297363640826747
1988,"ILLINOIS",18,94763,114458,209221,"G DOUGLAS STEPHENS","ROBERT H MICHEL","Republican",0.547067454987788,-19695,209221,-0.0941349099755761
1988,"ILLINOIS",19,132889,73981,206870,"TERRY L BRUCE","ROBERT F KERANS","Democrat",0.642379272006574,58908,206870,0.284758544013148
1988,"ILLINOIS",20,153341,69303,222644,"RICHARD J DURBIN","PAUL E JURGENS","Democrat",0.688727295592965,84038,222644,0.377454591185929
1988,"ILLINOIS",21,105836,95385,201221,"JERRY F COSTELLO","ROBERT H ""BOB"" GAFFNER","Democrat",0.525968959502239,10451,201221,0.0519379190044777
1988,"ILLINOIS",22,139392,75462,214854,"GLENN POSHARD","PATRICK J KELLEY","Democrat",0.648775447513195,63930,214854,0.29755089502639
1988,"INDIANA",1,138251,41076,179327,"PETER J VISCLOSKY","OWEN W CUMPACKER","Democrat",0.770943583509455,97175,179327,0.54188716701891
1988,"INDIANA",2,116915,102846,219761,"PHILIP R SHARP","MIKE PENCE","Democrat",0.532009774254759,14069,219761,0.0640195485095172
1988,"INDIANA",3,97934,116309,214243,"THOMAS W WARD","JOHN HILER","Republican",0.542883548120592,-18375,214243,-0.0857670962411841
1988,"INDIANA",4,80915,132843,213758,"JILL LONG","DAN COATS","Republican",0.621464459809691,-51928,213758,-0.242928919619383
1988,"INDIANA",5,116240,90163,206403,"JIM JONTZ","PATRICIA L WILLIAMS","Democrat",0.563170108961595,26077,206403,0.126340217923189
1988,"INDIANA",6,71447,192064,263511,"GEORGE THOMAS HOLLAND","DAN BURTON","Republican",0.728865208663016,-120617,263511,-0.457730417326032
1988,"INDIANA",7,80738,130578,211316,"MARK RICHARD WATERFILL","JOHN T MYERS","Republican",0.617927653372201,-49840,211316,-0.235855306744402
1988,"INDIANA",8,141355,87321,228676,"FRANK MCCLOSKEY","JOHN L MYERS","Democrat",0.618145323514492,54034,228676,0.236290647028984
1988,"INDIANA",9,147193,60946,208139,"LEE H HAMILTON","FLOYD EUGENE COATES","Democrat",0.707186063159715,86247,208139,0.414372126319431
1988,"INDIANA",10,105846,68978,174824,"ANDREW JACOBS JR","JAMES C CUMMINGS","Democrat",0.605443188578227,36868,174824,0.210886377156455
1988,"IOWA",1,71280,112746,185716,"BILL GLUBA","JIM LEACH","Republican",0.607088242262379,-41466,184026,-0.225326855987741
1988,"IOWA",2,86438,113543,200041,"ERIC TABOR","THOMAS J TAUKE","Republican",0.567598642278333,-27105,199981,-0.135537876098229
1988,"IOWA",3,129204,74682,203932,"DAVID R NAGLE","DONALD B REDFERN","Democrat",0.633564129219544,54522,203886,0.267414143197669
1988,"IOWA",4,157065,62056,219223,"NEAL SMITH","PAUL LUNDE","Democrat",0.716462232521223,95009,219121,0.433591485982631
1988,"IOWA",5,66599,117761,184368,"GENE FREUND","JIM LIGHTFOOT","Republican",0.638727978824959,-51162,184360,-0.277511390757214
1988,"IOWA",6,69614,125859,195478,"DAVE O'BREIN","FRED GRANDY","Republican",0.643852505141243,-56245,195473,-0.287737948463471
1988,"KANSAS",2,135694,49498,185192,"JIM SLATTERY","PHIL MEINHARDT","Democrat",0.7327206358806,86196,185192,0.465441271761199
1988,"KANSAS",3,53959,150223,204182,"LIONEL KUNST","JAN MEYERS","Republican",0.735730867559334,-96264,204182,-0.471461735118669
1988,"KANSAS",4,122777,69165,191942,"DAN GLICKMAN","LEE THOMPSON","Democrat",0.639656771316335,53612,191942,0.27931354263267
1988,"KANSAS",5,54327,127722,182049,"JOHN A BARNES","BOB WHITTAKER","Republican",0.701580343753605,-73395,182049,-0.40316068750721
1988,"KENTUCKY",2,92184,59907,152099,"WILLIAM H NATCHER","MARTIN A TORI","Democrat",0.606078935430213,32277,152091,0.212221630471231
1988,"KENTUCKY",3,131981,57387,189368,"ROMANO L MAZZOLI","PHILIP DUNNAGAN","Democrat",0.696955134975286,74594,189368,0.393910269950572
1988,"KENTUCKY",4,50575,145609,196184,"RICHARD V BELILES","JIM BUNNING","Republican",0.742206296130164,-95034,196184,-0.484412592260327
1988,"KENTUCKY",6,45339,128898,174277,"MILTON PATTON","LARRY J HOPKINS","Republican",0.739615669308056,-83559,174237,-0.479570929251537
1988,"KENTUCKY",7,96946,68165,165112,"CARL C PERKINS","WILLIAM THOMPSON """"WILL"""" SCOTT","Democrat",0.587152962837347,28781,165111,0.174313037895719
1988,"LOUISIANA",8,88564,116241,204805,"FAYE WILLIAMS","CLYDE C HOLLOWAY","Republican",0.567569151143771,-27677,204805,-0.135138302287542
1988,"MAINE",1,190989,111125,302163,"JOSEPH E BRENNAN","EDWARD S O'MEARA JR","Democrat",0.632072755433326,79864,302114,0.264350543172445
1988,"MAINE",2,85346,167226,252721,"KENNETH P HAYES","OLYMPIA J SNOWE","Republican",0.66170203505051,-81880,252572,-0.324184786912247
1988,"MARYLAND",1,96128,94588,190716,"ROY DYSON","WAYNE T GILCHREST","Democrat",0.504037416892133,1540,190716,0.00807483378426561
1988,"MARYLAND",2,63114,157956,221070,"JOSEPH BARTENFELDER","HELEN DELICH BENTLEY","Republican",0.714506717329353,-94842,221070,-0.429013434658705
1988,"MARYLAND",3,133779,49733,183512,"BENJAMIN L CARDIN","ROSS Z PIERPONT","Democrat",0.728993199354811,84046,183512,0.457986398709621
1988,"MARYLAND",4,128624,59688,188312,"C THOMAS MCMILLEN","BARDLYN MCCLANAHAN","Democrat",0.683036662560007,68936,188312,0.366073325120014
1988,"MARYLAND",5,128437,34909,163346,"STENY H HOYER","JOHN EUGENE SELLNER","Democrat",0.786288002154935,93528,163346,0.57257600430987
1988,"MARYLAND",6,166753,54528,221281,"BEVERLY B BYRON","KENNETH W HALSEY","Democrat",0.753580289315395,112225,221281,0.507160578630791
1988,"MARYLAND",8,102478,172619,275097,"PETER FRANCHOT","CONSTANCE A MORELLA","Republican",0.627484123781793,-70141,275097,-0.254968247563587
1988,"MASSACHUSETTS",1,38907,186356,225291,"JOHN R ARDEN","SILVIO O CONTE","Republican",0.827179070624215,-147449,225263,-0.654563776563395
1988,"MASSACHUSETTS",4,169729,71661,241414,"BARNEY FRANK","DEBRA R TUCKER","Democrat",0.703061959952613,98068,241390,0.40626372260657
1988,"MASSACHUSETTS",6,177643,77186,255067,"NICHOLAS MAVROULES","PAUL MCCARTHY","Democrat",0.696456225227097,100457,254829,0.394213374458951
1988,"MASSACHUSETTS",8,165745,40316,206189,"JOSEPH P KENNEDY II","GLENN W FISCUS","Democrat",0.803849865899733,125429,206061,0.608698395135421
1988,"MASSACHUSETTS",10,187178,93564,280767,"GERRY E STUDDS","JON L BRYAN","Democrat",0.666666666666667,93614,280742,0.333452066309993
1988,"MASSACHUSETTS",11,169692,40277,209988,"BRIAN J DONNELLY","MICHAEL C GILLERAN","Democrat",0.808103320189725,129415,209969,0.616352890188552
1988,"MICHIGAN",1,127800,10979,140138,"JOHN CONYERS JR","BILL ASHE","Democrat",0.91195821261899,116821,138779,0.841777214131821
1988,"MICHIGAN",2,98290,120070,219692,"LANA POLLACK","CARL D PURSELL","Republican",0.546537880305154,-21780,218360,-0.0997435427734017
1988,"MICHIGAN",3,112605,83769,196375,"HOWARD WOLPE","CAL ALLGAIER","Democrat",0.57341820496499,28836,196374,0.146842249992362
1988,"MICHIGAN",4,54428,132270,186703,"NORMAN J RIVERS","FREDERICK S UPTON","Republican",0.708451390711451,-77842,186698,-0.416940727806404
1988,"MICHIGAN",5,62868,166569,229440,"JAMES M CATCHICK","PAUL B HENRY","Republican",0.725980648535565,-103701,229437,-0.451980282168961
1988,"MICHIGAN",6,120581,81079,204625,"BOB CARR","SCOTT SCHULTZ","Democrat",0.589277947464875,39502,201660,0.195884161459883
1988,"MICHIGAN",7,150832,47071,199080,"DALE E KILDEE","JEFF COAD","Democrat",0.75764516777175,103761,197903,0.524302309717387
1988,"MICHIGAN",8,139904,54195,194104,"BOB TRAXLER","LLOYD F BUHL","Democrat",0.720768247949553,85709,194099,0.441573629951726
1988,"MICHIGAN",9,64843,149748,214594,"DAVID JOHN GAWRON","GUY VANDER JAGT","Republican",0.697820069526641,-84905,214591,-0.395659650218322
1988,"MICHIGAN",10,55398,152646,209863,"MATHIAS G FORBES","BILL SCHUETTE","Republican",0.727360230245446,-97248,208044,-0.467439580088827
1988,"MICHIGAN",11,86526,129085,216417,"MITCH IRWIN","ROBERT W DAVIS","Republican",0.596464233401258,-42559,215611,-0.197387888373042
1988,"MICHIGAN",12,108158,91780,201798,"DAVID E BONIOR","DOUGLAS CARL","Democrat",0.535971615179536,16378,199938,0.0819153937720693
1988,"MICHIGAN",13,99751,13196,114700,"GEORGE W CROCKETT JR","JOHN WRIGHT SAVAGE II","Democrat",0.869668700959023,86555,112947,0.766332881794116
1988,"MICHIGAN",14,111612,64750,178410,"DENNIS M HERTEL","KENNETH C MCNEALY","Democrat",0.625592735833193,46862,176362,0.265714836529411
1988,"MICHIGAN",15,104596,56963,163842,"WILLIAM D FORD","BURL C ADKINS","Democrat",0.638395527398347,47633,161559,0.294833466411651
1988,"MICHIGAN",17,135493,55197,193027,"SANDER M LEVIN","DENNIS M FLESSLAND","Democrat",0.701938070839831,80296,190690,0.421081336200115
1988,"MICHIGAN",18,57643,195579,257228,"GARY L KOHUT","WILLIAM S BROOMFIELD","Republican",0.760333245214362,-137936,253222,-0.544723602214658
1988,"MISSISSIPPI",1,137445,38381,175826,"JAMIE L WHITTEN","JIM BUSH","Democrat",0.781710327255355,99064,175826,0.563420654510709
1988,"MISSISSIPPI",2,112401,59827,173631,"MIKE ESPY","JACK COLEMAN","Democrat",0.647355598942585,52574,172228,0.305258146178322
1988,"MISSISSIPPI",3,164651,20729,185380,"GV ""SONNY"" MONTGOMERY","JIMMIE RAY BOURLAND","Democrat",0.888181033552703,143922,185380,0.776362067105405
1988,"MISSISSIPPI",4,110184,88433,201063,"MIKE PARKER","THOMAS COLLINS","Democrat",0.548007340982677,21751,198617,0.109512277398209
1988,"MISSISSIPPI",5,82034,100185,182219,"GENE TAYLOR","LARKIN SMITH","Republican",0.549805453876928,-18151,182219,-0.0996109077538566
1988,"MISSOURI",1,140751,53109,196658,"WILLIAM ""BILL"" CLAY","JOSEPH A SCHWAN","Democrat",0.715714590812476,87642,193860,0.452089136490251
1988,"MISSOURI",2,91645,186450,281109,"ROBERT H ""BOB"" FEIGENBAUM","JACK BUECHNER","Republican",0.663265850613107,-94805,278095,-0.340908682284831
1988,"MISSOURI",3,150205,86763,239203,"RICHARD A GEPHARDT","MARK F ""THOR"" HEARNE","Democrat",0.627939448919955,63442,236968,0.267723912089396
1988,"MISSOURI",4,166480,65393,231873,"IKE SKELTON","DAVID EYERLY","Democrat",0.717979238634942,101087,231873,0.435958477269885
1988,"MISSOURI",5,149166,60453,212139,"ALAN WHEAT","MARY ELLEN LOBB","Democrat",0.703152178524458,88713,209619,0.423210682237774
1988,"MISSOURI",6,93128,135883,229011,"DOUG R HUGHES","TOM COLEMAN","Republican",0.593347044465113,-42755,229011,-0.186694088930226
1988,"MISSOURI",7,111244,127939,240911,"MAX BACON","MEL HANCOCK","Republican",0.531063338743353,-16695,239183,-0.0698001112119172
1988,"MISSOURI",8,84801,117601,202402,"WAYNE CRYTS","BILL EMERSON","Republican",0.581026867323445,-32800,202402,-0.162053734646891
1988,"MISSOURI",9,160872,76008,236880,"HAROLD L VOLKMER","KEN DUDLEY","Democrat",0.679128672745694,84864,236880,0.358257345491388
1988,"MONTANA",1,115278,74405,189683,"PAT WILLIAMS","JIM FENLASON","Democrat",0.607740282471281,40873,189683,0.215480564942562
1988,"MONTANA",2,78069,97465,175534,"BUCK O'BRIEN","RON MARLENEE","Republican",0.555248555835337,-19396,175534,-0.110497111670673
1988,"NEBRASKA",1,72167,146231,218502,"CORKY JONES","DOUG BEREUTER","Republican",0.669243302120804,-74064,218398,-0.339123984651874
1988,"NEBRASKA",2,112174,109193,222275,"PETER HOAGLAND","JERRY SCHENKEN","Democrat",0.504663142503655,2981,221367,0.0134663251523488
1988,"NEBRASKA",3,45183,170302,215501,"JOHN D RACEK","VIRGINIA SMITH","Republican",0.790260834056455,-125119,215485,-0.58063902359793
1988,"NEVADA",1,101764,53588,159076,"JAMES H BILBRAY","LUCILLE LUSK","Democrat",0.639719379416128,48176,155352,0.310108656470467
1988,"NEVADA",2,75163,105981,185097,"JIM SPOO","BARBARA F VUCANOVICH","Republican",0.572570057861554,-30818,181144,-0.170129841452104
1988,"NEW HAMPSHIRE",1,86623,131824,218505,"JOSEPH F KEEFE","BOB SMITH","Republican",0.603299695659138,-45201,218447,-0.206919756279555
1988,"NEW HAMPSHIRE",2,89677,119742,210994,"JAMES W DONCHESS","CHUCK DOUGLAS","Republican",0.567513768164024,-30065,209419,-0.143563860012702
1988,"NEW JERSEY",1,141988,60037,203153,"JAMES J FLORIO","FRANK A CRISTAUDO","Democrat",0.698921502512884,81951,202025,0.405647815864373
1988,"NEW JERSEY",2,134505,67759,204636,"WILLIAM J HUGHES","KIRK W CONOVER","Democrat",0.657289040051604,66746,202264,0.329994462682435
1988,"NEW JERSEY",3,117024,107479,226610,"FRANK PALLONE JR","JOSEPH AZZOLINA","Democrat",0.516411455805128,9545,224503,0.04251613564184
1988,"NEW JERSEY",4,79006,155283,236194,"BETTY HOLLAND","CHRISTOPHER H SMITH","Republican",0.657438376927441,-76277,234289,-0.325567995082996
1988,"NEW JERSEY",5,54828,175562,231936,"LEE MONACO","MARGE ROUKEMA","Republican",0.7569415700883,-120734,230390,-0.524041842093841
1988,"NEW JERSEY",6,120125,74824,196598,"BERNARD J DWYER","PETER J SICA","Democrat",0.611018423381723,45301,194949,0.232373595145397
1988,"NEW JERSEY",7,52189,153350,205539,"JAMES HELY","MATTHEW J RINALDO","Republican",0.746087117286744,-101161,205539,-0.492174234573487
1988,"NEW JERSEY",9,142012,68363,211494,"ROBERT G TORRICELLI","ROGER J LANE","Democrat",0.671470585453961,73649,210375,0.350084373143197
1988,"NEW JERSEY",10,84681,13848,109473,"DONALD M PAYNE","MICHAEL WEBB","Democrat",0.773533199967115,70833,98529,0.718905093931736
1988,"NEW JERSEY",11,64773,154654,219427,"JOHN C SHAW","DEAN A GALLO","Republican",0.704808432872892,-89881,219427,-0.409616865745783
1988,"NEW JERSEY",12,71596,165918,239537,"NORMAN J WEINSTEIN","JIM COURTER","Republican",0.692661259012178,-94322,237514,-0.397121853869667
1988,"NEW JERSEY",13,73561,167470,241031,"JAMES B SMITH","H JAMES SAXTON","Republican",0.694806892059528,-93909,241031,-0.389613784119055
1988,"NEW JERSEY",14,104001,47293,154440,"FRANK J GUARINI","FRED J THEEMLING JR","Democrat",0.673407148407148,56708,151294,0.374819887107222
1988,"NEW MEXICO",1,84138,89985,177962,"TOM UDALL","STEVEN H SCHIFF","Republican",0.505641653836212,-5847,174123,-0.0335797108940232
1988,"NEW MEXICO",3,124938,45954,170892,"BILL RICHARDSON","CECILIA M SALAZAR","Democrat",0.731093322098167,78984,170892,0.462186644196335
1988,"NEW YORK",1,103511,87812,207951,"GEORGE J HOCHBRUECKNER","EDWAES P ROMAINE","Democrat",0.497766300715072,15699,191323,0.0820549541874213
1988,"NEW YORK",2,104765,55773,174618,"THOMAS J DOWNEY","JOSEPH CARDINO JR","Democrat",0.599966784638468,48992,160538,0.305173852919558
1988,"NEW YORK",3,128336,80398,224306,"ROBERT J MRAZEK","ROBERT PREVIDI","Democrat",0.57214697778927,47938,208734,0.229660716510008
1988,"NEW YORK",4,57435,135173,215386,"FRANCIS T GOBAN","NORMAN F LENT","Republican",0.627584894097109,-77738,192608,-0.403607326798471
1988,"NEW YORK",5,68930,122058,207313,"WILLIAM G KELLY","RAYMOND J MCGRATH","Republican",0.588761920381259,-53128,190988,-0.278174544997591
1988,"NEW YORK",10,102727,24313,136488,"CHARLES E SCHUMER","GEORGE S POPIELARSKI","Democrat",0.752644921165231,78414,127040,0.617238664987406
1988,"NEW YORK",11,70973,7418,83158,"EDOLPHUS TOWNS","RIAZ B HUSSAIN","Democrat",0.853471704466197,63555,78391,0.810743580257938
1988,"NEW YORK",12,69063,4652,79886,"MAJOR R OWENS","OWEN AUGUSTIN","Democrat",0.864519440202288,64411,73715,0.873784168758055
1988,"NEW YORK",13,77988,23926,108841,"STEPHEN J SOLARZ","ANTHONY M CURCI","Democrat",0.716531454139525,54062,101914,0.530466864218851
1988,"NEW YORK",14,56088,81211,156682,"JEROME X O'DONOVAN","GUY V MOLINARI","Republican",0.518317356173651,-25123,137299,-0.182980211072186
1988,"NEW YORK",15,64425,100701,175483,"PETER G DOUKAS","BILL GREEN","Republican",0.573850458448967,-36276,165126,-0.219686784637186
1988,"NEW YORK",16,95227,8820,110850,"CHARLES B RANGEL","CHARLES B RANGEL","Democrat",0.859061795218764,86407,104047,0.830461233865465
1988,"NEW YORK",17,148089,26443,186495,"TED WEISS","MYRNA C ALBERT","Democrat",0.794064184026381,121646,174532,0.69698393417826
1988,"NEW YORK",18,73168,5764,82866,"ROBERT GARCIA","FRED BROWN","Democrat",0.882967682764946,67404,78932,0.853950235645872
1988,"NEW YORK",19,74613,37454,137743,"ELIOT L ENGEL","MARIO BIAGGI","Democrat",0.541682698939329,37159,112067,0.33157843076017
1988,"NEW YORK",20,102235,84951,203263,"NITA M LOWEY","JOSEPH J DIOGUARDI","Democrat",0.502969059789534,17284,187186,0.09233596529655
1988,"NEW YORK",21,47294,134173,201607,"LAWRENCE W GRUNBERGER","HAMILTON FISH JR","Republican",0.665517566354343,-86879,181467,-0.478759223440074
1988,"NEW YORK",22,54312,144227,203635,"ELEANOR F BURLINGHAM","BENJAMIN A GILMAN","Republican",0.708262332113831,-89915,198539,-0.452883312598532
1988,"NEW YORK",23,145040,83308,234898,"MICHAEL R MCNULTY","PETER M BAKAL","Democrat",0.617459493056561,61732,228348,0.27034175906949
1988,"NEW YORK",24,62177,144271,225139,"FRED BAYE","GERALD B H SOLOMON","Republican",0.640808567151848,-82094,206448,-0.397649771370999
1988,"NEW YORK",26,43585,120973,174628,"DONALD R RAVENSCROFT","DAVID O'B MARTIN","Republican",0.692746867627185,-77388,164558,-0.470277956708273
1988,"NEW YORK",27,88476,116918,217426,"ROSEMARY S POOLER","JAMES T WALSH","Republican",0.537736977178442,-28442,205394,-0.138475320603328
1988,"NEW YORK",29,51243,132608,192661,"JAMES R VOGEL","FRANK HORTON","Republican",0.688297060640192,-81365,183851,-0.442559463913713
1988,"NEW YORK",30,128364,89126,225712,"LOUISE M SLAUGHTER","JOHN D BOUCHARD","Democrat",0.568707024881265,39238,217490,0.180412892546784
1988,"NEW YORK",31,98958,103802,220487,"DAVID J SWARTS","L WILLIAM PAXON","Republican",0.470785125653667,-4844,202760,-0.0238903136713356
1988,"NEW YORK",32,129359,43747,184146,"JOHN J LAFALCE","EMIL K EVERETT","Democrat",0.702480640361452,85612,173106,0.494564024355019
1988,"NORTH CAROLINA",1,118027,63013,181040,"WALTER B JONES","HOWARD D MOYE","Democrat",0.651938798055678,55014,181040,0.303877596111357
1988,"NORTH CAROLINA",4,131896,95482,227378,"DAVID E PRICE","TOM FETZER","Democrat",0.580073709857594,36414,227378,0.160147419715188
1988,"NORTH CAROLINA",5,110516,99540,210056,"STEPHEN L NEAL","LYONS GRAY","Democrat",0.526126366302319,10976,210056,0.0522527326046388
1988,"NORTH CAROLINA",6,70008,116534,186542,"TOM GILMORE","HOWARD COBLE","Republican",0.624706500412776,-46526,186542,-0.249413000825551
1988,"NORTH CAROLINA",7,102392,49855,152247,"CHARLES ROSE","GEORGE G ""JERRY"" THOMPSON","Democrat",0.672538703554093,52537,152247,0.345077407108186
1988,"NORTH CAROLINA",8,99214,93463,192677,"W G ""BILL"" HEFNER","TED BLANTON","Democrat",0.514923940065498,5751,192677,0.0298478801309964
1988,"NORTH CAROLINA",9,71802,139014,210816,"MARK SHOLANDER","J ALEX MCMILLAN","Republican",0.659409153005464,-67212,210816,-0.318818306010929
1988,"NORTH CAROLINA",10,71865,112554,184419,"JACK L RHYNE","CASS BALLENGER","Republican",0.610316724415597,-40689,184419,-0.220633448831194
1988,"NORTH CAROLINA",11,108436,106907,215343,"JAMES MCCLURE CLARKE","CHARLES H TAYLOR","Democrat",0.503550150225454,1529,215343,0.00710030045090855
1988,"NORTH DAKOTA",0,212583,84475,299982,"BYRON L DORGANSTEVE SYDNESS","STEVE SYDNESS","Democrat",0.708652519151149,128108,297058,0.431255849026116
1988,"OHIO",1,117682,90738,208420,"THOMAS A LUKEN","STEVE CHABOT","Democrat",0.564638710296517,26944,208420,0.129277420593033
1988,"OHIO",2,58637,153162,211799,"CHUCK R STIDHAM","WILLIS D GRADISON JR","Republican",0.723147890216668,-94525,211799,-0.446295780433335
1988,"OHIO",3,141953,42664,184617,"TONY P HALL","RON CRUTCHER","Democrat",0.768905355411474,99289,184617,0.537810710822947
1988,"OHIO",5,80472,123838,204310,"TOM MURRAY","PAUL E GILLMOR","Republican",0.606127942831971,-43366,204310,-0.212255885663942
1988,"OHIO",6,52635,152235,204870,"GORDON R ROBERTS","BOB MCEWEN","Republican",0.743080978181286,-99600,204870,-0.486161956362571
1988,"OHIO",7,50423,142597,193020,"JACK SCHIRA","MICHAEL DEWINE","Republican",0.738768003315719,-92174,193020,-0.477536006631437
1988,"OHIO",8,49084,154164,203248,"JOHN GRIFFIN","DONALD E LUKENS","Republican",0.758501928678265,-105080,203248,-0.51700385735653
1988,"OHIO",9,157557,36183,193812,"MARCY KAPTUR","AL HAWKINS","Democrat",0.812937279425423,121374,193740,0.626478786001858
1988,"OHIO",10,56893,143673,200566,"JOHN M BUCHANAN","CLARENCE E MILLER","Republican",0.716337764127519,-86780,200566,-0.432675528255038
1988,"OHIO",11,124600,78028,202628,"DENNIS E ECKART","MARGARET MUELLER","Democrat",0.614919951832915,46572,202628,0.229839903665831
1988,"OHIO",12,50782,204892,255674,"MARK P BROWN","JOHN R KASICH","Republican",0.801379882193731,-154110,255674,-0.602759764387462
1988,"OHIO",13,137074,59287,196361,"DONALD J PEASE","DWIGHT BROWN","Democrat",0.698071409292069,77787,196361,0.396142818584138
1988,"OHIO",14,148951,50356,199307,"THOMAS C SAWYER","LORETTA LANG","Democrat",0.747344548861806,98595,199307,0.494689097723612
1988,"OHIO",15,51172,154694,205866,"MARK S FROEHLICH","CHALMERS P WYLIE","Republican",0.751430542197352,-103522,205866,-0.502861084394703
1988,"OHIO",16,43356,158824,202180,"MELVIN J GRAVELY","RALPH REGULA","Republican",0.785557424077555,-115468,202180,-0.571114848155109
1988,"OHIO",17,162526,47929,210455,"JAMES A TRAFICANT JR","FREDERICK W LENZ","Democrat",0.772260103109929,114597,210455,0.544520206219857
1988,"OHIO",18,151306,43628,194934,"DOUGLAS APPLEGATE","WILLIAM C ABRAHAM","Democrat",0.77619091589974,107678,194934,0.552381831799481
1988,"OHIO",19,168065,70359,238424,"EDWARD F FEIGHAN","NOEL F ROBERTS","Democrat",0.70489967452941,97706,238424,0.40979934905882
1988,"OHIO",20,146715,30944,177659,"MARY ROSE OAKAR","MICHAEL SAJNA","Democrat",0.825823628411733,115771,177659,0.651647256823465
1988,"OHIO",21,148388,24804,173192,"LOUIS STOKES","FRANKLIN H ROSKI","Democrat",0.856783223243568,123584,173192,0.713566446487136
1988,"OKLAHOMA",1,93101,103458,196559,"KURT GLASSCO","JAMES M INHOFE","Republican",0.52634577912993,-10357,196559,-0.0526915582598609
1988,"OKLAHOMA",2,136009,73659,209668,"MIKE SYNAR","IRA PHILLIPS","Democrat",0.648687448728466,62350,209668,0.297374897456932
1988,"OKLAHOMA",5,53668,139182,192850,"TERRY J MONTGOMERY","MICKEY EDWARDS","Republican",0.721711174487944,-85514,192850,-0.443422348975888
1988,"OKLAHOMA",6,122887,45239,168126,"GLENN ENGLISH","MIKE BROWN","Democrat",0.730922046560318,77648,168126,0.461844093120636
1988,"OREGON",1,179915,78626,258603,"LES AUCOIN","EARL MOLANDER","Democrat",0.695718920507496,101289,258541,0.391771517863704
1988,"OREGON",2,74700,125366,200079,"LARRY TUTTLE","ROBERT F ""BOB"" SMITH","Republican",0.626582499912535,-50666,200066,-0.253246428678536
1988,"OREGON",4,108483,42220,150735,"PETER A DEFAZIO","JIM HOWARD","Democrat",0.719693501840979,66263,150703,0.439692640491563
1988,"OREGON",5,110782,111489,222354,"MIKE KOPETSKI","DENNY SMITH","Republican",0.501403167921423,-707,222271,-0.00318080181400183
1988,"PENNSYLVANIA",1,128076,39749,167825,"THOMAS M FOGLIETTA","WILLIAM J O'BRIEN","Democrat",0.76315209295397,88327,167825,0.52630418590794
1988,"PENNSYLVANIA",2,184322,12365,196687,"WILLIAM H GRAY III","RICHARD L HARSCH","Democrat",0.937133618388607,171957,196687,0.874267236777215
1988,"PENNSYLVANIA",3,135590,78909,214499,"ROBERT A BORSKI","MARK MATTHEWS","Democrat",0.632124159086989,56681,214499,0.264248318173977
1988,"PENNSYLVANIA",4,124041,52402,177699,"JOE KOLTER","GORDON R JOHNSTON","Democrat",0.698039943950163,71639,176443,0.406017807450565
1988,"PENNSYLVANIA",5,42758,153453,196211,"DONALD A HADLEY","RICHARD T SCHULZE","Republican",0.782081534674407,-110695,196211,-0.564163069348813
1988,"PENNSYLVANIA",6,114119,65278,180745,"GUS YATRON","JAMES R ERWIN","Democrat",0.631381227696478,48841,179397,0.272250929502723
1988,"PENNSYLVANIA",7,73745,155387,229132,"DAVID LANDAU","CURT WELDON","Republican",0.678154949985161,-81642,229132,-0.356309899970323
1988,"PENNSYLVANIA",8,128153,93648,225566,"PETER H KOSTMAYER","ED HOWARD","Democrat",0.568139701905429,34505,221801,0.155567377964933
1988,"PENNSYLVANIA",10,51179,140096,191275,"ROBERT C CORDARO","JOSEPH M MCDADE","Republican",0.732432361782773,-88917,191275,-0.464864723565547
1988,"PENNSYLVANIA",13,76424,152191,228615,"BERNARD TOMKIN","LAWRENCE COUGHLIN","Republican",0.665708724274435,-75767,228615,-0.33141744854887
1988,"PENNSYLVANIA",14,135181,36719,171900,"WILLIAM J COYNE","RICHARD EDWARD CALIGIURI","Democrat",0.786393251890634,98462,171900,0.572786503781268
1988,"PENNSYLVANIA",15,79127,106951,186078,"ED REIBMAN","DON RITTER","Republican",0.574764346134417,-27824,186078,-0.149528692268834
1988,"PENNSYLVANIA",16,48169,136944,185113,"ERNEST ERIC GUYLL","ROBERT S WALKER","Republican",0.739785968570549,-88775,185113,-0.479571937141098
1988,"PENNSYLVANIA",18,136924,80975,218488,"DOUG WALGREN","JOHN A NEWMAN","Democrat",0.626688879938486,55949,217899,0.256765749269157
1988,"PENNSYLVANIA",19,42819,145381,188200,"PAUL E RITCHEY","WILLIAM F GOODLING","Republican",0.772481402763018,-102562,188200,-0.544962805526036
1988,"PENNSYLVANIA",21,38288,141832,180120,"GEORGE R H ELDER","THOMAS J RIDGE","Republican",0.787430601821008,-103544,180120,-0.574861203642016
1988,"PENNSYLVANIA",22,123428,47039,170467,"AUSTIN J MURPHY","WILLIAM HODGKISS","Democrat",0.724058028826694,76389,170467,0.448116057653387
1988,"PENNSYLVANIA",23,63476,105575,170160,"HOWARD SHAKESPEARE","WILLIAM F CLINGER JR","Republican",0.620445463093559,-42099,169051,-0.249031357401021
1988,"RHODE ISLAND",1,84141,105506,189647,"FERNAND J ST GERMAIN","RONALD K MACHTLEY","Republican",0.556328336330129,-21365,189647,-0.112656672660258
1988,"RHODE ISLAND",2,56129,145218,201347,"RUTH S MORGENTHAU","CLAUDINE SCHNEIDER","Republican",0.721232499118437,-89089,201347,-0.442464998236875
1988,"SOUTH CAROLINA",1,57691,101572,159263,"WHEELER TILLMAN","ARTHUR RAVENEL JR","Republican",0.637762694411131,-43881,159263,-0.275525388822263
1988,"SOUTH CAROLINA",2,83978,94960,179999,"JIM LEVENTIS","FLOYD D SPENCE","Republican",0.527558486436036,-10982,178938,-0.0613732130682136
1988,"SOUTH CAROLINA",3,89071,75571,165825,"BUTLER DERRICK","HENRY JORDAN","Democrat",0.537138549675863,13500,164642,0.0819960884828902
1988,"SOUTH CAROLINA",4,90234,82793,173027,"LIZ J PATTERSON","KNOX WHITE","Democrat",0.521502424477105,7441,173027,0.0430048489542095
1988,"SOUTH CAROLINA",5,107959,46622,154581,"JOHN SPRATT JR","ROBERT K ""BOB"" CARLEY","Democrat",0.698397603845233,61337,154581,0.396795207690467
1988,"SOUTH CAROLINA",6,120719,37958,158677,"ROBIN TALLON","BOB CUNNINGHAM","Democrat",0.760784486724604,82761,158677,0.521568973449208
1988,"SOUTH DAKOTA",0,223759,88157,311916,"TIM JOHNSON","DAVID VOLK","Democrat",0.717369419972044,135602,311916,0.434738839944088
1988,"TENNESSEE",1,29469,119526,148998,"SIDNEY S SMITH","JAMES H ""JIMMY"" QUILLEN","Republican",0.802198687230701,-90057,148995,-0.604429678848283
1988,"TENNESSEE",2,77540,99631,177174,"DUDLEY W TAYLOR","JOHN J DUNCAN JR","Republican",0.562334202535361,-22091,177171,-0.124687448848852
1988,"TENNESSEE",3,108264,80372,188638,"MARILYN LLOYD","HAROLD L COKER","Democrat",0.573924659930661,27892,188636,0.147861489853474
1988,"TENNESSEE",6,123652,38033,161687,"BART GORDON","WALLACE EMBRY","Democrat",0.764761545455108,85619,161685,0.529542010699818
1988,"TENNESSEE",7,35237,142025,177266,"KENNETH ""KEN"" BLOODWORTH","DON SUNDQUIST","Republican",0.801197071068338,-106788,177262,-0.602430300910517
1988,"TENNESSEE",8,94571,56893,151465,"JOHN TANNER","ED BRYANT","Democrat",0.624375268213779,37678,151464,0.248758780964454
1988,"TEXAS",1,122566,74357,196923,"JIM CHAPMAN","HORACE MCQUEEN","Democrat",0.622405711877231,48209,196923,0.244811423754462
1988,"TEXAS",3,50627,227882,278509,"BLAKE COWDEN","STEVE BARTLETT","Republican",0.818221314212467,-177255,278509,-0.636442628424934
1988,"TEXAS",4,139379,67337,209868,"RALPH M HALL","RANDY SUTTON","Democrat",0.664126975050984,72042,206716,0.348507130555932
1988,"TEXAS",5,95376,59877,157039,"JOHN BRYANT","LON WILLIAMS","Democrat",0.607339578066595,35499,155253,0.228652586423451
1988,"TEXAS",6,78786,164692,243478,"N P ""PAT"" KENDRICK","JOE BARTON","Republican",0.676414296158174,-85906,243478,-0.352828592316349
1988,"TEXAS",7,48824,185203,234027,"DIANNE RICHARDS","BILL ARCHER","Republican",0.791374499523559,-136379,234027,-0.582748999047119
1988,"TEXAS",13,98345,89105,187450,"BILL SARPALIUS","LARRY S MILNER","Democrat",0.524646572419312,9240,187450,0.0492931448386236
1988,"TEXAS",14,111395,96042,209216,"GREG LAUGHLIN","MAC SWEENEY","Democrat",0.532440157540532,15353,207437,0.0740128328118899
1988,"TEXAS",19,53932,113068,167000,"GERALD MCCATHERN","LARRY COMBEST","Republican",0.677053892215569,-59136,167000,-0.354107784431138
1988,"TEXAS",20,94527,36801,133696,"HENRY B GONZALEZ","LEE TRAVINO","Democrat",0.707029380086166,57726,131328,0.439555921052632
1988,"TEXAS",22,58471,125733,186484,"WAYNE WALKER","TOM DELAY","Republican",0.674229424508269,-67262,184204,-0.365149508154003
1988,"TEXAS",23,116423,60559,180430,"ALBERT G BUSTAMANTE","JEROME L ""JERRY"" GONZALES","Democrat",0.645253006706202,55864,176982,0.315647918997412
1988,"TEXAS",25,113499,44043,159036,"MIKE ANDREWS","GEORGE LOEFFLER","Democrat",0.713668603335094,69456,157542,0.440872910081121
1988,"TEXAS",26,86490,194944,281446,"JO ANN REYES","DICK ARMEY","Republican",0.692651521073314,-108454,281434,-0.385362109766411
1988,"UTAH",1,87976,130893,218869,"GUNN MCKAY","JAMES V HANSEN","Republican",0.598042664790354,-42917,218869,-0.196085329580708
1988,"UTAH",2,112129,80212,195338,"WAYNE OWENS","RICHARD SNELGROVE","Democrat",0.574025535226121,31917,192341,0.165939659251018
1988,"UTAH",3,60018,129951,194461,"ROBERT W STRINGHAM","HOWARD C NIELSON","Republican",0.668262530790236,-69933,189969,-0.368128484121093
1988,"VERMONT",0,45330,98937,240131,"PAUL N POIRIER","PETER SMITH","Republican",0.412012609783826,-53607,144267,-0.37158185863711
1988,"VIRGINIA",1,49614,135937,185573,"JAMES S ELLENSON","HERBERT H BATEMAN","Republican",0.732525744585689,-86323,185551,-0.465225194151473
1988,"VIRGINIA",2,106666,62564,176208,"OWEN B PICKETT","JERRY R CURRY","Democrat",0.605341414691728,44102,169230,0.260603911835963
1988,"VIRGINIA",5,97242,78396,179442,"LEWIS F PAYNE JR","CHARLES R HAWKINS","Democrat",0.541913264453138,18846,175638,0.107300242544324
1988,"VIRGINIA",6,118369,66935,185312,"JIM OLIN","CHARLES E JUDD","Democrat",0.638755180452426,51434,185304,0.277565513966239
1988,"VIRGINIA",8,93561,154761,248400,"DAVID G BRICKLEY","STAN PARRIS","Republican",0.623031400966184,-61200,248322,-0.24645420059439
1988,"VIRGINIA",9,113309,65410,178727,"RICK BOUCHER","JOHN C BROWN","Democrat",0.633978078298187,47899,178719,0.268012914127765
1988,"VIRGINIA",10,88284,188550,276908,"ROBERT L WEINBERG","FRANK R WOLF","Republican",0.680912071879469,-100266,276834,-0.362188170528187
1988,"WASHINGTON",1,122646,152265,274911,"REESE LINDQUIST","JOHN MILLER","Republican",0.553870161615941,-29619,274911,-0.107740323231882
1988,"WASHINGTON",3,109412,108794,218206,"JOLENE UNSOELD","BILL WIGHT","Democrat",0.501416093049687,618,218206,0.00283218609937399
1988,"WASHINGTON",4,48850,142938,191788,"J RICHARD GOLOB","SID MORRISON","Republican",0.745291676225833,-94088,191788,-0.490583352451665
1988,"WASHINGTON",5,160654,49657,210311,"THOMAS S FOLEY","MARLYN A DERBY","Democrat",0.763887766212894,110997,210311,0.527775532425788
1988,"WASHINGTON",6,125904,60346,186250,"NORM DICKS","KEVIN P COOK","Democrat",0.675994630872483,65558,186250,0.351989261744966
1988,"WASHINGTON",7,173809,53902,227711,"JIM MCDERMOTT","ROBERT EDWARDS","Democrat",0.763287676045514,119907,227711,0.526575352091028
1988,"WASHINGTON",8,71920,174942,246862,"JIM KEAN","ROD CHANDLER","Republican",0.70866313972989,-103022,246862,-0.417326279459779
1988,"WEST VIRGINIA",1,119256,40732,159988,"ALAN B MOLLOHAN","HOWARD TUCK","Democrat",0.745405905442908,78524,159988,0.490811810885816
1988,"WEST VIRGINIA",3,120192,41478,161670,"ROBERT E WISE JR","PAUL W HART","Democrat",0.743440341436259,78714,161670,0.486880682872518
1988,"WEST VIRGINIA",4,78812,49753,128565,"NICK JOE RAHALL II","MARIANNE R BREWSTER","Democrat",0.613012872865865,29059,128565,0.226025745731731
1988,"WISCONSIN",1,158552,49620,208176,"LES ASPIN","BERNARD J WEAVER","Democrat",0.761624779033126,108932,208172,0.523278827123725
1988,"WISCONSIN",2,151501,107457,258977,"ROBERT W KASTENMEIER","ANN HANEY","Democrat",0.584997895566016,44044,258958,0.170081634859707
1988,"WISCONSIN",3,72935,157513,230467,"KARL KRUEGER","STEVEN C GUNDERSON","Republican",0.683451426885411,-84578,230448,-0.36701555231549
1988,"WISCONSIN",5,140518,78307,219179,"JIM MOODY","HELEN I BARNHILL","Democrat",0.641110690348984,62211,218825,0.284295670055981
1988,"WISCONSIN",6,57552,165923,223495,"JOSEPH GARRETT","THOMAS E PETRI","Republican",0.742401396004385,-108371,223475,-0.484935675131446
1988,"WISCONSIN",7,142197,86077,230179,"DAVID R OBEY","KEVIN J HERMENING","Democrat",0.617767042171527,56120,228274,0.245844905683521
1988,"WISCONSIN",8,72708,167275,240013,"ROBERT A BARON","TOBY ROTH","Republican",0.696941415673318,-94567,239983,-0.394057079043099
1988,"WISCONSIN",9,62003,185093,247104,"THOMAS J HICKEY","F JAMES SENSENBRENNER JR","Republican",0.749048983423983,-123090,247096,-0.498146469388416
1988,"WYOMING",0,56527,118350,177651,"BRYAN SHARRATT","DICK CHENEY","Republican",0.666193829474644,-61823,174877,-0.353522761712518
1990,"ALABAMA",2,83243,87649,170911,"FAYE BAGGIANO","WILLIAM L DICKINSON","Republican",0.512834165150283,-4406,170892,-0.0257823654705896
1990,"ALABAMA",3,101923,36317,138242,"GLEN BROWDER","DON SLEDGE","Democrat",0.737279553247204,65606,138240,0.474580439814815
1990,"ALABAMA",5,113047,55326,168383,"BUD CRAMER","ALBERT MCDONALD","Democrat",0.671368249763931,57721,168373,0.342816247260547
1990,"ALABAMA",7,127490,53258,180794,"CLAUDE HARRIS","MICHAEL D BARKER","Democrat",0.705167206876334,74232,180748,0.410693341005156
1990,"ALASKA",0,91677,99003,191647,"JOHN S DEVENS","DON YOUNG","Republican",0.51659039797127,-7326,190680,-0.0384203901825047
1990,"ARIZONA",2,76549,39586,116179,"MORRIS K UDALL","JOSEPH SWEENEY","Democrat",0.65888843939094,36963,116135,0.318276144142593
1990,"ARIZONA",3,103018,134279,237297,"ROGER HARTSTONE","BOB STUMP","Republican",0.565868932182033,-31261,237297,-0.131737864364067
1990,"ARIZONA",4,89395,141843,231238,"MARK IVEY JR","JON L KYL","Republican",0.6134069659831,-52448,231238,-0.226813931966199
1990,"ARIZONA",5,75642,138975,214617,"CHUCK PHILLIPS","JIM KOLBE","Republican",0.647548889416961,-63333,214617,-0.295097778833923
1990,"ARKANSAS",1,101026,56071,157097,"BILL ALEXANDER","TERRY HAYES","Democrat",0.643080389822848,44955,157097,0.286160779645697
1990,"ARKANSAS",2,103471,67800,171271,"RAY THORNTON","JIM KEET","Democrat",0.604136135130874,35671,171271,0.208272270261749
1990,"ARKANSAS",3,54332,129876,184208,"DAN IVY","JOHN PAUL HAMMERSCHMIDT","Republican",0.705050812125423,-75544,184208,-0.410101624250847
1990,"ARKANSAS",4,110365,42130,152495,"BERYL ANTHONY JR","ROY ROOD","Democrat",0.72372864684088,68235,152495,0.44745729368176
1990,"CALIFORNIA",1,96468,99782,230261,"DOUGLAS H BOSCO","FRANK RIGGS","Republican",0.433343032471847,-3314,196250,-0.0168866242038217
1990,"CALIFORNIA",2,65333,133315,209401,"ERWIN E ""BILL"" RUSH","WALLY HERGER","Republican",0.636649299669056,-67982,198648,-0.342223430389433
1990,"CALIFORNIA",3,132143,76148,219088,"ROBERT T MATSUI","LOWELL PATRICK LANDOWSKI","Democrat",0.60315033228657,55995,208291,0.268830626383281
1990,"CALIFORNIA",4,115090,82738,210454,"VIC FAZIO","MARK BAUGHMAN","Democrat",0.546865348247123,32352,197828,0.16353600097054
1990,"CALIFORNIA",5,120633,35671,156304,"NANCY PELOSI","ALAN NICHOLS","Democrat",0.771784471286723,84962,156304,0.543568942573447
1990,"CALIFORNIA",6,137306,64402,201708,"BARBARA BOXER","BILL BOERUM","Democrat",0.680716679556587,72904,201708,0.361433359113173
1990,"CALIFORNIA",7,121080,79031,200111,"GEORGE MILLER","ROGER A PAYTON","Democrat",0.605064189374897,42049,200111,0.210128378749794
1990,"CALIFORNIA",8,119645,75544,195189,"RONALD V DELLUMS","BARBARA GALEWSKI","Democrat",0.612969993186091,44101,195189,0.225939986372183
1990,"CALIFORNIA",9,94739,67412,162151,"FORTNEY PETE STARK","VICTOR ROMERO","Democrat",0.584264050175454,27327,162151,0.168528100350907
1990,"CALIFORNIA",10,81875,48747,130637,"DON EDWARDS","MARK PATROSSO","Democrat",0.626736682563133,33128,130622,0.253617307957312
1990,"CALIFORNIA",11,105029,45818,159365,"TOM LANTOS","BILL QURAISHI","Democrat",0.659046842154802,59211,150847,0.392523550352344
1990,"CALIFORNIA",12,69270,125157,205698,"ROBERT PALMER","TOM CAMPBELL","Republican",0.608450252311641,-55887,194427,-0.287444645033869
1990,"CALIFORNIA",13,97286,59773,167646,"NORMAN Y MINETA","DAVID E SMITH","Democrat",0.580306121231643,37513,157059,0.238846548112493
1990,"CALIFORNIA",14,120742,128309,249051,"PATRICIA MALBERG","JOHN T DOOLITTLE","Republican",0.515191667570096,-7567,249051,-0.0303833351401922
1990,"CALIFORNIA",15,97147,49634,146781,"GARY CONDIT","CLIFF BURRIS","Democrat",0.661849966957576,47513,146781,0.323699933915153
1990,"CALIFORNIA",16,134236,39885,181002,"LEON E PANETTA","JERRY M REISS","Democrat",0.741627164340726,94351,174121,0.541870308578517
1990,"CALIFORNIA",17,82611,68848,151459,"CALVIN DOOLEY","CHARLES PASHAYAN JR","Democrat",0.545434738113945,13763,151459,0.0908694762278901
1990,"CALIFORNIA",19,76991,94599,173245,"ANITA PEREZ FERGUSON","ROBERT J LAGOMARSINO","Republican",0.546041732806142,-17608,171590,-0.102616702605047
1990,"CALIFORNIA",20,65101,112962,188925,"MICHAEL A THOMAS","WILLIAM M THOMAS","Republican",0.597919809448194,-47861,178063,-0.268786890033303
1990,"CALIFORNIA",21,68921,118326,202611,"RICHARD D FREIMAN","ELTON GALLEGLY","Republican",0.584005804225832,-49405,187247,-0.263849354061747
1990,"CALIFORNIA",22,61630,108634,180929,"DAVID BAYER","CARLOS J MOORHEAD","Republican",0.600423370493398,-47004,170264,-0.276065404313302
1990,"CALIFORNIA",23,103141,57118,167093,"ANTHONY C BEILENSON","JIM SALOMON","Democrat",0.617267030934869,46023,160259,0.287178879189312
1990,"CALIFORNIA",24,71562,26607,103875,"HENRY A WAXMAN","JOHN N COWLES","Democrat",0.688924187725632,44955,98169,0.457934785930385
1990,"CALIFORNIA",25,48120,17021,68717,"EDWARD R ROYBAL","STEVEN J RENSHAW","Democrat",0.700263399158869,31099,65141,0.477410540212769
1990,"CALIFORNIA",26,78031,44492,127791,"HOWARD L BERMAN","ROY DAHLSON","Democrat",0.610614206008248,33539,122523,0.273736359703892
1990,"CALIFORNIA",27,90857,58140,156098,"MEL LEVINE","DAVID BARRETT COHEN","Democrat",0.582051019231508,32717,148997,0.219581602314141
1990,"CALIFORNIA",28,69482,21245,95600,"JULIAN C DIXON","GEORGE Z ADAMS","Democrat",0.726799163179916,48237,90727,0.531671938893604
1990,"CALIFORNIA",29,51350,12054,64672,"MAXINE WATERS","BILL DEWITT","Democrat",0.794006679861455,39296,63404,0.619771623241436
1990,"CALIFORNIA",30,45456,28914,78083,"MATTHEW G MARTINEZ","REUBEN D FRANCO","Democrat",0.582149763712972,16542,74370,0.222428398547802
1990,"CALIFORNIA",31,56394,27593,83987,"MERVYN M DYMALLY","EUNICE N SATO","Democrat",0.671461059449677,28801,83987,0.342922118899353
1990,"CALIFORNIA",32,68268,42692,110960,"GLENN M ANDERSON","SANFORD W KAHN","Democrat",0.615248738284066,25576,110960,0.230497476568133
1990,"CALIFORNIA",33,49981,101336,159157,"GEORGIA HOUSTON WEBB","DAVID DREIER","Republican",0.63670463755914,-51355,151317,-0.33938685012259
1990,"CALIFORNIA",34,55646,36024,91670,"ESTEBAN EDWARD TORRES","JOHN EASTMAN","Democrat",0.60702519908367,19622,91670,0.214050398167339
1990,"CALIFORNIA",35,66100,121602,200722,"BARRY NORTON","JERRY LEWIS","Republican",0.605822979045645,-55502,187702,-0.295692107702635
1990,"CALIFORNIA",36,72409,64961,137370,"GEORGE E BROWN JR","BOB HAMMOCK","Democrat",0.527109266943292,7448,137370,0.0542185338865837
1990,"CALIFORNIA",37,103961,115469,232082,"RALPH WAITE","ALFRED A ""AL"" MCCANDLESS","Republican",0.497535353883541,-11508,219430,-0.0524449710613863
1990,"CALIFORNIA",38,43693,60561,104254,"BARBARA JACKSON","ROBERT K DORNAN","Republican",0.580898574635026,-16868,104254,-0.161797149270052
1990,"CALIFORNIA",39,53670,113849,174228,"FRANCIS X ""FRANK"" HOFFMAN","WILLIAM E DANNEMEYER","Republican",0.653448355029042,-60179,167519,-0.359236862684233
1990,"CALIFORNIA",40,68087,142299,210386,"EUGENE C GRATZ","C CHRISTOPHER COX","Republican",0.676371051305695,-74212,210386,-0.35274210261139
1990,"CALIFORNIA",41,93586,105723,214737,"DAN KRIPKE","BILL LOWERY","Republican",0.492337137987399,-12137,199309,-0.0608953935848356
1990,"CALIFORNIA",42,67189,109353,184286,"GUY C KIMBROUGH","DANA ROHRABACHER","Republican",0.593387452112477,-42164,176542,-0.238832685706517
1990,"CALIFORNIA",44,48712,50377,108711,"JIM BATES","RANDY ""DUKE"" CUNNINGHAM","Republican",0.463402967500989,-1665,99089,-0.0168030760225656
1990,"COLORADO",1,82176,46802,128978,"PATRICIA SCHROEDER","GLORIA GONZALES ROEMER","Democrat",0.637131913969824,35374,128978,0.274263827939649
1990,"COLORADO",2,105248,68226,173474,"DAVID E SKAGGS","JASON LEWIS","Democrat",0.60670763342057,37022,173474,0.21341526684114
1990,"COLORADO",3,124487,49961,177307,"BEN NIGHTHORSE CAMPBELL","BOB ELLIS","Democrat",0.702098619907844,74526,174448,0.427210400807117
1990,"COLORADO",4,75901,89285,165186,"RICHARD R ""DICK"" BOND","WAYNE ALLARD","Republican",0.540511907788796,-13384,165186,-0.0810238155775913
1990,"COLORADO",5,57776,127740,192277,"CAL JOHNSTON","JOEL HEFLEY","Republican",0.664354030903332,-69964,185516,-0.377131891588866
1990,"COLORADO",6,57961,105312,163273,"DON JARRETT","DAN SCHAEFER","Republican",0.645005604110906,-47351,163273,-0.290011208221813
1990,"CONNECTICUT",1,126566,50690,177256,"BARBARA B KENNELLY","JAMES P GARVEY","Democrat",0.714029426366385,75876,177256,0.428058852732771
1990,"CONNECTICUT",2,105085,70922,176015,"SAM GEJDENSON","JOHN M RAGSDALE","Democrat",0.597022980995938,34163,176007,0.194100234649758
1990,"CONNECTICUT",3,90772,83440,174212,"ROSA L DELAURO","THOMAS SCOTT","Democrat",0.521043326521709,7332,174212,0.0420866530434184
1990,"CONNECTICUT",4,32352,105682,138068,"AL SMITH","CHRISTOPHER SHAYS","Republican",0.765434423617348,-73330,138034,-0.531245924917049
1990,"CONNECTICUT",5,85803,93912,181608,"ANTHONY TOBY MOFFETT","GARY A FRANKS","Republican",0.517113783533765,-8109,179715,-0.0451214422836157
1990,"CONNECTICUT",6,48628,141105,189733,"PAUL KULAS","NANCY L JOHNSON","Republican",0.743702993153537,-92477,189733,-0.487405986307074
1990,"DELAWARE",0,116274,58037,177435,"THOMAS R CARPER","RALPH O WILLIAMS","Democrat",0.65530475948939,58237,174311,0.334098249680169
1990,"FLORIDA",1,88416,80851,169267,"EARL HUTTO","TERRY KETCHEL","Democrat",0.522346352212776,7565,169267,0.0446927044255525
1990,"FLORIDA",2,103032,77939,180971,"DOUGLAS ""PETE"" PETERSON","BILL GRANT","Democrat",0.569328787485288,25093,180971,0.138657574970575
1990,"FLORIDA",3,84280,31727,116007,"CHARLES E BENNETT","ROD SULLIVAN","Democrat",0.726507883144983,52553,116007,0.453015766289965
1990,"FLORIDA",4,95320,120895,216228,"REID HUGHES","CRAIG T JAMES","Republican",0.559108903564756,-25575,216215,-0.118285040353352
1990,"FLORIDA",5,63253,94453,157706,"BOB FLETCHER","BILL MCCOLLUM","Republican",0.598918240269869,-31200,157706,-0.197836480539739
1990,"FLORIDA",6,95421,138588,234029,"ART JOHNSON","CLIFF STEARNS","Republican",0.59218302005307,-43167,234009,-0.184467264079587
1990,"FLORIDA",7,99464,47765,147229,"SAM GIBBONS","CHARLES D PROUT","Democrat",0.675573426430934,51699,147229,0.351146852861868
1990,"FLORIDA",9,102503,142163,244666,"CHERYL DAVIS KNAPP","MICHAEL BILIRAKIS","Republican",0.581049267164216,-39660,244666,-0.162098534328431
1990,"FLORIDA",11,120991,111970,232961,"JIM BACCHUS","BILL TOLLEY","Democrat",0.519361609883199,9021,232961,0.0387232197663987
1990,"FLORIDA",14,156055,80249,236304,"HARRY JOHNSTON","SCOTT SHORE","Democrat",0.660399316135148,75806,236304,0.320798632270296
1990,"FLORIDA",17,79569,22029,101599,"WILLIAM LEHMAN","EARL RODNEY","Democrat",0.783167157157059,57540,101598,0.566349731293923
1990,"FLORIDA",18,36978,56364,93343,"BERNARD ""BERNIE"" ANSCHER","ILEANA ROS-LEHTINEN","Republican",0.603837459691675,-19386,93342,-0.207687857556084
1990,"FLORIDA",19,87696,53796,141492,"DANTE B FASCELL","BOB ALLEN","Democrat",0.619794758714274,33900,141492,0.239589517428547
1990,"GEORGIA",1,80515,32532,113047,"LINDSAY THOMAS","CHRIS MEREDITH","Democrat",0.712225888347325,47983,113047,0.424451776694649
1990,"GEORGIA",2,77910,28781,106691,"CHARLES HATCHER","JONATHAN PERRY WATERS","Democrat",0.730239664076633,49129,106691,0.460479328153265
1990,"GEORGIA",3,72961,42561,115522,"RICHARD RAY","PAUL BROUN","Democrat",0.631576669378993,30400,115522,0.263153338757985
1990,"GEORGIA",4,96526,87569,184095,"BEN JONES","JOHN LINDER","Democrat",0.524327113718461,8957,184095,0.0486542274369212
1990,"GEORGIA",5,86037,27781,113818,"JOHN LEWIS","J W TIBBS","Democrat",0.755917341720993,58256,113818,0.511834683441986
1990,"GEORGIA",6,77794,78768,156562,"DAVID WORLEY","NEWT GINGRICH","Republican",0.503110588776331,-974,156562,-0.00622117755266284
1990,"GEORGIA",7,95817,63588,159405,"GEORGE ""BUDDY"" DARDEN","AL BEVERLY","Democrat",0.601091559235909,32229,159405,0.202183118471817
1990,"GEORGIA",8,81344,36980,118324,"J ROY ROWLAND","ROBERT F ""BOB"" CUNNINGHAM","Democrat",0.687468307359454,44364,118324,0.374936614718907
1990,"GEORGIA",9,96197,76121,172318,"ED JENKINS","JOE HOFFMAN","Democrat",0.558252765236365,20076,172318,0.116505530472731
1990,"GEORGIA",10,89683,64184,153867,"DOUG BARNARD JR","SAM JONES","Democrat",0.582860522399215,25499,153867,0.16572104479843
1990,"HAWAII",1,97622,62982,162711,"NEIL ABERCROMBIE","MIKE LIU","Democrat",0.599971729016477,34640,160604,0.215685786157256
1990,"HAWAII",2,118155,54625,178288,"PATSY T MINK","ANDY POEPOE","Democrat",0.662719868976039,63530,172780,0.367693020025466
1990,"IDAHO",1,85054,75406,160460,"LARRY LAROCCO","C A ""SKIP"" SMYSER","Democrat",0.530063567244173,9648,160460,0.060127134488346
1990,"IDAHO",2,98008,56044,154052,"RICHARD H STALLINGS","SEAN MCDEVITT","Democrat",0.636200763378599,41964,154052,0.272401526757199
1990,"ILLINOIS",1,100890,6708,107598,"CHARLES A HAYES","BABETTE PEYTON","Democrat",0.937656833770144,94182,107598,0.875313667540289
1990,"ILLINOIS",2,80245,22350,102595,"GUS SAVAGE","WILLIAM T HESPEL","Democrat",0.782153126370681,57895,102595,0.564306252741362
1990,"ILLINOIS",3,110512,45299,155811,"MARTY RUSSO","CARL L KLEIN","Democrat",0.709269563766358,65213,155811,0.418539127532716
1990,"ILLINOIS",4,77290,53258,130548,"GEORGE E SANGMEISTER","MANNY HOFFMAN","Democrat",0.592042773539235,24032,130548,0.184085547078469
1990,"ILLINOIS",5,73805,34440,111246,"WILLIAM O LIPINSKI","DAVID J SHESTOKAS","Democrat",0.663439584344606,39365,108245,0.363665758233637
1990,"ILLINOIS",6,48155,96410,144565,"ROBERT J CASSIDY","HENRY J HYDE","Republican",0.666897243454501,-48255,144565,-0.333794486909003
1990,"ILLINOIS",7,80021,20099,100120,"CARDISS COLLINS","MICHAEL DOOLEY","Democrat",0.799250898921294,59922,100120,0.598501797842589
1990,"ILLINOIS",9,96557,39031,135588,"SIDNEY R YATES","HERBERT SOHN","Democrat",0.71213529220875,57526,135588,0.4242705844175
1990,"ILLINOIS",10,47286,104070,153599,"PEG MCNAMARA","JOHN EDWARD PORTER","Republican",0.677543473590323,-56784,151356,-0.375168476968207
1990,"ILLINOIS",11,82703,68850,154245,"FRANK ANNUNZIO","WALTER W DUDYCZ","Democrat",0.536179454763526,13853,151553,0.0914069665397584
1990,"ILLINOIS",13,60305,116048,176353,"STEVEN K THOMAS","HARRIS W FAWELL","Republican",0.658043809858636,-55743,176353,-0.316087619717272
1990,"ILLINOIS",14,55592,112383,167975,"DONALD J WESTPHAL","J DENNIS HASTERT","Republican",0.669045988986456,-56791,167975,-0.338091977972913
1990,"ILLINOIS",16,83061,69105,152166,"JOHN W COX JR","JOHN W HALLOCK JR","Democrat",0.545857813177714,13956,152166,0.0917156263554276
1990,"ILLINOIS",17,102062,51380,153442,"LANE EVANS","DAN LEE","Democrat",0.66515034996937,50682,153442,0.330300699938739
1990,"ILLINOIS",19,113958,55680,171888,"TERRY L BRUCE","ROBERT F KERANS","Democrat",0.662978218374756,58278,169638,0.343543309871609
1990,"ILLINOIS",20,130114,66433,196547,"RICHARD J DURBIN","PAUL JURGENS","Democrat",0.661999419986059,63681,196547,0.323998839972119
1990,"ILLINOIS",21,95208,48949,144157,"JERRY F COSTELLO","ROBERT H GAFFNER","Democrat",0.660446596419182,46259,144157,0.320893192838364
1990,"INDIANA",1,68920,35450,104370,"PETER J VISCLOSKY","WILLIAM BILL COSTAS","Democrat",0.660343010443614,33470,104370,0.320686020887228
1990,"INDIANA",2,93495,63980,157475,"PHILIP R SHARP","MIKE PENCE","Democrat",0.593713287823464,29515,157475,0.187426575646928
1990,"INDIANA",3,80740,77911,158651,"TIMOTHY J ROEMER","JOHN HILER","Democrat",0.508915796307619,2829,158651,0.0178315926152372
1990,"INDIANA",4,99347,64415,163762,"JILL L LONG","RICHARD WALTER HAWKS","Democrat",0.606654779497075,34932,163762,0.21330955899415
1990,"INDIANA",5,81373,71750,153123,"JIM JONTZ","JOHN ARTHUR JOHNSON","Democrat",0.531422451232016,9623,153123,0.0628449024640322
1990,"INDIANA",6,67024,116470,183494,"JAMES PHLIP FADELY","DAN BURTON","Republican",0.634734650724274,-49446,183494,-0.269469301448549
1990,"INDIANA",7,65248,88598,153846,"JOHN WM RILEY SR","JOHN T MYERS","Republican",0.575887575887576,-23350,153846,-0.151775151775152
1990,"INDIANA",8,97465,80645,178110,"FRANK MCCLOSKEY","RICHARD E MOURDOCK","Democrat",0.547218011341306,16820,178110,0.0944360226826119
1990,"INDIANA",9,107526,48325,155851,"LEE H HAMILTON","FLOYD COATES","Democrat",0.689928200653188,59201,155851,0.379856401306376
1990,"INDIANA",10,69362,35049,104411,"ANDREW JACOBS JR","JANOS HORVATH","Democrat",0.664316978096178,34313,104411,0.328633956192355
1990,"IOWA",2,81008,82650,166106,"ERIC TABOR","JIM NUSSLE","Republican",0.497573838392352,-1642,163658,-0.0100331178433074
1990,"IOWA",5,47022,99978,147012,"ROD POWELL","JIM LIGHTFOOT","Republican",0.680066933311566,-52956,147000,-0.360244897959184
1990,"IOWA",6,44063,112333,156459,"MIKE D EARLL","FRED GRANDY","Republican",0.717970842201471,-68270,156396,-0.43652011560398
1990,"KANSAS",1,61396,102974,164388,"DUANE WEST","PAT ROBERTS","Republican",0.626408253643818,-41578,164370,-0.252953702013749
1990,"KANSAS",2,99093,58643,157745,"JIM SLATTERY","SCOTT MORGAN","Democrat",0.628184728517544,40450,157736,0.256441142161586
1990,"KANSAS",3,58923,88725,147726,"LEROY JONES","JAN MEYERS","Republican",0.60060517444458,-29802,147648,-0.201844928478544
1990,"KANSAS",4,112015,46283,158316,"DAN GLICKMAN","ROGER M GRUND SR","Democrat",0.707540614972586,65732,158298,0.415242138245587
1990,"KANSAS",5,62244,90555,152823,"GEORGE D WINGERT","DICK NICHOLS","Republican",0.592548242083979,-28311,152799,-0.185282626195198
1990,"KENTUCKY",2,77057,39624,116681,"WILLIAM H NATCHER","MARTIN TORI","Democrat",0.660407435657905,37433,116681,0.32081487131581
1990,"KENTUCKY",3,84750,55188,139938,"ROMANO L MAZZOLI","AL BROWN","Democrat",0.605625348368563,29562,139938,0.211250696737126
1990,"KENTUCKY",4,44979,101680,146659,"GALEN MARTIN","JIM BUNNING","Republican",0.693308968423349,-56701,146659,-0.386617936846699
1990,"KENTUCKY",7,61330,59377,120707,"CARL C PERKINS","WILLIAM T ""WILL"" SCOTT","Democrat",0.5080898373748,1953,120707,0.0161796747496003
1990,"MAINE",1,167623,110836,278872,"THOMAS H ANDREWS","DAVID F EMERY","Democrat",0.601075045182019,56787,278459,0.203933074528027
1990,"MAINE",2,116798,121704,238522,"PATRICK K MCGOWAN","OLYMPIA J SNOWE","Republican",0.510242241805787,-4906,238502,-0.0205700581127202
1990,"MARYLAND",1,67518,88920,156438,"ROY DYSON","WAYNE T GILCHREST","Republican",0.568404096191462,-21402,156438,-0.136808192382925
1990,"MARYLAND",2,39785,115398,155183,"RONALD P BOWERS","HELEN DELICH BENTLEY","Republican",0.743625268231701,-75613,155183,-0.487250536463401
1990,"MARYLAND",3,82545,35841,118386,"BENJAMIN L CARDIN","HARWOOD NICHOLS","Democrat",0.697253053570524,46704,118386,0.394506107141047
1990,"MARYLAND",4,85601,59846,145447,"C THOMAS MCMILLEN","ROBERT P DUCKWORTH","Democrat",0.588537405377904,25755,145447,0.177074810755808
1990,"MARYLAND",5,84747,20314,105061,"STENY H HOYER","LEE F BREUER","Democrat",0.806645662995783,64433,105061,0.613291325991567
1990,"MARYLAND",6,106502,56479,162981,"BEVERLY B BYRON","CHRISTOPHER P FIOTES JR","Democrat",0.653462673563176,50023,162981,0.306925347126352
1990,"MARYLAND",7,59628,10529,70160,"KWEISI MFUME","KENNETH KONDNER","Democrat",0.849885974914481,49099,70157,0.69984463417763
1990,"MARYLAND",8,39343,130059,176887,"JAMES WALKER JR","CONSTANCE A MORELLA","Republican",0.735266017287873,-90716,169402,-0.535507254932055
1990,"MASSACHUSETTS",1,43611,150748,204892,"JOHN R ARDEN","SILVIO O CONTE","Republican",0.735743708880776,-107137,194359,-0.551232513030012
1990,"MASSACHUSETTS",4,143473,75454,229894,"BARNEY FRANK","JOHN R SOTO","Democrat",0.624083273160674,68019,218927,0.310692605297656
1990,"MASSACHUSETTS",5,110232,101017,221140,"CHESTER G ATKINS","JOHN F MACGOVERN","Democrat",0.498471556480058,9215,211249,0.0436215082674948
1990,"MASSACHUSETTS",6,149284,80177,244937,"NICHOLAS MAVROULES","EDGAR L KELLEY","Democrat",0.609479172195299,69107,229461,0.301171005094548
1990,"MASSACHUSETTS",8,125479,39310,186407,"JOSEPH P KENNEDY II","GLENN W FISCUS","Democrat",0.673145321795855,86169,164789,0.522905048273853
1990,"MASSACHUSETTS",10,137805,120217,265838,"GERRY E STUDDS","JON L BRYAN","Democrat",0.518379614652533,17588,258022,0.0681647301392904
1990,"MICHIGAN",1,76556,7298,85756,"JOHN CONYERS JR","RAY SHOULDERS","Democrat",0.892718876813284,69258,83854,0.825935554654519
1990,"MICHIGAN",2,49678,95962,149766,"ELMER WHITE","CARL D PURSELL","Republican",0.640746230786694,-46284,145640,-0.31779730843175
1990,"MICHIGAN",3,82376,60007,142390,"HOWARD WOLPE","BRAD HASKINS","Democrat",0.57852377273685,22369,142383,0.157104429601849
1990,"MICHIGAN",4,55449,75850,131302,"JOANNE MCFARLAND","FREDERICK S UPTON","Republican",0.57767589221794,-20401,131299,-0.155378182621345
1990,"MICHIGAN",5,41170,126308,167498,"THOMAS TRZYBINSKI","PAUL B HENRY","Republican",0.754086615959594,-85138,167478,-0.508353335960544
1990,"MICHIGAN",7,90307,41759,132068,"DALE E KILDEE","DAVID J MORRILL","Democrat",0.683791683072357,48548,132066,0.367604076749504
1990,"MICHIGAN",8,98903,45259,144165,"BOB TRAXLER","JAMES WHITE","Democrat",0.686040301043943,53644,144162,0.372109154978427
1990,"MICHIGAN",9,73604,89078,162694,"GERALDINE GREENE","GUY VANDER JAGT","Republican",0.547518654652292,-15474,162682,-0.0951180831315081
1990,"MICHIGAN",10,50923,99952,153716,"JOAN LOUISE DENNISON","DAVE CAMP","Republican",0.650238101433813,-49029,150875,-0.324964374482187
1990,"MICHIGAN",11,59759,94555,154316,"MARCIA GOULD","ROBERT W DAVIS","Republican",0.612736203634101,-34796,154314,-0.225488290109776
1990,"MICHIGAN",12,98232,51119,151825,"DAVID E BONIOR","JIM DINGEMAN","Democrat",0.647008068499918,47113,149351,0.315451520244257
1990,"MICHIGAN",13,54345,11203,67824,"BARBARA-ROSE COLLINS","CARL R EDWARDS SR","Democrat",0.801265038924275,43142,65548,0.658174162445841
1990,"MICHIGAN",14,78506,40499,123421,"DENNIS M HERTEL","KENNETH C MCNEALY","Democrat",0.636083000461834,38007,119005,0.319373135582539
1990,"MICHIGAN",15,68742,41092,112335,"WILLIAM D FORD","BURL C ADKINS","Democrat",0.611937508345573,27650,109834,0.251743540251653
1990,"MICHIGAN",16,88962,42629,133614,"JOHN D DINGELL","FRANK BEAUMONT","Democrat",0.665813462661098,46333,131591,0.352098547773024
1990,"MICHIGAN",17,92205,40100,132314,"SANDER M LEVIN","BLAINE L LANKFORD","Democrat",0.696865033178651,52105,132305,0.393824874343373
1990,"MICHIGAN",18,64185,126629,190834,"WALTER O BRIGGS IV","WM S BROOMFIELD","Republican",0.663555760503893,-62444,190814,-0.327250621023615
1990,"MISSISSIPPI",1,43668,23650,67318,"JAMIE L WHITTEN","BILL BOWLIN","Democrat",0.648682373213702,20018,67318,0.297364746427404
1990,"MISSISSIPPI",2,59393,11224,70617,"MIKE ESPY","DOROTHY BENFORD","Democrat",0.841058102156705,48169,70617,0.682116204313409
1990,"MISSISSIPPI",4,57137,13754,70891,"MIKE PARKER","JERRY ""REV"" PARKS","Democrat",0.805983834337222,43383,70891,0.611967668674444
1990,"MISSISSIPPI",5,89926,20588,110514,"GENE TAYLOR","SHEILA A SMITH","Democrat",0.813706860669236,69338,110514,0.627413721338473
1990,"MISSOURI",1,62550,40160,102710,"WILLIAM ""BILL"" CLAY","WAYNE G PIOTROWSKI","Democrat",0.608996202901373,22390,102710,0.217992405802746
1990,"MISSOURI",2,94308,94260,188568,"JOAN KELLY HORN","JACK BUECHNER","Democrat",0.500127275041364,48,188568,0.000254550082728777
1990,"MISSOURI",3,88950,67659,156609,"RICHARD A GEPHARDT","MALCOLM L ""MACK"" HOLEKAMP","Democrat",0.567975020592686,21291,156609,0.135950041185372
1990,"MISSOURI",4,105527,65095,170622,"IKE SKELTON","DAVID EYERLY","Democrat",0.618484134519581,40432,170622,0.236968269039163
1990,"MISSOURI",5,71890,43897,115787,"ALAN WHEAT","ROBERT H GARDNER","Democrat",0.620881446103621,27993,115787,0.241762892207243
1990,"MISSOURI",6,73093,78956,152049,"BOB MCCLURE","E THOMAS COLEMAN","Republican",0.519279968957376,-5863,152049,-0.0385599379147512
1990,"MISSOURI",7,76725,83609,160334,"THOMAS PATRICK ""PAT"" DEATON","MEL HANCOCK","Republican",0.521467686205047,-6884,160334,-0.0429353724100939
1990,"MISSOURI",8,60751,81452,142203,"RUSS CARNAHAN","BILL EMERSON","Republican",0.572786790714683,-20701,142203,-0.145573581429365
1990,"MISSOURI",9,94156,69514,163670,"HAROLD L VOLKMER","DON CURTIS","Democrat",0.575279525875237,24642,163670,0.150559051750474
1990,"MONTANA",1,100409,63837,164246,"PAT WILLIAMS","BRAD JOHNSON","Democrat",0.611333000499251,36572,164246,0.222666000998502
1990,"MONTANA",2,56739,96449,153188,"DON BURRIS","RON MARLENEE","Republican",0.629611980050657,-39710,153188,-0.259223960101313
1990,"NEBRASKA",1,70587,129654,200381,"LARRY HALL","DOUG BEREUTER","Republican",0.647037393764878,-59067,200241,-0.294979549642681
1990,"NEBRASKA",2,111903,80845,193421,"PETER HOAGLAND","ALLY MILDER","Democrat",0.578546279876539,31058,192748,0.161132670637309
1990,"NEBRASKA",3,94234,98607,192944,"SANDRA K SCOFIELD","BILL BARRETT","Republican",0.511065386847997,-4373,192841,-0.0226767129396757
1990,"NEVADA",1,84650,47377,137852,"JAMES H BILBRAY","BOB DICKINSON","Democrat",0.614064358877637,37273,132027,0.282313466184947
1990,"NEVADA",2,59581,103508,175209,"JANE WISDOM","BARBARA F VUCANOVICH","Republican",0.590768739048793,-43927,163089,-0.269343732563202
1990,"NEW HAMPSHIRE",1,66176,81684,148368,"JOSEPH F KEEFE","""BILL"" ZELIFF","Republican",0.550549983824005,-15508,147860,-0.104882997430001
1990,"NEW HAMPSHIRE",2,74866,67225,142263,"""DICK"" SWETT","CHUCK DOUGLAS","Democrat",0.526250676563829,7641,142091,0.0537753974565595
1990,"NEW JERSEY",1,72415,57299,133794,"ROBERT E ANDREWS","DANIEL J MANGINI","Democrat",0.541242507137839,15116,129714,0.116533296328847
1990,"NEW JERSEY",3,77866,73696,158643,"FRANK PALLONE JR","PAUL A KAPALKO","Democrat",0.490825312178917,4170,151562,0.0275134928280176
1990,"NEW JERSEY",4,54961,99920,159299,"MARK SETARO","CHRISTOPHER H SMITH","Republican",0.627248130873389,-44959,154881,-0.290280925355596
1990,"NEW JERSEY",5,35010,118101,156109,"LAWRENCE WAYNE OLSEN","MARGE ROUKEMA","Republican",0.756529091852488,-83091,153111,-0.542684718929404
1990,"NEW JERSEY",6,63745,58147,126022,"BERNARD J DWYER","PAUL ""DANIELS"" DANIELCZYK","Democrat",0.505824379870181,5598,121892,0.0459259016178256
1990,"NEW JERSEY",7,31099,100066,134072,"BRUCE H BERGEN","MATTHEW J RINALDO","Republican",0.746360164687631,-68967,131165,-0.52580337742538
1990,"NEW JERSEY",9,82535,69658,154766,"ROBERT G TORRICELLI","PETER J RUSSO","Democrat",0.533288965276611,12877,152193,0.0846096732438417
1990,"NEW JERSEY",10,42106,8954,51703,"DONALD M PAYNE","HOWARD E BERKELEY","Democrat",0.814382144169584,33152,51060,0.649275362318841
1990,"NEW JERSEY",11,47414,92681,143686,"MICHAEL GORDON","DEAN A GALLO","Republican",0.645024567459599,-45267,140095,-0.323116456690103
1990,"NEW JERSEY",12,52256,107851,168390,"MARGUERITE CHANDLER","DICK ZIMMER","Republican",0.640483401627175,-55595,160107,-0.34723653556684
1990,"NEW JERSEY",13,67587,99688,171406,"JOHN H ADLER","JIM SAXTON","Republican",0.581589909338063,-32101,167275,-0.19190554476162
1990,"NEW JERSEY",14,56455,24870,85276,"FRANK J GUARINI","FRED J THEEMLING JR","Democrat",0.66202683052676,31585,81325,0.388379956962804
1990,"NEW MEXICO",1,41306,97375,138681,"REBECCA VIGIL-GIRON","STEVEN SCHIFF","Republican",0.702150979586245,-56069,138681,-0.404301959172489
1990,"NEW MEXICO",3,104225,35751,139976,"BILL RICHARDSON","PHIL T ARCHULETTA","Democrat",0.744591930045151,68474,139976,0.489183860090301
1990,"NEW YORK",1,72937,46380,143180,"GEORGE J HOCHBRUECKNER","FRANCIS W CREIGHTON","Democrat",0.509407738510965,26557,119317,0.222575156934888
1990,"NEW YORK",2,56722,31808,110005,"THOMAS J DOWNEY","JOHN W BUGLER","Democrat",0.515631107676924,24914,88530,0.281418728114763
1990,"NEW YORK",3,70118,45699,145444,"ROBERT J MRAZEK","ROBERT PREVIDI","Democrat",0.482096201974643,24419,115817,0.210841240923181
1990,"NEW YORK",4,41308,63838,140304,"FRANCIS T GOBAN","NORMAN F LENT","Republican",0.454997719238226,-22530,105146,-0.214273486390352
1990,"NEW YORK",5,51738,59568,141927,"MARK S EPSTEIN","RAYMOND J MCGRATH","Republican",0.4197087234987,-7830,111306,-0.0703466120424775
1990,"NEW YORK",6,42499,13224,83558,"FLOYD H FLAKE","WILLIAM SAMPOL","Democrat",0.508616769190263,29275,55723,0.525366545232669
1990,"NEW YORK",8,53552,14384,101494,"JAMES H SCHEUER","GUSTAVE REIFENKUGEL","Democrat",0.527637101700593,39168,67936,0.5765426283561
1990,"NEW YORK",9,35177,13330,74625,"THOMAS J MANTON","ANN PFOSER DARBY","Democrat",0.471383584589615,21847,48507,0.450388603706681
1990,"NEW YORK",10,58673,9199,91828,"CHARLES E SCHUMER","PATRICK J KINSELLA","Democrat",0.638944548503724,49474,67872,0.728930928807166
1990,"NEW YORK",13,45412,7954,76911,"STEPHEN J SOLARZ","EDWIN RAMOS","Democrat",0.59044870044597,37458,53366,0.701907581606266
1990,"NEW YORK",14,32738,44271,116017,"ANTHONY J POCCHIA","SUSAN MOLINARI","Republican",0.381590628959549,-11533,77009,-0.149761716163046
1990,"NEW YORK",15,30519,48505,107522,"FRANCES L REITER","BILL GREEN","Republican",0.451116980710924,-17986,79024,-0.227601741243167
1990,"NEW YORK",16,50421,3440,76109,"CHARLES B RANGEL","CHARLES B RANGEL","Democrat",0.662484068901181,46981,53861,0.872263790126437
1990,"NEW YORK",17,73450,15219,115940,"TED WEISS","WILLIAM W KOEPPEL","Democrat",0.63351733655339,58231,88669,0.656723319311146
1990,"NEW YORK",18,36652,1189,56826,"JOSE E SERRANO","JOSEPH CHIAVARO","Democrat",0.644986449864499,35463,37841,0.937158108929468
1990,"NEW YORK",19,43928,17135,95545,"ELIOT L ENGEL","WILLIAM J GOULDMAN","Democrat",0.459762415615678,26793,61063,0.438776345741284
1990,"NEW YORK",20,82203,35575,144627,"NITA M LOWEY","GLENN D BELLITTO","Democrat",0.568379348254475,46628,117778,0.395897366231384
1990,"NEW YORK",21,34128,79928,153706,"RICHARD L BARBUTO","HAMILTON FISH JR","Republican",0.520005725215671,-45800,114056,-0.40155712983096
1990,"NEW YORK",22,37034,95495,160267,"JOHN G DOW","BENJAMIN A GILMAN","Republican",0.595849426269912,-58461,132529,-0.44111854763863
1990,"NEW YORK",23,102492,65760,195130,"MICHAEL R MCNULTY","MARGARET B BUHRMASTER","Democrat",0.52524983344437,36732,168252,0.218315384066757
1990,"NEW YORK",24,56671,92512,190607,"BOB LAWRENCE","GERALD B H SOLOMON","Republican",0.485354682671675,-35841,149183,-0.240248553789641
1990,"NEW YORK",27,50043,83442,162604,"PEGGY L MURRAY","JAMES T WALSH","Republican",0.513160807852205,-33399,133485,-0.250207888526801
1990,"NEW YORK",28,97815,53077,172046,"MATTHEW F MCHUGH","SEYMOUR KRIEGER","Democrat",0.568539809120816,44738,150892,0.296490204914773
1990,"NEW YORK",29,34835,89105,159615,"ALTON F EBER","FRANK HORTON","Republican",0.558249537950694,-54270,123940,-0.437873164434404
1990,"NEW YORK",30,97280,49017,173809,"LOUISE MCINTOSH SLAUGHTER","JOHN M REGAN JR","Democrat",0.559694837436496,48263,146297,0.329897400493517
1990,"NEW YORK",31,65428,70898,169341,"KEVIN P GAUGHAN","BILL PAXON","Republican",0.418670020845513,-5470,136326,-0.0401244076698502
1990,"NEW YORK",32,65652,39053,136938,"JOHN J LAFALCE","MICHAEL T WARING","Democrat",0.47942864654077,26599,104705,0.254037534024163
1990,"NEW YORK",33,81609,18181,125833,"HENRY J NOWAK","THOMAS K KEPFER","Democrat",0.648550062384271,63428,99790,0.635614791061229
1990,"NEW YORK",34,37421,77128,141782,"JOSEPH P LEAHEY","AMO HOUGHTON","Republican",0.54399006926126,-39707,114549,-0.346637683436783
1990,"NORTH CAROLINA",1,105832,57526,163358,"WALTER B JONES","HOWARD D MOYE","Democrat",0.647853181356285,48306,163358,0.29570636271257
1990,"NORTH CAROLINA",2,130979,44263,175242,"TIM VALENTINE","HAL C SHARPE","Democrat",0.747417856449938,86716,175242,0.494835712899876
1990,"NORTH CAROLINA",3,83930,57605,141535,"H MARTIN LANCASTER","DON DAVIS","Democrat",0.592998198325502,26325,141535,0.185996396651005
1990,"NORTH CAROLINA",4,139396,100661,240057,"DAVID E PRICE","JOHN CARRINGTON","Democrat",0.580678755462244,38735,240057,0.161357510924489
1990,"NORTH CAROLINA",5,113814,78747,192561,"STEPHEN L NEAL","KEN BELL","Democrat",0.591054263324349,35067,192561,0.182108526648698
1990,"NORTH CAROLINA",6,62913,125392,188305,"HELEN R ALLEGRONE","HOWARD COBLE","Republican",0.665898409495234,-62479,188305,-0.331796818990468
1990,"NORTH CAROLINA",7,94946,49681,144627,"CHARLIE ROSE","ROBERT C ANDERSON","Democrat",0.656488760743153,45265,144627,0.312977521486306
1990,"NORTH CAROLINA",8,98700,80852,179552,"W G ""BILL"" HEFNER","TED BLANTON","Democrat",0.549701479237213,17848,179552,0.0994029584744252
1990,"NORTH CAROLINA",9,80802,131936,212738,"DAVID P MCKNIGHT","J ALEX MCMILLAN","Republican",0.620180691742895,-51134,212738,-0.24036138348579
1990,"NORTH CAROLINA",10,65710,106400,172110,"DANIEL R GREEN JR","CASS BALLENGER","Republican",0.618209284759747,-40690,172110,-0.236418569519493
1990,"NORTH CAROLINA",11,99318,101991,201309,"JAMES MCCLURE CLARKE","CHARLES H TAYLOR","Republican",0.506639047434541,-2673,201309,-0.0132780948690819
1990,"NORTH DAKOTA",0,152530,81443,233979,"BYRON L DORGAN","EDWARD T SCHAFER","Democrat",0.651896110334688,71087,233973,0.303825655096956
1990,"OHIO",1,83932,80362,164294,"CHARLES LUKEN","J KENNETH BLACKWELL","Democrat",0.510864669434063,3570,164294,0.0217293388681267
1990,"OHIO",2,57345,103817,161162,"TYRONE K YATES","WILLIS D GRADISON JR","Republican",0.64417790794356,-46472,161162,-0.28835581588712
1990,"OHIO",4,64467,103897,168364,"THOMAS E BURKHART","MICHAEL G OXLEY","Republican",0.617097479271103,-39430,168364,-0.234194958542206
1990,"OHIO",5,41693,113615,165920,"P SCOTT MANGE","PAUL E GILLMOR","Republican",0.684757714561234,-71922,155308,-0.463092693228939
1990,"OHIO",6,47415,117220,164635,"RAY MITCHELL","BOB MCEWEN","Republican",0.71199927111489,-69805,164635,-0.423998542229781
1990,"OHIO",7,59349,97123,156472,"JACK SCHIRA","DAVID L HOBSON","Republican",0.62070530190705,-37774,156472,-0.241410603814101
1990,"OHIO",8,63584,99955,163539,"GREGORY V JOLIVETTE","JOHN A BOEHNER","Republican",0.611199774977223,-36371,163539,-0.222399549954445
1990,"OHIO",9,117681,33791,151472,"MARCY KAPTUR","JERRY D LAMMERS","Democrat",0.776915865638534,83890,151472,0.553831731277068
1990,"OHIO",10,61656,106009,167665,"JOHN M BUCHANAN","CLARENCE E MILLER","Republican",0.632266722333224,-44353,167665,-0.264533444666448
1990,"OHIO",11,111923,58372,170305,"DENNIS E ECKART","MARGARET R MUELLER","Democrat",0.65719150935087,53551,170295,0.314460201415191
1990,"OHIO",12,50784,130495,181279,"MIKE GELPI","JOHN R KASICH","Republican",0.719857236635242,-79711,181279,-0.439714473270484
1990,"OHIO",13,93431,60925,164862,"DONALD J PEASE","WILLIAM D NIELSEN","Democrat",0.566722470915068,32506,154356,0.210591101090984
1990,"OHIO",14,97875,66460,164335,"THOMAS C SAWYER","JEAN E BENDER","Democrat",0.595582194906745,31415,164335,0.191164389813491
1990,"OHIO",15,68510,99251,167919,"THOMAS V ERNEY","CHALMERS P WYLIE","Republican",0.591064739547044,-30741,167761,-0.183242827594018
1990,"OHIO",16,70516,101097,171613,"WARNER D MENDENHALL","RALPH REGULA","Republican",0.589098727951845,-30581,171613,-0.17819745590369
1990,"OHIO",17,133207,38199,171406,"JAMES A TRAFICANT JR","ROBERT R DEJULIO JR","Democrat",0.777143157182362,95008,171406,0.554286314364725
1990,"OHIO",18,120782,41823,162605,"DOUGLAS APPLEGATE","JOHN A HALES","Democrat",0.742793887026844,78959,162605,0.485587774053688
1990,"OHIO",19,132951,72315,205266,"EDWARD F FEIGHAN","SUSAN M LAWKO","Democrat",0.647701031831867,60636,205266,0.295402063663734
1990,"OHIO",20,109390,39749,149139,"MARY ROSE OAKER","BILL SMITH","Democrat",0.733476823634328,69641,149139,0.466953647268655
1990,"OHIO",21,103338,25906,129249,"LOUIS STOKES","FRANKLIN H ROSKI","Democrat",0.799526495369403,77432,129244,0.599114852527003
1990,"OKLAHOMA",1,59521,75618,135139,"KURT G GLASSCO","JAMES M INHOFE","Republican",0.559557196664175,-16097,135139,-0.119114393328351
1990,"OKLAHOMA",2,90820,57331,148151,"MIKE SYNAR","TERRY M GORHAM","Democrat",0.613023199303413,33489,148151,0.226046398606827
1990,"OKLAHOMA",3,107641,26261,133902,"BILL K BREWSTER","PATRICK K MILLER","Democrat",0.803878956251587,81380,133902,0.607757912503174
1990,"OKLAHOMA",4,100879,36232,137111,"DAVE MCCURDY","HOWARD BELL","Democrat",0.735746949551823,64647,137111,0.471493899103646
1990,"OKLAHOMA",5,50086,114608,164694,"BRYCE BAGGETT","MICKEY EDWARDS","Republican",0.69588448880955,-64522,164694,-0.3917689776191
1990,"OKLAHOMA",6,110100,27540,137640,"GLENN ENGLISH","ROBERT BURNS","Democrat",0.799912816041848,82560,137640,0.599825632083697
1990,"OREGON",1,150292,72382,238259,"LES AUCOIN","EARL MOLANDER","Democrat",0.630792540890376,77910,222674,0.349883686465416
1990,"OREGON",2,60131,127998,188185,"JIM SMILEY","ROBERT F ""BOB"" SMITH","Republican",0.680171108217977,-67867,188129,-0.360747146904518
1990,"OREGON",3,169731,40216,210193,"RON WYDEN","PHIL MOONEY","Democrat",0.807500725523685,129515,209947,0.616893787479697
1990,"OREGON",5,124610,101650,226550,"MICHAEL J KOPETSKI","DENNY SMITH","Democrat",0.550033105274774,22960,226260,0.101476177848493
1990,"PENNSYLVANIA",1,73423,19018,92441,"THOMAS M FOGLIETTA","JAMES LOVE JACKSON","Democrat",0.794268776841445,54405,92441,0.58853755368289
1990,"PENNSYLVANIA",2,94584,8118,102702,"WILLIAM H GRAY III","DONALD BAKOVE","Democrat",0.920955774960565,86466,102702,0.841911549921131
1990,"PENNSYLVANIA",3,89908,59901,149809,"ROBERT A BORSKI","JOSEPH MARC MCCOLGAN","Democrat",0.600150858760155,30007,149809,0.200301717520309
1990,"PENNSYLVANIA",4,74114,58469,132583,"JOE KOLTER","GORDON R JOHNSTON","Democrat",0.559000776871846,15645,132583,0.118001553743693
1990,"PENNSYLVANIA",5,50597,75097,131489,"SAMUEL C STRETTON","RICHARD T SCHULZE","Republican",0.571127622842975,-24500,125694,-0.194917816283991
1990,"PENNSYLVANIA",6,74394,56093,130487,"GUS YATRON","JOHN F HICKS","Democrat",0.570125759654218,18301,130487,0.140251519308437
1990,"PENNSYLVANIA",7,56292,105868,162160,"JOHN INNELLI","CURT WELDON","Republican",0.652861371484953,-49576,162160,-0.305722742969906
1990,"PENNSYLVANIA",8,85015,65100,150115,"PETER H KOSTMAYER","AUDRIE ZETTICK SCHALLER","Democrat",0.566332478433201,19915,150115,0.132664956866402
1990,"PENNSYLVANIA",12,80686,50007,130693,"JOHN P MURTHA","WILLEAM A CHOBY","Democrat",0.617370478908587,30679,130693,0.234740957817175
1990,"PENNSYLVANIA",13,58967,89577,148544,"BERNARD TOMKIN","LAWRENCE COUGHLIN","Republican",0.603033444635933,-30610,148544,-0.206066889271866
1990,"PENNSYLVANIA",14,77636,30497,108133,"WILLIAM J COYNE","RICHARD EDWARD CALIGIURI","Democrat",0.717967687939852,47139,108133,0.435935375879704
1990,"PENNSYLVANIA",15,50233,77178,127411,"RICHARD J ORLOSKI","DON RITTER","Republican",0.605740477666763,-26945,127411,-0.211480955333527
1990,"PENNSYLVANIA",16,43849,85596,129445,"ERNEST ERIC GUYLL","ROBERT S WALKER","Republican",0.661253814361312,-41747,129445,-0.322507628722624
1990,"PENNSYLVANIA",18,80880,85697,166577,"DOUG WALGREN","RICK SANTORUM","Republican",0.514458778823007,-4817,166577,-0.0289175576460136
1990,"PENNSYLVANIA",20,82080,43054,125134,"JOSEPH M GAYDOS","ROBERT C LEE","Democrat",0.655936835712117,39026,125134,0.311873671424233
1990,"PENNSYLVANIA",22,78375,45509,123884,"AUSTIN J MURPHY","SUZANNE HAYDEN","Democrat",0.632648283878467,32866,123884,0.265296567756934
1990,"PENNSYLVANIA",23,53465,78189,131654,"DANIEL J SHANNON","WILLIAM F CLINGER JR","Republican",0.593897640785696,-24724,131654,-0.187795281571392
1990,"RHODE ISLAND",1,73131,89963,163094,"J SCOTT WOLF","RONALD K MACHTLEY","Republican",0.551602143549119,-16832,163094,-0.103204287098238
1990,"RHODE ISLAND",2,108818,74953,183771,"JOHN F REED","GERTRUDE M COXE","Democrat",0.592139129677697,33865,183771,0.184278259355393
1990,"SOUTH CAROLINA",1,42555,80839,123503,"EUGENE PLATT","ARTHUR RAVENEL JR","Republican",0.654550901597532,-38284,123394,-0.310258197319157
1990,"SOUTH CAROLINA",3,72561,52419,125050,"BUTLER DERRICK","RAY HASKETT","Democrat",0.580255897640944,20142,124980,0.161161785885742
1990,"SOUTH CAROLINA",4,81927,51338,133535,"ELIZABETH J PATTERSON","TERRY HASKINS","Democrat",0.613524544127008,30589,133265,0.229535136757588
1990,"SOUTH DAKOTA",0,173814,83484,257298,"TIM JOHNSON","DON FRANKENFELD","Democrat",0.675535760091411,90330,257298,0.351071520182823
1990,"TENNESSEE",3,49662,36855,93665,"MARILYN LLOYD","GRADY L RHODEN","Democrat",0.530208722575135,12807,86517,0.148028711120358
1990,"TENNESSEE",4,52101,22890,77276,"JIM COOPER","CLAIBORNE ""CLAY"" SANDERS","Democrat",0.674219680107666,29211,74991,0.389526743209185
1990,"TENNESSEE",6,60538,26424,90768,"BART GORDON","GREGORY COCHRAN","Democrat",0.666953111228627,34114,86962,0.392286285963984
1990,"TENNESSEE",7,40516,66141,106676,"KEN BLOODWORTH","DON SUNDQUIST","Republican",0.620017623457947,-25625,106657,-0.240256148213432
1990,"TENNESSEE",9,48629,25730,83657,"HAROLD E FORD","AARON C DAVIS","Democrat",0.58129026859677,22899,74359,0.307951962775185
1990,"TEXAS",1,89241,56954,146195,"JIM CHAPMAN","HAMP HODGES","Democrat",0.610424433120148,32287,146195,0.220848866240295
1990,"TEXAS",2,76974,61555,138529,"CHARLES WILSON","DONNA PETERSON","Democrat",0.55565260703535,15419,138529,0.1113052140707
1990,"TEXAS",5,65228,41307,109474,"JOHN BRYANT","JERRY RUCKER","Democrat",0.595830973564499,23921,106535,0.224536537288215
1990,"TEXAS",6,62344,125049,188130,"JOHN E WELCH","JOE BARTON","Republican",0.66469462605645,-62705,187393,-0.334617621789501
1990,"TEXAS",9,79786,58399,138185,"JACK BROOKS","MAURY MEYERS","Democrat",0.577385389152223,21387,138185,0.154770778304447
1990,"TEXAS",10,152784,73766,235496,"J J PICKLE","DAVID BEILHARZ","Democrat",0.648775350749057,79018,226550,0.34878834694328
1990,"TEXAS",11,73810,64269,138079,"CHET EDWARDS","HUGH D SHINE","Democrat",0.53454906249321,9541,138079,0.0690981249864208
1990,"TEXAS",12,98026,39438,137464,"PETE GEREN","MIKE MCGINN","Democrat",0.713103066984811,58588,137464,0.426206133969621
1990,"TEXAS",13,81815,63045,144860,"BILL SARPALIUS","DICK WATERFIELD","Democrat",0.564786690597819,18770,144860,0.129573381195637
1990,"TEXAS",14,89251,75098,164349,"GREG LAUGHLIN","JOE DIAL","Democrat",0.543057761227631,14153,164349,0.0861155224552629
1990,"TEXAS",21,48585,144570,193155,"KIRBY J ROBERTS","LAMAR S SMITH","Republican",0.748466257668712,-95985,193155,-0.496932515337423
1990,"TEXAS",22,37721,93425,131146,"BRUCE DIRECTOR","TOM DELAY","Republican",0.712373995394446,-55704,131146,-0.424747990788892
1990,"TEXAS",23,71052,40856,111908,"ALBERT G BUSTAMANTE","JEROME L ""JERRY"" GONZALES","Democrat",0.634914393966472,30196,111908,0.269828787932945
1990,"TEXAS",26,62158,147856,210014,"JOHN WAYNE CATON","RICHARD K ARMEY","Republican",0.704029255192511,-85698,210014,-0.408058510385022
1990,"UTAH",1,69491,82746,158666,"KENLEY BRUNSDALE","JAMES V HANSEN","Republican",0.52151059458233,-13255,152237,-0.087068189730486
1990,"UTAH",2,85167,58869,147871,"WAYNE OWENS","GENEVIEVE ATWOOD","Democrat",0.575954717287365,26298,144036,0.18257935516121
1990,"UTAH",3,79163,49452,135676,"BILL ORTON","KARL SNOW","Democrat",0.583470916005778,29711,128615,0.231007269758582
1990,"VERMONT",0,6315,82938,209856,"DOLORES SANDOVAL","PETER SMITH","Republican",0.395213860933211,-76623,89253,-0.858492151524318
1990,"VIRGINIA",1,69194,72000,141293,"ANDREW H ""ANDY"" FOX","HERBERT H BATEMAN","Republican",0.509579384682893,-2806,141194,-0.019873365723756
1990,"VIRGINIA",3,36253,77125,118154,"JAMES A ""JAY"" STARKE JR","THOMAS J BLILEY JR","Republican",0.65274980110703,-40872,113378,-0.360493217379033
1990,"VIRGINIA",7,58684,81688,140620,"DAVID M SMITH","D FRENCH SLAUGHTER JR","Republican",0.580913099132414,-23004,140372,-0.163878836235147
1990,"VIRGINIA",8,88475,76367,171121,"JAMES P MORAN","STAN PARRIS","Democrat",0.517031807902011,12108,164842,0.0734521541840065
1990,"VIRGINIA",10,57249,103761,168825,"N MACKENZIE CANTER III","FRANK R WOLF","Republican",0.61460684140382,-46512,161010,-0.288876467300168
1990,"WASHINGTON",1,92447,100339,192786,"CYNTHIA SULLIVAN","JOHN MILLER","Republican",0.520468291265963,-7892,192786,-0.0409365825319266
1990,"WASHINGTON",2,92837,75669,183671,"AL SWIFT","DOUG SMITH","Democrat",0.505452684419424,17168,168506,0.101883612452969
1990,"WASHINGTON",3,95645,82269,177914,"JOLENE UNSOELD","BOB WILLIAMS","Democrat",0.537591195746259,13376,177914,0.0751823914925189
1990,"WASHINGTON",4,44241,106545,150786,"OLE H HOUGEN","SID MORRISON","Republican",0.706597429469579,-62304,150786,-0.413194858939159
1990,"WASHINGTON",5,110234,49965,160199,"THOMAS S FOLEY","MARLYN DERBY","Democrat",0.688106667332505,60269,160199,0.37621333466501
1990,"WASHINGTON",6,79079,49786,128865,"NORMAN D DICKS","NORBERT ""BERT"" MUELLER","Democrat",0.613657703798549,29293,128865,0.227315407597098
1990,"WASHINGTON",7,106761,35511,147642,"JIM MCDERMOTT","LARRY PENBERTHY","Democrat",0.723107245905637,71250,142272,0.500801282051282
1990,"WASHINGTON",8,75031,96323,171354,"DAVID GILES","ROD CHANDLER","Republican",0.562128692647968,-21292,171354,-0.124257385295937
1990,"WEST VIRGINIA",1,72849,35657,108506,"ALAN B MOLLOHAN","HOWARD K TUCK","Democrat",0.67138222771091,37192,108506,0.34276445542182
1990,"WEST VIRGINIA",2,63174,50708,113882,"HARLEY O STAGGERS JR","OLIVER LUCK","Democrat",0.554732091111853,12466,113882,0.109464182223705
1990,"WEST VIRGINIA",4,39948,36946,76894,"NICK JOE RAHALL II","MARIANNE R BREWSTER","Democrat",0.51952037870315,3002,76894,0.0390407574062996
1990,"WISCONSIN",2,85156,96938,182118,"ROBERT W KASTENMEIER","SCOTT L KLUG","Republican",0.532281268188757,-11782,182094,-0.0647028457829473
1990,"WISCONSIN",3,60409,94509,154935,"JAMES L ZIEGEWEID","STEVE GUNDERSON","Republican",0.609991286668603,-34100,154918,-0.220116448701894
1990,"WISCONSIN",4,96981,43001,140221,"GERALD D KLECZKA","JOSEPH L COOK","Democrat",0.691629641779762,53980,139982,0.385621008415368
1990,"WISCONSIN",5,77557,31255,114115,"JIM MOODY","DONALDA ARNELL HAMMERSMITH","Democrat",0.679638960697542,46302,108812,0.425522920266147
1990,"WISCONSIN",7,100069,60961,161041,"DAVID R OBEY","JOHN L MCEWEN","Democrat",0.621388342099217,39108,161030,0.242861578587841
1990,"WISCONSIN",8,83199,95902,179142,"JEROME VAN SISTINE","TOBY ROTH","Republican",0.535340679460986,-12703,179101,-0.0709264604887745
1990,"WYOMING",0,70977,87078,158055,"PETE MAXFIELD","CRAIG THOMAS","Republican",0.550934801176805,-16101,158055,-0.101869602353611
1992,"ALABAMA",1,78742,128874,214204,"WILLIAM A BREWER","SONNY CALLAHAN","Republican",0.601641425930421,-50132,207616,-0.241465012330456
1992,"ALABAMA",2,109335,112906,228160,"GEORGE C WALLACE JR","TERRY EVERETT","Republican",0.494854488078541,-3571,222241,-0.0160681422419806
1992,"ALABAMA",3,119175,73800,197604,"GLEN BROWDER","DON SLEDGE","Democrat",0.603100139673286,45375,192975,0.235134084726001
1992,"ALABAMA",4,157907,66934,230523,"TOM BEVILL","MARTHA ""MICKEY"" STRICKLAND","Democrat",0.684994555857767,90973,224841,0.404610369105279
1992,"ALABAMA",5,160060,77951,244133,"ROBERT E ""BUD"" CRAMER JR","TERRY SMITH","Democrat",0.655626236518619,82109,238011,0.3449798538723
1992,"ALABAMA",6,126062,146599,280139,"BEN ERDREICH","SPENCER T BAUCHUS III","Republican",0.523308072064225,-20537,272661,-0.0753206362479416
1992,"ALABAMA",7,144320,36086,207773,"EARL F HILLIARD","KERVIN JONES","Democrat",0.694604207476429,108234,180406,0.599946786692239
1992,"ALASKA",0,102378,111849,239116,"JOHN DEVENS","DON YOUNG","Republican",0.467760417537931,-9471,214227,-0.0442101135711185
1992,"ARIZONA",1,130715,113613,254789,"SAM COPPERSMITH","JOHN J RHODES III","Democrat",0.513032352260105,17102,244328,0.0699960708555712
1992,"ARIZONA",2,90693,41257,137378,"ED PASTOR","DON SHOOTER","Democrat",0.66017120645227,49436,131950,0.37465706707086
1992,"ARIZONA",3,88830,158906,258503,"ROGER HARTSTONE","BOB STUMP","Republican",0.614716270217367,-70076,247736,-0.282865631155746
1992,"ARIZONA",4,70572,156330,264066,"WALTER R MYBECK II","JOHN KYL","Republican",0.592011088137057,-85758,226902,-0.377951714837242
1992,"ARIZONA",5,77256,172867,259813,"JIM TOEVS","JIM KOLBE","Republican",0.665351618279301,-95611,250123,-0.382255930082399
1992,"ARIZONA",6,124251,97074,233372,"KARAN ENGLISH","DOUG WEAD","Democrat",0.532416056767736,27177,221325,0.12279227380549
1992,"ARKANSAS",1,149558,64618,214176,"BLANCHE M LAMBERT","TERRY HAYES","Democrat",0.698294860301808,84940,214176,0.396589720603616
1992,"ARKANSAS",2,154946,53978,208924,"RAY THORNTON","DENNIS SCOTT","Democrat",0.741638107637227,100968,208924,0.483276215274454
1992,"ARKANSAS",3,117775,125295,249494,"JOHN VANWINKLE","Y TIM HUTCHINSON","Republican",0.502196445605906,-7520,243070,-0.0309375899946517
1992,"ARKANSAS",4,102918,113009,215927,"W J ""BILL"" MCCUEN","JAY DICKEY","Republican",0.523366693373223,-10091,215927,-0.0467333867464467
1992,"CALIFORNIA",1,119676,113266,251206,"DAN HAMBURG","FRANK D RIGGS","Democrat",0.476405818332365,6410,232942,0.0275175794833049
1992,"CALIFORNIA",2,71780,167247,256556,"ELLIOT ROY FREEDMAN","WALLY HERGER","Republican",0.651892764152855,-95467,239027,-0.399398394323654
1992,"CALIFORNIA",3,122149,96092,238685,"VIC FAZIO","H L ""BILL"" RICHARDSON","Democrat",0.511758175000524,26057,218241,0.119395530628984
1992,"CALIFORNIA",4,129489,141155,283365,"PATRICIA MALBERG","JOHN T DOOLITTLE","Republican",0.498138443350449,-11666,270644,-0.0431045949660809
1992,"CALIFORNIA",5,158250,58698,230560,"ROBERT T MATSUI","ROBERT S DINSMORE","Democrat",0.686372310895212,99552,216948,0.458874937773107
1992,"CALIFORNIA",6,190322,98171,291786,"LYNN C WOOLSEY","BILL FILANTE","Democrat",0.652265701575812,92151,288493,0.319421961711376
1992,"CALIFORNIA",7,153320,54822,217982,"GEORGE MILLER","DAVE SCHOLL","Democrat",0.703360827958272,98498,208142,0.473225009849045
1992,"CALIFORNIA",8,191906,25693,232691,"NANCY PELOSI","MARC WOLIN","Democrat",0.82472463481613,166213,217599,0.763850017693096
1992,"CALIFORNIA",9,164265,53707,228467,"RONALD V DELLUMS","G WILLIAM ""BILLY"" HUNTER","Democrat",0.718987862579716,110558,217972,0.507211935477951
1992,"CALIFORNIA",10,134635,145702,280429,"WENDELL H WILLIAMS","BILL BAKER","Republican",0.519568232957362,-11067,280337,-0.0394774860257476
1992,"CALIFORNIA",11,90539,94453,198490,"PATRICIA GARAMENDI","RICHARD W POMBO","Republican",0.475857725830017,-3914,184992,-0.0211576716830998
1992,"CALIFORNIA",12,157205,53278,228407,"TOM LANTOS","JIM TOMLIN","Democrat",0.688266997071018,103927,210483,0.493754840058342
1992,"CALIFORNIA",13,123795,64953,205516,"FORTNEY PETE STARK","VERNE TEYLER","Democrat",0.602361859903852,58842,188748,0.311748998664887
1992,"CALIFORNIA",14,146873,101202,259222,"ANNA G ESHOO","TOM HUENING","Democrat",0.56659157015994,45671,248075,0.184101582182808
1992,"CALIFORNIA",15,168617,82875,265370,"NORMAN Y MINETA","ROBERT WICK","Democrat",0.635403399027773,85742,251492,0.340933310005885
1992,"CALIFORNIA",16,96661,49843,155883,"DON EDWARDS","TED BUNDESEN","Democrat",0.620086860016807,46818,146504,0.319568066400917
1992,"CALIFORNIA",17,151565,49947,210367,"LEON E PANETTA","BILL MCCAMPBELL","Democrat",0.720478972462411,101618,201512,0.504277660883719
1992,"CALIFORNIA",19,101619,100590,216640,"RICHARD H LEHMAN","TAL L CLOUD","Democrat",0.469068500738552,1029,202209,0.00508879426731748
1992,"CALIFORNIA",20,72679,39388,112067,"CALVIN M DOOLEY","ED HUNT","Democrat",0.648531681940268,33291,112067,0.297063363880536
1992,"CALIFORNIA",21,68058,127758,195965,"DEBORAH A VOLLMER","WILLIAM M THOMAS","Republican",0.651942948995994,-59700,195816,-0.304878048780488
1992,"CALIFORNIA",22,87328,131242,249926,"GLORIA OCHOA","MICHAEL HUFFINGTON","Republican",0.525123436537215,-43914,218570,-0.200915038660383
1992,"CALIFORNIA",23,88225,115504,212881,"ANITA PEREZ FERGUSON","ELTON GALLEGLY","Republican",0.542575429465288,-27279,203729,-0.133898463154485
1992,"CALIFORNIA",24,141742,99835,255267,"ANTHONY C BEILENSON","TOM MCCLINTOCK","Democrat",0.555269580478479,41907,241577,0.173472640193396
1992,"CALIFORNIA",25,72233,113611,218715,"JAMES H ""GIL"" GILMARTIN","HOWARD P ""BUCK"" MCKEON","Republican",0.519447683057861,-41378,185844,-0.222649103549213
1992,"CALIFORNIA",26,73807,36453,120908,"HOWARD L BERMAN","GARY FORSCH","Democrat",0.610439342309855,37354,110260,0.338781062942137
1992,"CALIFORNIA",27,83805,105521,212450,"DOUG KAHN","CARLOS J MOORHEAD","Republican",0.4966862791245,-21716,189326,-0.114701625767195
1992,"CALIFORNIA",28,76525,122353,209382,"AL WACHTEL","DAVID DREIER","Republican",0.584353000735498,-45828,198878,-0.230432727601846
1992,"CALIFORNIA",29,160312,67141,261486,"HENRY WAXMAN","MARK A ROBBINS","Democrat",0.613080623819248,93171,227453,0.409627483480104
1992,"CALIFORNIA",30,48800,20034,83543,"XAVIER BECERRA","MORRY WAKSBERG","Democrat",0.584130328094514,28766,68834,0.417903942818956
1992,"CALIFORNIA",31,68324,40873,109197,"MATTHEW G MARTINEZ","REUBEN D FRANCO","Democrat",0.625694845096477,27451,109197,0.251389690192954
1992,"CALIFORNIA",33,32010,15428,50779,"LUCILLE ROYABL-ALLARD","ROBERT GUZMAN","Democrat",0.63037869985624,16582,47438,0.34955099287491
1992,"CALIFORNIA",34,91738,50907,149718,"ESTEBAN EDWARD TORRES","J ""JAY"" HERNANDEZ","Democrat",0.612738615263362,40831,142645,0.286242069473168
1992,"CALIFORNIA",35,102941,17417,124776,"MAXINE WATERS","NATE TRUMAN","Democrat",0.825006411489389,85524,120358,0.710580102693631
1992,"CALIFORNIA",36,125751,109684,351397,"JANE HARMAN","JOAN MILKE FLORES","Democrat",0.357860198009659,16067,235435,0.0682438889714783
1992,"CALIFORNIA",38,82108,92038,189321,"EVAN ANDERSON BRAUDE","STEVE HORN","Republican",0.486147865265871,-9930,174146,-0.0570211202094794
1992,"CALIFORNIA",39,81728,122472,213684,"MOLLY MCCLANAHAN","EDWARD R ROYCE","Republican",0.57314539226147,-40744,204200,-0.199529872673849
1992,"CALIFORNIA",40,63881,129563,205283,"DONALD M ""DON"" RUSK","JERRY LEWIS","Republican",0.631143348450675,-65682,193444,-0.339540125307583
1992,"CALIFORNIA",41,58777,101753,170666,"BOB BAKER","JAY KIM","Republican",0.596211313325443,-42976,160530,-0.267713200024917
1992,"CALIFORNIA",42,79780,69251,157455,"GEORGE E BROWN JR","DICK RUTAN","Democrat",0.506684449525261,10529,149031,0.0706497305929639
1992,"CALIFORNIA",43,88468,88987,190639,"MARK A TAKANO","KEN CALVERT","Republican",0.46678276742954,-519,177455,-0.00292468513144177
1992,"CALIFORNIA",44,81693,110333,203541,"GEORGIA SMITH","ALFRED A ""AL"" MCCANDLESS","Republican",0.54206769152161,-28640,192026,-0.149146469748888
1992,"CALIFORNIA",45,88508,123731,227016,"PATRICIA MCCABE","DANA ROHRABACHER","Republican",0.545032068224266,-35223,212239,-0.165959130979697
1992,"CALIFORNIA",46,45435,55659,110806,"ROBERT JOHN BANUELOS","ROBERT K DORNAN","Republican",0.502310344205187,-10224,101094,-0.101133598433141
1992,"CALIFORNIA",47,76924,165004,254257,"JOHN F ANWILER","CHRISTOPHER COX","Republican",0.648965416881344,-88080,241928,-0.36407526206144
1992,"CALIFORNIA",48,67415,140935,230495,"MICHAEL FARBER","RON PACKARD","Republican",0.611444933729582,-73520,208350,-0.352867770578354
1992,"CALIFORNIA",49,127280,106170,248898,"LYNN SCHENK","JUDY JARVIS","Democrat",0.511374137196763,21110,233450,0.0904262154636967
1992,"CALIFORNIA",50,77293,39531,136626,"BOB FILNER","TONY VALENCIA","Democrat",0.565726874826168,37762,116824,0.323238375676231
1992,"CALIFORNIA",51,85148,141890,252995,"BEA HERBERT","RANDY ""DUKE"" CUNNINGHAM","Republican",0.560841123342359,-56742,227038,-0.249922920392181
1992,"CALIFORNIA",52,88076,112995,213784,"JANET M GASTIL","DUNCAN HUNTER","Republican",0.528547505893799,-24919,201071,-0.123931347633423
1992,"COLORADO",1,156629,70902,227531,"PATRICK SCHROEDER","RAYMOND DIAZ ARAGON","Democrat",0.688385318923575,85727,227531,0.37677063784715
1992,"COLORADO",2,164790,88470,271361,"DAVID E SKAGGS","BRYAN DAY","Democrat",0.607272231455515,76320,253260,0.30135039090263
1992,"COLORADO",3,114480,143293,261964,"MIKE CALLIHAN","SCOTT MCINNIS","Republican",0.546995006947519,-28813,257773,-0.111776640687737
1992,"COLORADO",4,101957,139884,241841,"TOM REDDER","WAYNE ALLARD","Republican",0.578413089591922,-37927,241841,-0.156826179183844
1992,"COLORADO",5,62550,173096,243415,"CHARLES A ORIEZ","JOEL HEFLEY","Republican",0.711114762853563,-110546,235646,-0.469118932636242
1992,"COLORADO",6,91073,142021,233097,"TOM KOLBE","DAN SCHAEFER","Republican",0.609278540693359,-50948,233094,-0.218572764635726
1992,"CONNECTICUT",1,112838,75113,245430,"BARBARA B KENNELLY","PHILIP L STEELE","Democrat",0.459756346004971,37725,187951,0.200717208208522
1992,"CONNECTICUT",2,83197,119416,242707,"SAM GEJDENSON","EDWARD W MUNSTER","Republican",0.492017123527546,-36219,202613,-0.178759507040516
1992,"CONNECTICUT",3,112022,84952,247531,"ROSA L DELAURO","TOM SCOTT","Democrat",0.452557457449774,27070,196974,0.137429305390559
1992,"CONNECTICUT",4,58666,147816,219615,"DAVE SCHROPFER","CHRISTOPHER SHAYS","Republican",0.673068779454955,-89150,206482,-0.431756763301402
1992,"CONNECTICUT",5,74791,104891,240283,"JAMES J LAWLOR","GARY A FRANKS","Republican",0.436531090422543,-30100,179682,-0.167518170990973
1992,"CONNECTICUT",6,60373,166967,239597,"EUGENE F SLASON","NANCY L JOHNSON","Republican",0.696865987470628,-106594,227340,-0.468874813055336
1992,"DELAWARE",0,117426,153037,276124,"S B WOO","MICHAEL N CASTLE","Republican",0.554232880879605,-35611,270463,-0.131666808398931
1992,"FLORIDA",1,118941,100349,228632,"EARL HUTTO","TERRY KETCHEL","Democrat",0.520229014311207,18592,219290,0.0847827078298144
1992,"FLORIDA",2,167215,60425,227726,"DOUGLAS ""PETE"" PETERSON","RAY WAGNER","Democrat",0.734281548878916,106790,227640,0.469117905464769
1992,"FLORIDA",3,91915,63114,155029,"CORRINE BROWN","DON WEIDNER","Democrat",0.592889072367106,28801,155029,0.185778144734211
1992,"FLORIDA",4,103531,135883,239471,"MATTOX HAIR","TILLIE FOWLER","Republican",0.56742987668653,-32352,239414,-0.135129942275723
1992,"FLORIDA",5,129698,114356,263549,"KAREN L THURMAN","TOM HOGAN","Democrat",0.492121009755302,15342,244054,0.0628631368467634
1992,"FLORIDA",6,76419,144195,220614,"PHIL DENTON","CLIFF STEARNS","Republican",0.653607658625473,-67776,220614,-0.307215317250945
1992,"FLORIDA",7,96945,125823,223023,"DAN WEBSTER","JOHN L MICA","Republican",0.564170511561588,-28878,222768,-0.129632622279681
1992,"FLORIDA",8,65145,141977,207122,"CHUCK KOVALESKI","BILL MCCOLLUM","Republican",0.685475227160804,-76832,207122,-0.370950454321608
1992,"FLORIDA",9,110135,158028,268163,"CHERYL DAVID KNAPP","MICHAEL BILIRAKIS","Republican",0.589298299914604,-47893,268163,-0.178596599829208
1992,"FLORIDA",10,114809,149606,264415,"KAREN MOFFITT","C W BILL YOUNG","Republican",0.565799973526464,-34797,264415,-0.131599947052928
1992,"FLORIDA",11,100984,77640,191354,"SAM GIBBONS","MARK SHARPE","Democrat",0.527733938146054,23344,178624,0.13068792547474
1992,"FLORIDA",12,92346,100484,192830,"TOM MIMS","CHARLES T CANADY","Republican",0.521101488357621,-8138,192830,-0.0422029767152414
1992,"FLORIDA",13,115767,158881,274648,"RAND SNELL","DAN MILLER","Republican",0.578489557542746,-43114,274648,-0.156979115085491
1992,"FLORIDA",15,132412,128873,261285,"JIM BACCHUS","BILL TOLLEY","Democrat",0.506772298448055,3539,261285,0.0135445968961096
1992,"FLORIDA",16,101237,157322,258559,"JOHN P COMERFORD","TOM LEWIS","Republican",0.608456870578862,-56085,258559,-0.216913741157724
1992,"FLORIDA",18,52142,104755,156897,"MAGDA MONTIEL DAVIS","ILEANA ROS-LEHTINEN","Republican",0.667667323148307,-52613,156897,-0.335334646296615
1992,"FLORIDA",19,177423,103867,281294,"HARRY JOHNSTON","LARRY METZ","Democrat",0.630738657774428,73556,281290,0.261495254008319
1992,"FLORIDA",20,130959,91589,237889,"PETER DEUTSCH","BEVERLY KENNEDY","Democrat",0.55050464712534,39370,222548,0.176905656307853
1992,"FLORIDA",22,91625,128400,247088,"GWEN MARGOLIS","E CLAY SHAW JR","Republican",0.519652917179305,-36775,220025,-0.167140097716169
1992,"FLORIDA",23,84249,44807,143935,"ALCEE L HASTINGS","ED FIELDING","Democrat",0.585326709973252,39442,129056,0.305619266055046
1992,"GEORGIA",1,75808,103932,179740,"BARBARA CHRISTMAS","JACK KINGSTON","Republican",0.578235228663625,-28124,179740,-0.15647045732725
1992,"GEORGIA",2,95789,54593,150382,"SANFORD D BISHOP JR","JIM DUDLEY","Democrat",0.636971180061443,41196,150382,0.273942360122887
1992,"GEORGIA",3,94271,114107,208378,"RICHARD RAY","MICHAEL A ""MAC"" COLLINS","Republican",0.547596195375711,-19836,208378,-0.0951923907514229
1992,"GEORGIA",4,123819,126495,250314,"CATHEY STEINBERG","JOHN LINDER","Republican",0.505345286320382,-2676,250314,-0.0106905726407632
1992,"GEORGIA",5,147445,56960,204407,"JOHN LEWIS","PAUL STABLER","Democrat",0.721330482811254,90485,204405,0.442675081333627
1992,"GEORGIA",6,116196,158761,274957,"TONY CENTER","NEWT GINGRICH","Republican",0.577403012107348,-42565,274957,-0.154806024214695
1992,"GEORGIA",7,111374,82915,194289,"GEORGE ""BUDDY"" DARDEN","AL BEVERLY","Democrat",0.573238834931468,28459,194289,0.146477669862936
1992,"GEORGIA",8,108472,86220,194692,"J ROY ROWLAND","BOB CUNNINGHAM","Democrat",0.55714667269328,22252,194692,0.114293345386559
1992,"GEORGIA",9,113024,77919,190943,"NATHAN DEAL","DANIEL BECKER","Democrat",0.591925338975506,35105,190943,0.183850677951012
1992,"GEORGIA",10,108426,93059,201485,"DON JOHNSON","RALPH HUDGENS","Democrat",0.538134352433184,15367,201485,0.0762687048663672
1992,"GEORGIA",11,120168,44221,164400,"CYNTHIA A MCKINNEY","WOODROW LOVETT","Democrat",0.730948905109489,75947,164389,0.461995632311164
1992,"HAWAII",1,129332,41575,177476,"NEIL ABERCROMBIE","WARNER SUTTON","Democrat",0.728729518357412,87757,170907,0.513478090423447
1992,"HAWAII",2,131454,40070,180955,"PATSY T MINK","KAMUELA PRICE","Democrat",0.726445801442347,91384,171524,0.532776754273454
1992,"IDAHO",1,140985,90983,242890,"LARRY LAROCCO","RACHEL S GILBERT","Democrat",0.580447939396435,50002,231968,0.215555593875017
1992,"IDAHO",2,81450,139783,229957,"J D WILLIAMS","MICHAEL D CRAPO","Republican",0.607865818392134,-58333,221233,-0.26367223696284
1992,"ILLINOIS",1,209258,43453,252711,"BOBBY L RUSH","JAY WALKER","Democrat",0.828052597631286,165805,252711,0.656105195262573
1992,"ILLINOIS",2,182614,31957,233864,"MEL REYNOLDS","RON BLACKSTONE","Democrat",0.78085553997195,150657,214571,0.702131229290072
1992,"ILLINOIS",3,162165,93128,255293,"WILLIAM O LIPINSKI","HARRY C LEPINSKE","Democrat",0.635211306224613,69037,255293,0.270422612449225
1992,"ILLINOIS",4,90452,26154,116606,"LUIS V GUTIERREZ","HILDEGARDE RODRIGUEZ-SCHIEMAN","Democrat",0.775706224379535,64298,116606,0.551412448759069
1992,"ILLINOIS",5,132889,90738,232083,"DAN ROSTENKOWSKI","ELIAS R ZENKICH","Democrat",0.572592563867237,42151,223627,0.18848797327693
1992,"ILLINOIS",6,86891,165009,251904,"BARRY W WATKINS","HENRY J HYDE","Republican",0.655047160823171,-78118,251900,-0.310115125049623
1992,"ILLINOIS",7,182811,35346,225281,"CARDISS COLLINS","NORMAN G BOCCIO","Democrat",0.811479885121249,147465,218157,0.675958140238452
1992,"ILLINOIS",8,96419,132887,238633,"SHEILA A SMITH","PHILIP M CRANE","Republican",0.556867658706046,-36468,229306,-0.159036396779849
1992,"ILLINOIS",9,162942,64760,239703,"SIDNEY R YATES","HERB SOHN","Democrat",0.679766210685724,98182,227702,0.43118637517457
1992,"ILLINOIS",10,85400,155230,240630,"MICHAEL J KENNEDY","JOHN EDWARD PORTER","Republican",0.645098283672028,-69830,240630,-0.290196567344055
1992,"ILLINOIS",11,135387,107860,243247,"GEORGE E SANGMEISTER","ROBERT T HERBOLSHEIMER","Democrat",0.556582403893984,27527,243247,0.113164807787969
1992,"ILLINOIS",12,168762,68115,236877,"JERRY F COSTELLO","MIKE STARR","Democrat",0.712445699666916,100647,236877,0.424891399333831
1992,"ILLINOIS",13,82985,179257,262255,"DENNIS MICHAEL TEMPLE","HARRIS W FAWELL","Republican",0.683521763169434,-96272,262242,-0.367111294148153
1992,"ILLINOIS",14,75294,155271,230624,"JONATHAN ABRAM REICH","J DENNIS HASTERT","Republican",0.673264707922853,-79977,230565,-0.346873983475376
1992,"ILLINOIS",15,97190,142167,239586,"CHARLES D MATTIS","THOMAS W EWING","Republican",0.593386091006987,-44977,239357,-0.187907602451568
1992,"ILLINOIS",16,113555,142388,255943,"JOHN W COX JR","DONALD A MANZULLO","Republican",0.55632699468241,-28833,255943,-0.11265398936482
1992,"ILLINOIS",17,156233,103719,259952,"LANE EVANS","KEN SCHLOEMER","Democrat",0.601007109004739,52514,259952,0.202014218009479
1992,"ILLINOIS",18,114413,156533,270976,"RONALD C HAWKINS","ROBERT H MICHEL","Republican",0.577663704534719,-42120,270946,-0.155455330582478
1992,"ILLINOIS",19,187156,83526,270685,"GLENN POSHARD","DOUGLAS E LEE","Democrat",0.691416221807636,103630,270682,0.382847769707627
1992,"ILLINOIS",20,154869,119219,274088,"RICHARD J DURBIN","JOHN M SHIMKUS","Democrat",0.56503385773912,35650,274088,0.130067715478241
1992,"INDIANA",1,147054,64770,211824,"PETER J VISCLOSKY","DAVID J VUCICH","Democrat",0.694227283027419,82284,211824,0.388454566054838
1992,"INDIANA",2,130881,90593,229295,"PHILIP R SHARP","WILLIAM G FRAZIER","Democrat",0.57079744434026,40288,221474,0.181908485871931
1992,"INDIANA",3,121269,89834,211103,"TIM ROEMER","CARL H BAXMEYER","Democrat",0.574454176397304,31435,211103,0.148908352794607
1992,"INDIANA",4,134907,82468,217375,"JILL L LONG","CHARLES W ""CHUCK"" PIERSON","Democrat",0.62061874640598,52439,217375,0.241237492811961
1992,"INDIANA",5,107973,112492,220465,"JIM JONTZ","STEVEN E BUYER","Republican",0.510248792325312,-4519,220465,-0.0204975846506248
1992,"INDIANA",6,71952,186499,258455,"NATALIE M BRUNER","DAN BURTON","Republican",0.721591766458378,-114547,258451,-0.443205868810722
1992,"INDIANA",7,88005,129189,217194,"ELLEN E WEDUM","JOHN T MYERS","Republican",0.594809248874278,-41184,217194,-0.189618497748557
1992,"INDIANA",8,125244,108054,238397,"FRANK MCCLOSKEY","RICHARD E MOURDOCK","Democrat",0.525358960054027,17190,233298,0.0736825862201991
1992,"INDIANA",9,160980,70057,231037,"LEE H HAMILTON","MICHAEL E BAILEY","Democrat",0.696771512787995,90923,231037,0.39354302557599
1992,"INDIANA",10,117604,64378,183831,"ANDREW JACOBS JR","JANOS HORVATH","Democrat",0.639739760976114,53226,181982,0.292479475992131
1992,"IOWA",1,81600,178042,261309,"JAN J ZONNEVELD","JAMES A LEACH","Republican",0.681346604977249,-96442,259642,-0.371442216590536
1992,"IOWA",2,131570,134536,267892,"DAVID R NAGLE","JIM NUSSLE","Republican",0.502202380063608,-2966,266106,-0.0111459343269224
1992,"IOWA",3,121063,125931,257276,"ELAINE BAXTER","JIM LIGHTFOOT","Republican",0.489478225718683,-4868,246994,-0.0197089807849583
1992,"IOWA",4,158610,94045,257593,"NEAL SMITH","PAUL LUNDE","Democrat",0.615738781721553,64565,252655,0.255546100413607
1992,"KANSAS",1,83620,194912,285297,"DUANE WEST","PAT ROBERTS","Republican",0.683189798701003,-111292,278532,-0.399566297588787
1992,"KANSAS",2,151019,109801,268806,"JIM SLATTERY","JIM VAN SLYKE","Democrat",0.561814096411538,41218,260820,0.158032359481635
1992,"KANSAS",3,110071,169929,292791,"TOM LOVE","JAN MEYERS","Republican",0.580376445997316,-59858,280000,-0.213778571428571
1992,"KANSAS",4,143671,117070,278016,"DAN GLICKMAN","ERIC R YOST","Democrat",0.516772415976059,26601,260741,0.102020779240702
1992,"KENTUCKY",1,128524,83088,212574,"THOMAS J BARLOW III","STEVE HAMRICK","Democrat",0.60460827758804,45436,211612,0.214713721339055
1992,"KENTUCKY",2,126894,79684,206578,"WILLIAM H NATCHER","BRUCE R BARTLEY","Democrat",0.61426676606415,47210,206578,0.2285335321283
1992,"KENTUCKY",3,148066,132689,280770,"ROMANO L MAZZOLI","SUSAN B STOKES","Democrat",0.527356911350928,15377,280755,0.0547701732827554
1992,"KENTUCKY",4,86890,139634,226524,"FLOYD G POORE","JIM BUNNING","Republican",0.616420335152125,-52744,226524,-0.23284067030425
1992,"KENTUCKY",5,95760,115255,211015,"JOHN DOUG HAYES","HAROLD ROGERS","Republican",0.546193398573561,-19495,211015,-0.0923867971471222
1992,"KENTUCKY",6,135613,87816,223450,"SCOTTY BAESLER","CHARLES W ELLINGER","Democrat",0.606905347952562,47797,223429,0.213924781474204
1992,"LOUISIANA",5,90079,153501,243580,"JERRY HUCKABY","JIM MCCRERY","Republican",0.630187207488299,-63422,243580,-0.260374414976599
1992,"MAINE",1,232696,125236,358148,"THOMAS H ANDREWS","LINDA BEAN","Democrat",0.649720227392028,107460,357932,0.300224623671535
1992,"MAINE",2,130824,153022,311433,"PATRICK K MCGOWAN","OLYMPIA J SNOWE","Republican",0.491348058812008,-22198,283846,-0.0782043784305574
1992,"MARYLAND",1,112771,120084,232855,"C THOMAS MCMILLEN","WAYNE T GILCHREST","Republican",0.515702905241459,-7313,232855,-0.0314058104829186
1992,"MARYLAND",2,88658,165443,254101,"MICAHEL C HICKEY JR","HELEN DELICH BENTLEY","Republican",0.651091495114148,-76785,254101,-0.302182990228295
1992,"MARYLAND",3,163354,58869,222223,"BENJAMIN L CARDIN","WILLIAM T S BRICKER","Democrat",0.735090427183505,104485,222223,0.47018085436701
1992,"MARYLAND",4,136902,45166,182068,"ALBERT RUSSELL WYNN","MICHELE DYSON","Democrat",0.751927851132544,91736,182068,0.503855702265088
1992,"MARYLAND",5,118312,104972,223284,"STENY H HOYER","LAWRENCE J HOGAN JR","Democrat",0.529872270292542,13340,223284,0.0597445405850845
1992,"MARYLAND",6,106224,125564,231788,"THOMAS H HATTERY","ROSCOE G BARTLETT","Republican",0.541719157160854,-19340,231788,-0.0834383143217078
1992,"MARYLAND",7,152689,26304,178993,"KWEISI MFUME","KENNETH KONDNER","Democrat",0.85304453246775,126385,178993,0.7060890649355
1992,"MARYLAND",8,77042,203377,280419,"EDWARD J HEFFERNAN","CONSTANCE A MORELLA","Republican",0.725261127099091,-126335,280419,-0.450522254198182
1992,"MASSACHUSETTS",1,135049,113828,262120,"JOHN W OLVER","PATRICK LARKIN","Democrat",0.515218220662292,21221,248877,0.0852670194513756
1992,"MASSACHUSETTS",2,131215,76795,247163,"RICHARD E NEAL","ANTHONY W RAVISA JR","Democrat",0.530884477045512,54420,208010,0.261622037402048
1992,"MASSACHUSETTS",3,115587,131473,260932,"JOSEPH D EARLY","PETER BLUTE","Republican",0.50385924302117,-15886,247060,-0.0643001699991905
1992,"MASSACHUSETTS",4,182633,70665,269812,"BARNEY FRANK","EDWARD J MCCORMICK III","Democrat",0.676889834403214,111968,253298,0.442040600399529
1992,"MASSACHUSETTS",5,133844,96206,256564,"MARTIN T MEEHAN","PAUL W CRONIN","Democrat",0.521678801390686,37638,230050,0.163607911323625
1992,"MASSACHUSETTS",6,130248,159165,290312,"NICHOLAS MAVROULES","PETER G TORKILDSEN","Republican",0.548254980848191,-28917,289413,-0.0999160369437447
1992,"MASSACHUSETTS",7,174837,78262,281558,"EDWARD J MARKEY","STEPHEN A SOHN","Democrat",0.620962643576102,96575,253099,0.381570057566407
1992,"MASSACHUSETTS",9,175550,54291,253634,"JOHN JOSEPH MOAKLEY","MARTIN D CONBOY","Democrat",0.692139066528935,121259,229841,0.527577760277757
1992,"MASSACHUSETTS",10,189342,75887,311650,"GERRY E STUDDS","DANIEL W DALY","Democrat",0.60754692764319,113455,265229,0.427762424169303
1992,"MICHIGAN",1,144857,117056,268619,"BART STUPAK","PHILIP E RUPPE","Democrat",0.539265651350053,27801,261913,0.106145933955168
1992,"MICHIGAN",2,86265,155577,246761,"JOHN H MILTNER","PETER HOEKSTRA","Republican",0.630476452924084,-69312,241842,-0.286600342372293
1992,"MICHIGAN",3,95927,162451,264948,"CAROL S KOOISTRA","PAUL B HENRY","Republican",0.6131429563537,-66524,258378,-0.257467741061545
1992,"MICHIGAN",4,87573,157337,251539,"LISA A DONALDSON","DAVE CAMP","Republican",0.625497437773069,-69764,244910,-0.284855661263321
1992,"MICHIGAN",5,147618,93098,244992,"JAMES A BARCIA","KEITH MUXLOW","Democrat",0.602542123824451,54520,240716,0.226490968610313
1992,"MICHIGAN",6,89020,144083,233112,"ANDY DAVIS","FRED UPTON","Republican",0.618084869075809,-55063,233103,-0.236217466098677
1992,"MICHIGAN",8,135517,131906,284707,"BOB CARR","DICK CHRYSLER","Democrat",0.475987594263576,3611,267423,0.0135029522516762
1992,"MICHIGAN",9,133956,111798,249530,"DALE E KILDEE","MEGAN O'NEILL","Democrat",0.536833246503426,22158,245754,0.0901633340657731
1992,"MICHIGAN",10,138193,114918,260213,"DAVID E BONIOR","DOUGLAS CARL","Democrat",0.531076464281185,23275,253111,0.0919557032290181
1992,"MICHIGAN",11,117725,168940,293098,"WALTER BRIGGS","JOE KNOLLENBERG","Republican",0.576394243563586,-51215,286665,-0.178658015453578
1992,"MICHIGAN",12,137514,119357,261349,"SANDER M LEVIN","JOHN PAPPAGEORGE","Democrat",0.526169987258417,18157,256871,0.0706852856102869
1992,"MICHIGAN",13,127642,105169,245888,"WILLIAM D FORD","F ROBERT GEAKE","Democrat",0.519106259760541,22473,232811,0.0965289440791028
1992,"MICHIGAN",14,165496,32036,200879,"JOHN CONYERS JR","JOHN W GORDON","Democrat",0.823859139083727,133460,197532,0.675637365085151
1992,"MICHIGAN",15,148908,31849,184964,"BARBARA-ROSE COLLINS","CHARLES C VINCENT","Democrat",0.805064769360524,117059,180757,0.647604242159363
1992,"MICHIGAN",16,156964,75694,240936,"JOHN D DINGELL","FRANK BEAUMONT","Democrat",0.651475910615267,81270,232658,0.349311005854086
1992,"MISSISSIPPI",1,121664,82952,204616,"JAMIE L WHITTEN","CLYDE E WHITAKER","Democrat",0.594596707979826,38712,204616,0.189193415959651
1992,"MISSISSIPPI",2,133361,41248,174609,"MIKE ESPY","DOROTHY ""DOT"" BENFORD","Democrat",0.763769336059424,92113,174609,0.527538672118848
1992,"MISSISSIPPI",3,162864,37710,200574,"G V ""SONNY"" MONTGOMERY","MICHAEL E WILLIAMS","Democrat",0.811989589877053,125154,200574,0.623979179754106
1992,"MISSISSIPPI",4,130927,43705,194544,"MIKE PARKER","JACK L MCMILLAN","Democrat",0.672994284069414,87222,174632,0.499461725227908
1992,"MISSISSIPPI",5,120766,67619,191058,"GENE TAYLOR","PAUL HARVEY","Democrat",0.632090778716411,53147,188385,0.282119064681371
1992,"MISSOURI",1,158693,74482,233175,"WILLIAM ""BILL"" CLAY","ARTHUR S MONTGOMERY","Democrat",0.680574675672778,84211,233175,0.361149351345556
1992,"MISSOURI",2,148729,157594,312442,"JOAN KELLY HORN","JAMES M TALENT","Republican",0.504394415603536,-8865,306323,-0.0289400404148562
1992,"MISSOURI",3,174000,90006,271834,"RICHARD A GEPHARDT","MACK HOLEKAMP","Democrat",0.640096529499621,83994,264006,0.318151860184996
1992,"MISSOURI",4,176977,74475,251452,"IKE SKELTON","JOHN CARLEY","Democrat",0.703820212207499,102502,251452,0.407640424414998
1992,"MISSOURI",5,151014,93562,255312,"ALAN WHEAT","EDWARD ""GOMER"" MOODY","Democrat",0.591488061665727,57452,244576,0.234904487766584
1992,"MISSOURI",6,148887,119637,268524,"PAT DANNER","E THOMAS COLEMAN","Democrat",0.554464405416276,29250,268524,0.108928810832551
1992,"MISSOURI",7,99762,160303,260065,"THOMAS PATRICK ""PAT"" DEATON","MEL HANCOCK","Republican",0.616395901024744,-60541,260065,-0.232791802049488
1992,"MISSOURI",8,86730,147398,234418,"THAD BULLOCK","BILL EMERSON","Republican",0.628782772653977,-60668,234128,-0.259123214651814
1992,"MISSOURI",9,124694,118811,261335,"HAROLD L WOLKMER","RICK HARDY","Democrat",0.477142365163487,5883,243505,0.0241596681792982
1992,"MONTANA",0,203711,189570,403735,"PAT WILLIAMS","RON MARLENEE","Democrat",0.504566113911353,14141,393281,0.0359564789552508
1992,"NEBRASKA",1,96309,142713,239108,"GERRY FINNEGAN","DOUG BEREUTER","Republican",0.596855814109105,-46404,239022,-0.19414112508472
1992,"NEBRASKA",2,119512,113828,233372,"PETER HOAGLAND","RONALD L STASKIEWICZ","Democrat",0.512109421867233,5684,233340,0.0243593040198851
1992,"NEBRASKA",3,67457,170857,238355,"LOWELL FISHER","BILL BARRETT","Republican",0.716817352268675,-103400,238314,-0.433881349815789
1992,"NEVADA",1,128278,84217,221488,"JAMES H BILBRAY","J COY PETTYJOHN","Democrat",0.579164559705266,44061,212495,0.207350761194381
1992,"NEVADA",2,117199,129575,270461,"PETE SFERRAZZA","BARBARA F VUCANOVICH","Republican",0.479089406605758,-12376,246774,-0.0501511504453468
1992,"NEW HAMPSHIRE",1,108578,135936,255681,"BOB PRESTON","WILLIAM H ZELIFF JR","Republican",0.531662501320004,-27358,244514,-0.111887253899572
1992,"NEW HAMPSHIRE",2,157328,91126,255088,"DICK SWETT","BILL HATCH","Democrat",0.616759706454243,66202,248454,0.266455762434897
1992,"NEW JERSEY",1,153525,65123,228072,"ROBERT E ANDREWS","LEE A SOLOMON","Democrat",0.673142691781543,88402,218648,0.404311953459442
1992,"NEW JERSEY",2,132465,98315,237027,"WILLIAM J HUGHES","FRANK A LOBIONDO","Democrat",0.558860382994342,34150,230780,0.147976427766704
1992,"NEW JERSEY",3,94012,151368,255798,"TIMOTHY E RYAN","JIM SAXTON","Republican",0.591748176295358,-57356,245380,-0.233743581383976
1992,"NEW JERSEY",4,84514,149095,241225,"BRIAN M HUGHES","CRISTOPHER H SMITH","Republican",0.618074411856151,-64581,233609,-0.276449109409312
1992,"NEW JERSEY",5,67579,196198,274371,"FRANK R LUCAS","MARGE ROUKEMA","Republican",0.715082862255851,-128619,263777,-0.487605060335056
1992,"NEW JERSEY",6,118266,100949,226093,"FRANK PALLONE JR","JOSEPH M KYRILLOS","Democrat",0.523085632903274,17317,219215,0.0789955066943412
1992,"NEW JERSEY",7,105761,132174,248082,"LEONARD R SENDELSKY","BOB FRANKS","Republican",0.532783515128063,-26413,237935,-0.111009309265135
1992,"NEW JERSEY",8,96742,84674,205828,"HERB KLEIN","JOSEPH L BUBBA","Democrat",0.470013797928367,12068,181416,0.0665211447722362
1992,"NEW JERSEY",9,139188,88179,238704,"ROBERT G TORRICELLI","PATRICK J ROMA","Democrat",0.583098733159059,51009,227367,0.22434654105477
1992,"NEW JERSEY",10,117287,30160,149632,"DONALD M PAYNE","ALFRED D PALERMO","Democrat",0.783836345166809,87127,147447,0.59090385019702
1992,"NEW JERSEY",11,68871,188165,268436,"ONA SPIRIDELLIS","DEAN A GALLO","Republican",0.70096782845818,-119294,257036,-0.464113976252354
1992,"NEW JERSEY",12,83035,174216,272757,"FRANK G ABATE","DICK ZIMMER","Republican",0.638722379260661,-91181,257251,-0.354443714504511
1992,"NEW JERSEY",13,93670,44529,145714,"ROBERT MENENDEZ","FRED J THEEMLING JR","Democrat",0.642834593793321,49141,138199,0.355581444149379
1992,"NEW MEXICO",1,76600,128426,205214,"ROBERT J ARAGON","STEVEN SCHIFF","Republican",0.625815002875048,-51826,205026,-0.252777696487275
1992,"NEW MEXICO",2,73157,94838,168170,"DAN SOSA","JOE SKEEN","Republican",0.56394124992567,-21681,167995,-0.129057412422989
1992,"NEW MEXICO",3,122850,54569,182217,"BILL RICHARDSON","F GREGG BEMIS JR","Democrat",0.674196150743344,68281,177419,0.384857315169176
1992,"NEW YORK",1,111908,87248,257043,"GEORGE J HOCHBRUECKNER","EDWARD P ROMAINE","Democrat",0.435366845236011,24660,199156,0.123822531081163
1992,"NEW YORK",2,91320,94208,232997,"THOMAS J DOWNEY","RICK LAZIO","Republican",0.404331386241025,-2888,185528,-0.0155663835108447
1992,"NEW YORK",3,116915,108574,293639,"STEVE A ORLINS","PETER T KING","Democrat",0.398158963897847,8341,225489,0.0369907179507648
1992,"NEW YORK",4,97007,98723,261812,"PHILIP SCHILIRO","DAVID A LEVY","Republican",0.377075917070264,-1716,195730,-0.00876717927757625
1992,"NEW YORK",5,105953,82883,256555,"GARY L ACKERMAN","ALLAN E BINDER","Democrat",0.412983570774298,23070,188836,0.122169501578089
1992,"NEW YORK",6,96972,18725,160228,"FLOYD H FLAKE","DIANAND D BHAGWANDIN","Democrat",0.605212572084779,78247,115697,0.676309670950846
1992,"NEW YORK",7,72280,46218,171124,"THOMAS J MANTON","DENNIS C SHEA","Democrat",0.42238376849536,26062,118498,0.219936201454877
1992,"NEW YORK",8,132172,25548,227585,"JERROLD NADLER","DAVID L ASKREN","Democrat",0.580758837357471,106624,157720,0.676033477047933
1992,"NEW YORK",12,55926,12288,104485,"NYDIA M VELAZQUEZ","ANGEL DIAZ","Democrat",0.535253864191032,43638,68214,0.639722051191837
1992,"NEW YORK",13,68738,92144,217142,"SAL F ALBANESE","SUSAN MOLINARI","Republican",0.424349043483066,-23406,160882,-0.145485511119951
1992,"NEW YORK",14,97059,92034,238720,"CAROLYN B MALONEY","BILL GREEN","Democrat",0.406580931635389,5025,189093,0.0265742253811617
1992,"NEW YORK",16,80927,6741,132082,"JOSE E SERRANO","MICHAEL WALTERS","Democrat",0.612702714980088,74186,87668,0.846215266687959
1992,"NEW YORK",17,94758,16511,166357,"ELIOT L ENGEL","MARTIN RICHMAN","Democrat",0.569606328558462,78247,111269,0.703223719095166
1992,"NEW YORK",18,115841,74076,243057,"NITA M LOWEY","JOSEPH J DIOGUARDI","Democrat",0.476600139062031,41765,189917,0.219911856231933
1992,"NEW YORK",19,92854,119047,267291,"NEIL P MCCARTHY","HAMILTON FISH JR","Republican",0.445383495890247,-26193,211901,-0.123609610148135
1992,"NEW YORK",20,66826,150301,265011,"JONATHAN L LEVINE","BENJAMIN A GILMAN","Republican",0.567150042828411,-83475,217127,-0.384452417248891
1992,"NEW YORK",21,149319,83845,297006,"MICHAEL R MCNULTY","NANCY NORMAN","Democrat",0.502747419244056,65474,233164,0.280806642534868
1992,"NEW YORK",22,86896,136909,284496,"DAVID ROBERTS","GERALD B H SOLOMON","Republican",0.48123347955683,-50013,223805,-0.223466857308818
1992,"NEW YORK",23,61835,139774,252880,"PAULA DIPERNA","SHERWOOD L BOEHLERT","Republican",0.552728566909206,-77939,201609,-0.386584924284134
1992,"NEW YORK",24,47675,113408,231046,"MARGARET M RAVENSCROFT","JOHN M MCHUGH","Republican",0.490845978722852,-65733,161083,-0.408069132062353
1992,"NEW YORK",25,101422,119282,266033,"RHEA JEZER","JAMES T WALSH","Republican",0.44837294621344,-17860,220704,-0.0809228650137741
1992,"NEW YORK",26,112763,98389,266740,"MAURICE D HINCHEY","BOB MOPPERT","Democrat",0.42274499512634,14374,211152,0.0680741835265591
1992,"NEW YORK",27,89906,126997,277339,"W DOUGLAS CALL","BILL PAXON","Republican",0.457912518614403,-37091,216903,-0.171002706278844
1992,"NEW YORK",28,140908,93806,275326,"LOUISE MCINTOSH SLAUGHTER","WILLIAM P POLITO","Democrat",0.511786028199298,47102,234714,0.200678272280307
1992,"NEW YORK",29,120758,85294,264526,"JOHN J LAFALCE","WILLIAM E MILLER JR","Democrat",0.456507110832206,35464,206052,0.172111894084988
1992,"NEW YORK",30,102519,114921,265097,"DENNIS T GORSKI","JACK QUINN","Republican",0.4335054715821,-12402,217440,-0.0570364238410596
1992,"NEW YORK",31,52010,133758,247194,"JOSEPH P LEAHEY","AMO HOUGHTON","Republican",0.541105366635113,-81748,185768,-0.44005426122906
1992,"NORTH CAROLINA",1,116078,54457,173262,"EVA M CLAYTON","TED TYLER","Democrat",0.669956482090707,61621,170535,0.361339314510218
1992,"NORTH CAROLINA",2,113693,93893,211569,"TIM VALENTINE","DON DAVIS","Democrat",0.53738024001626,19800,207586,0.0953821548659351
1992,"NORTH CAROLINA",3,101739,80759,187050,"H MARTIN LANCASTER","TOMMY POLLARD","Democrat",0.543913392141139,20980,182498,0.114960163947002
1992,"NORTH CAROLINA",4,171299,89345,265060,"DAVID E PRICE","LAVINIA ""VICKY"" ROTHROCK GOUDIE","Democrat",0.646264996604542,81954,260644,0.31442887616826
1992,"NORTH CAROLINA",5,117835,102086,223683,"STEPHEN L NEAL","RICHARD M BURR","Democrat",0.52679461559439,15749,219921,0.0716120788828716
1992,"NORTH CAROLINA",6,67200,162822,230022,"ROBIN HOOD","HOWARD COBLE","Republican",0.707854031353523,-95622,230022,-0.415708062707045
1992,"NORTH CAROLINA",7,92414,66536,163101,"CHARLIE ROSE","ROBERT C ANDERSON","Democrat",0.566605968081128,25878,158950,0.162805913809374
1992,"NORTH CAROLINA",8,113162,71842,195451,"W G ""BILL"" HEFNER","COY C PRIVETTE","Democrat",0.578978874500514,41320,185004,0.223346522237357
1992,"NORTH CAROLINA",9,74583,153650,228245,"RORY BLAKE","J ALEX MCMILLAN","Republican",0.673180135380841,-79067,228233,-0.346431059487454
1992,"NORTH CAROLINA",10,79206,149033,235127,"BEN NEILL","CASS BALLENGER","Republican",0.633840435169079,-69827,228239,-0.305938073685917
1992,"NORTH CAROLINA",11,108003,130158,238161,"JOHN S STEVENS","CHARLES H TAYLOR","Republican",0.546512653205185,-22155,238161,-0.0930253064103695
1992,"NORTH CAROLINA",12,127262,49402,180824,"MELVIN L WATT","BARBARA GORE WASHINGTON","Democrat",0.70378932000177,77860,176664,0.44072363356428
1992,"NORTH DAKOTA",0,169273,117442,297898,"EARL POMEROY","JOHN T KORSMO","Democrat",0.568224694358472,51831,286715,0.180775334391294
1992,"OHIO",2,75924,177720,253651,"THOMAS R CHANDLER","WILLIS D GRADISON JR","Republican",0.70064774039921,-101796,253644,-0.401334153380328
1992,"OHIO",3,146072,98733,244811,"TONY P HALL","PETER W DAVIS","Democrat",0.596672535139352,47339,244805,0.193374318335001
1992,"OHIO",4,92608,147346,240440,"RAYMOND M BALL","MICHAEL G OXLEY","Republican",0.612818166694394,-54738,239954,-0.228118722755195
1992,"OHIO",6,122720,119252,241972,"TED STRICKLAND","BOB MCEWEN","Democrat",0.507166118393864,3468,241972,0.0143322367877275
1992,"OHIO",7,66237,164195,230432,"CLIFFORD S HESKETT","DAVID L HOBSON","Republican",0.712552944035551,-97958,230432,-0.425105888071101
1992,"OHIO",8,62033,176362,238395,"FRED SENNET","JOHN A BOEHNER","Republican",0.739789005641897,-114329,238395,-0.479578011283794
1992,"OHIO",9,178879,53011,243102,"MARCY KAPTUR","KEN D BROWN","Democrat",0.735818709841959,125868,231890,0.542791840959075
1992,"OHIO",10,103788,136433,240239,"MARY ROSE OAKAR","MARTIN R HOKE","Republican",0.567905294311082,-32645,240221,-0.135895696046557
1992,"OHIO",11,154718,43866,223624,"LOUIS STOKES","BERYL E ROTHSCHILD","Democrat",0.691866704825958,110852,198584,0.558212141965113
1992,"OHIO",12,68761,170297,239058,"BOB FITRAKIS","JOHN R KASICH","Republican",0.712366873311079,-101536,239058,-0.424733746622159
1992,"OHIO",13,134486,88889,252258,"SHERROD BROWN","MARGARET R MUELLER","Democrat",0.533128780851351,45597,223375,0.204127588136542
1992,"OHIO",14,165335,78659,243994,"THOMAS C SAWYER","ROBERT MORGAN","Democrat",0.677619121781683,86676,243994,0.355238243563366
1992,"OHIO",15,94907,110390,250205,"RICHARD CORDRAY","DEBORAH PRYCE","Republican",0.441198217461681,-15483,205297,-0.0754175657705665
1992,"OHIO",16,90224,158489,248713,"WARNER D MENDENHALL","RALPH REGULA","Republican",0.637236493468375,-68265,248713,-0.27447298693675
1992,"OHIO",17,216503,40743,257246,"JAMES A TRAFICANT JR","SALVATORE PANSINO","Democrat",0.841618528567985,175760,257246,0.683237057135971
1992,"OHIO",18,166189,77229,243418,"DOUGLAS APPLEGATE","BILL RESS","Democrat",0.682730940193412,88960,243418,0.365461880386824
1992,"OHIO",19,138465,124606,263083,"ERIC FINGERHUT","ROBERT A GARDNER","Democrat",0.526316789758365,13859,263071,0.0526815954628218
1992,"OKLAHOMA",1,106619,119211,225830,"JOHN SELPH","JAMES M INHOFE","Republican",0.527879378293407,-12592,225830,-0.0557587565868131
1992,"OKLAHOMA",2,118542,87657,213513,"MIKE SYNAR","JERRY HILL","Democrat",0.555198044147195,30885,206199,0.149782491670668
1992,"OKLAHOMA",3,155934,51725,207659,"BILL K BREWSTER","ROBERT W STOKES","Democrat",0.750913757650764,104209,207659,0.501827515301528
1992,"OKLAHOMA",4,140841,58235,199076,"DAVE MCCURDY","HOWARD BELL","Democrat",0.707473527697965,82606,199076,0.414947055395929
1992,"OKLAHOMA",5,107579,123237,230816,"LAURIE WILLIAMS","ERNEST J ISTOOK JR","Republican",0.533918792458062,-15658,230816,-0.0678375849161237
1992,"OKLAHOMA",6,134734,64068,198802,"GLENN ENGLISH","BOB ANTHONY","Democrat",0.677729600305832,70666,198802,0.355459200611664
1992,"OREGON",1,152917,140986,294154,"ELIZABETH FURSE","TONY MEEKER","Democrat",0.519853546101702,11931,293903,0.0405950262501574
1992,"OREGON",2,90036,184163,274478,"DENZEL FERGUSON","ROBERT F ""BOB"" SMITH","Republican",0.670957235188248,-94127,274199,-0.343279880670608
1992,"OREGON",3,208028,50235,269879,"RON WYDEN","AL RITTER","Democrat",0.770819515412463,157793,258263,0.610977956579146
1992,"OREGON",4,199372,79733,279299,"PETER A DEFAZIO","RICHARD L SCHULZ","Democrat",0.713829981489372,119639,279105,0.428652299313878
1992,"OREGON",5,174443,97984,272944,"MICHAEL J KOPETSKI","JIM SEAGRAVES","Democrat",0.639116448795357,76459,272427,0.280658671864389
1992,"PENNSYLVANIA",1,150172,35419,185591,"THOMAS M FOGLIETTA","CRAIG SNYDER","Democrat",0.80915561638226,114753,185591,0.61831123276452
1992,"PENNSYLVANIA",2,164355,47906,213927,"LUCIEN E BLACKWELL","LARRY HOLLIN","Democrat",0.76827609418166,116449,212261,0.548612321622908
1992,"PENNSYLVANIA",3,130828,86787,221971,"ROBERT A BORSKI","CHARLES F DOUGHERTY","Democrat",0.589392308004199,44041,217615,0.202380350619213
1992,"PENNSYLVANIA",4,186684,48484,237922,"RON KLINK","GORDON R JOHNSTON","Democrat",0.784643706761039,138200,235168,0.587664988433801
1992,"PENNSYLVANIA",6,108312,99694,208006,"TIM HOLDEN","JOHN E JONES","Democrat",0.520715748584175,8618,208006,0.0414314971683509
1992,"PENNSYLVANIA",7,91623,180648,273898,"FRANK DALY","CURT WELDON","Republican",0.659544794047419,-89025,272271,-0.326972024196481
1992,"PENNSYLVANIA",8,114095,129593,249538,"PETER H KOSTMAYER","JAMES C GREENWOOD","Republican",0.519331725027852,-15498,243688,-0.0635977151111257
1992,"PENNSYLVANIA",11,138875,68112,206987,"PAUL E KANJORSKI","MICHAEL A FESCINA","Democrat",0.670935855875007,70763,206987,0.341871711750013
1992,"PENNSYLVANIA",13,127685,126312,253997,"MARJORIE MARGOLIES-MEZVINSKY","JON D FOX","Democrat",0.502702787828203,1373,253997,0.00540557565640539
1992,"PENNSYLVANIA",14,165633,61311,229038,"WILLIAM J COYNE","BYRON W KING","Democrat",0.723168207895633,104322,226944,0.45968168358714
1992,"PENNSYLVANIA",15,111419,99520,213324,"PAUL MCHALE","DON RITTER","Democrat",0.522299413099323,11899,210939,0.0564096729386221
1992,"PENNSYLVANIA",16,74741,137823,212564,"ROBERT PETERS","ROBERT S WALKER","Republican",0.648383545661542,-63082,212564,-0.296767091323084
1992,"PENNSYLVANIA",17,65881,150158,216039,"BILL STURGES","GEORGE W GEKAS","Republican",0.69505043070927,-84277,216039,-0.39010086141854
1992,"PENNSYLVANIA",18,96655,154024,254329,"FRANK A PECORA","RICK SANTORUM","Republican",0.605609269882711,-57369,250679,-0.228854431364414
1992,"PENNSYLVANIA",19,74798,98599,217587,"PAUL V KILKER","WILLIAM F GOODLING","Republican",0.453147476641527,-23801,173397,-0.137263043766616
1992,"PENNSYLVANIA",20,114898,111591,226489,"AUSTIN J MURPHY","BILL TOWNSEND","Democrat",0.507300575303878,3307,226489,0.0146011506077558
1992,"PENNSYLVANIA",21,70802,150729,221531,"JOHN C HARKINS","THOMAS J RIDGE","Republican",0.680396874478064,-79927,221531,-0.360793748956128
1992,"RHODE ISLAND",1,48092,135982,194089,"DAVID R CARLIN JR","RONALD K MACHTLEY","Republican",0.700616727377646,-87890,184074,-0.477471017090953
1992,"RHODE ISLAND",2,144450,49998,204413,"JACK REED","JAMES W BELL","Democrat",0.706657600054791,94452,194448,0.485744260676376
1992,"SOUTH CAROLINA",1,59908,121938,184549,"BILL OBERST JR","ARTHUR RAVENEL JR","Republican",0.66073508932587,-62030,181846,-0.34111280974011
1992,"SOUTH CAROLINA",3,119119,75660,194864,"BUTLER DERRICK","JIM BLAND","Democrat",0.611293004351753,43459,194779,0.223119535473537
1992,"SOUTH CAROLINA",4,94182,99879,198410,"ELIZABETH J PATTERSON","BOB INGLIS","Republican",0.503397006199284,-5697,194061,-0.0293567486511973
1992,"SOUTH CAROLINA",5,112031,70866,183086,"JOHN M SPRATT JR","BILL HORNE","Democrat",0.611903695531062,41165,182897,0.225072035079854
1992,"SOUTH CAROLINA",6,120647,64149,184871,"JAMES E CLYBRUN","JOHN CHASE","Democrat",0.652601002861455,56498,184796,0.305731725794931
1992,"SOUTH DAKOTA",0,230070,89375,332902,"TIM JOHNSON","JOHN TIMMER","Democrat",0.691104288949901,140695,319445,0.440435755763903
1992,"TENNESSEE",1,47809,114797,170158,"J CARR ""JACK"" CHRISTIAN","JAMES H ""JIMMY"" QUILLEN","Republican",0.674649443458433,-66988,162606,-0.411965118138322
1992,"TENNESSEE",2,52887,148377,205401,"TROY GOODALE","JOHN J DUNCAN JR","Republican",0.722377203616341,-95490,201264,-0.474451466730265
1992,"TENNESSEE",3,105693,102763,216533,"MARILYN LLOYD","ZACH WAMP","Democrat",0.488114975546453,2930,208456,0.0140557239897149
1992,"TENNESSEE",4,98984,50340,154511,"JIM COOPER","DALE JOHNSON","Democrat",0.640627528137155,48644,149324,0.325761431518041
1992,"TENNESSEE",5,125233,49417,187590,"BOB CLEMENT","TOM STONE","Democrat",0.667588890665814,75816,174650,0.434102490695677
1992,"TENNESSEE",6,120177,86289,212428,"BART GORDON","MARSHA BLACKBURN","Democrat",0.565730506336265,33888,206466,0.164133561942402
1992,"TENNESSEE",7,72062,125101,202866,"DAVID R DAVIS","DON SUNDQUIST","Republican",0.616668145475338,-53039,197163,-0.269010919898764
1992,"TENNESSEE",9,123276,60606,212755,"HAROLD E FORD","CHARLES L BLACK","Democrat",0.579427040492585,62670,183882,0.340816393121676
1992,"TEXAS",2,118625,92176,211350,"CHARLES WILSON","DONNA PETERSON","Democrat",0.561272770286255,26449,210801,0.125469044264496
1992,"TEXAS",4,128008,83875,220333,"RALPH M HALL","DAVID L BRIDGES","Democrat",0.580975160325507,44133,211883,0.20828948051519
1992,"TEXAS",5,98567,62419,167330,"JOHN BRYANT","RICHARD STOKLEY","Democrat",0.58905755094723,36148,160986,0.224541264457779
1992,"TEXAS",6,73933,189140,263073,"JOHN DIETRICH","JOE BARTON","Republican",0.718963937766323,-115207,263073,-0.437927875532647
1992,"TEXAS",8,53473,179349,232822,"CHAS ROBINSON","JACK FIELDS","Republican",0.770326687340543,-125876,232822,-0.540653374681087
1992,"TEXAS",9,118690,96270,221361,"JACK BROOKS","STEVE STOCKMAN","Democrat",0.536182977127859,22420,214960,0.104298474134723
1992,"TEXAS",10,177233,68646,261892,"J J PICKLE","HERBERT SPIRO","Democrat",0.676740793915049,108587,245879,0.441627792532099
1992,"TEXAS",11,119999,58033,178032,"CHET EDWARDS","JAMES W BROYLES","Democrat",0.674030511368743,61966,178032,0.348061022737485
1992,"TEXAS",12,125492,74432,199924,"PETE GEREN","DAVID HOBBS","Democrat",0.627698525439667,51060,199924,0.255397050879334
1992,"TEXAS",13,117892,77514,195406,"BILL SARPALIUS","BEAU BOULTER","Democrat",0.60331821950196,40378,195406,0.20663643900392
1992,"TEXAS",14,135930,54412,199671,"GREG LAUGHLIN","HUMBERTO J ""BERT"" GARZA","Democrat",0.680769866430278,81518,190342,0.428271217072428
1992,"TEXAS",15,86351,56549,142900,"E DE LA GARZA","TOM HAUGHEY","Democrat",0.604275717284815,29802,142900,0.208551434569629
1992,"TEXAS",16,66731,61870,128601,"RONALD D COLEMAN","CHIP TABERSKI","Democrat",0.51889954199423,4861,128601,0.0377990839884604
1992,"TEXAS",17,136213,69958,206171,"CHARLES W STENHOLM","JEANNIE SADOWISKI","Democrat",0.660679727022714,66255,206171,0.321359454045428
1992,"TEXAS",18,111422,56080,172208,"CRAIG A WASHINGTON","EDWARD BLUM","Democrat",0.647019882932268,55342,167502,0.330396054972478
1992,"TEXAS",19,47325,162057,209382,"TERRY LEE MOSER","LARRY COMBEST","Republican",0.773977705819984,-114732,209382,-0.547955411639969
1992,"TEXAS",21,62827,190979,264653,"JAMES M GADDY","LAMAR S SMITH","Republican",0.721620385939324,-128152,253806,-0.504921081455915
1992,"TEXAS",22,67812,150221,218033,"RICHARD KONRAD","TOM DELAY","Republican",0.688982860392693,-82409,218033,-0.377965720785386
1992,"TEXAS",23,63797,98259,166347,"ALBERT G BUSTAMANTE","HENRY BONILLA","Republican",0.590686937546214,-34462,162056,-0.212654884731204
1992,"TEXAS",24,104174,70042,174216,"MARTIN FROST","STEVE MASTERSON","Democrat",0.597958855673417,34132,174216,0.195917711346834
1992,"TEXAS",25,98975,73192,176877,"MICHAEL A ANDREWS","DOLLY MADISON MCKENNA","Democrat",0.559569644442183,25783,172167,0.14975576039543
1992,"TEXAS",26,55237,150209,205531,"JOHN WAYNE CATON","RICHARD K ARMEY","Republican",0.730833791496173,-94972,205446,-0.462272324601112
1992,"TEXAS",27,87022,66853,156844,"SOLOMON P ORTIZ","JAM KIMBROUGH","Democrat",0.554831552370508,20169,153875,0.131073923639318
1992,"TEXAS",29,64064,34609,98673,"GENE GREEN","CLARK KENT ERVIN","Democrat",0.649255622105338,29455,98673,0.298511244210676
1992,"TEXAS",30,107831,37853,150747,"EDDIE BERNICE JOHNSON","LUCY CAIN","Democrat",0.715311084134344,69978,145684,0.480341012053486
1992,"UTAH",1,68712,160037,245254,"RON HOLT","JAMES V HANSEN","Republican",0.652535738458904,-91325,228749,-0.399236717974723
1992,"UTAH",2,127738,118307,252969,"KAREN SHEPGERD","ENID GREENE","Democrat",0.504955152607632,9431,246045,0.0383303867178768
1992,"UTAH",3,135029,84019,228061,"BILL ORTON","RICHARD R HARRINGTON","Democrat",0.592074050363719,51010,219048,0.23287133413681
1992,"VERMONT",0,22279,86901,281162,"LEWIS E YOUNG","TIM PHILBIN","Republican",0.30907804041798,-64622,109180,-0.591884960615497
1992,"VIRGINIA",1,89814,133537,232051,"ANDREW H ""ANDY"" FOX","HERBERT H BATEMAN","Republican",0.57546401437615,-43723,223351,-0.19575914144105
1992,"VIRGINIA",2,99253,77797,177133,"OWEN B PICKETT","J L ""JIM"" CHAPMAN IV","Democrat",0.560330373222381,21456,177050,0.121186105619881
1992,"VIRGINIA",3,132432,35780,168473,"ROBERT C SCOTT","DANIEL ""DAN"" JENKINS","Democrat",0.786072545749171,96652,168212,0.574584452952227
1992,"VIRGINIA",4,147649,68286,215960,"NORMAN SISISKY","A J ""TONY"" ZEVGOLIS","Democrat",0.683686793850713,79363,215935,0.367531896172459
1992,"VIRGINIA",5,133031,60030,193084,"L F PAYNE","W A ""BILL"" HURLBURT","Democrat",0.688979925835388,73001,193061,0.378124012617774
1992,"VIRGINIA",6,84618,127309,212087,"STEPHEN ALAN MUSSELWHITE","BOB GOODLATTE","Republican",0.600267814623244,-42691,211927,-0.201442005973755
1992,"VIRGINIA",8,138542,102717,247126,"JAMES P MORAN","KYLE E MCSLARROW","Democrat",0.560612804804027,35825,241259,0.148491869733357
1992,"VIRGINIA",9,133284,77985,211295,"RICK BOUCHER","L GARRETT ""GARY"" WEDDLE","Democrat",0.630795806810384,55299,211269,0.261746872470642
1992,"VIRGINIA",10,75775,144471,221004,"RAYMOND E ""RAY"" VICKERY JR","FRANK R WOLF","Republican",0.653703100396373,-68696,220246,-0.311905778084505
1992,"VIRGINIA",11,114172,103119,228272,"LESLIE L BYRNE","HENRY N BUTLER","Democrat",0.50015770659564,11053,217291,0.0508672701584511
1992,"WASHINGTON",1,148844,113897,271274,"MARIA CANTWELL","GARY NELSON","Democrat",0.548685093300501,34947,262741,0.133009313354216
1992,"WASHINGTON",2,133207,107365,255920,"AL SWIFT","JACK METCALF","Democrat",0.520502500781494,25842,240572,0.107418984753005
1992,"WASHINGTON",3,138043,108583,246626,"JOLENE UNSOELD","PAT FISKE","Democrat",0.559726062945513,29460,246626,0.119452125891025
1992,"WASHINGTON",4,106556,103028,209584,"JAY INSLEE","RICHARD ""DOC"" HASTINGS","Democrat",0.508416673028475,3528,209584,0.0168333460569509
1992,"WASHINGTON",5,135965,110443,246408,"THOMAS S FOLEY","JOHN SONNELAND","Democrat",0.551788091295737,25522,246408,0.103576182591474
1992,"WASHINGTON",6,152933,66664,238162,"NORMAN D DICKS","LAURI J PHILLIPS","Democrat",0.642138544352164,86269,219597,0.392851450611803
1992,"WASHINGTON",7,222604,54149,283950,"JIM MCDERMOTT","GLENN C HAMPSON","Democrat",0.783954921641134,168455,276753,0.60868355537248
1992,"WASHINGTON",8,87611,155874,258171,"GEORGE O TAMBLYN","JENNIFER DUNN","Republican",0.603762622447912,-68263,243485,-0.280358132944535
1992,"WASHINGTON",9,110902,91910,212919,"MIKE KREIDLER","PETE VON REICHBAUER","Democrat",0.520864741991086,18992,202812,0.09364337415932
1992,"WEST VIRGINIA",2,143988,59102,203090,"ROBERT E WISE JR","SAMUEL A CRAVOTTA","Democrat",0.708986163769757,84886,203090,0.417972327539515
1992,"WEST VIRGINIA",3,122279,64012,186291,"NICK JOE RAHALL II","BEN WALDMAN","Democrat",0.656387050367436,58267,186291,0.312774100734872
1992,"WISCONSIN",1,147495,104352,256280,"LES ASPIN","MARK W NEUMANN","Democrat",0.575522865615733,43143,251847,0.171306388402482
1992,"WISCONSIN",2,108291,183366,292898,"ADA E DEER","SCOTT L KLUG","Republican",0.626040464598597,-75075,291657,-0.257408531254179
1992,"WISCONSIN",3,108664,146903,260335,"PAUL SACIA","STEVE GUNDERSON","Republican",0.564284479612807,-38239,255567,-0.149624169004605
1992,"WISCONSIN",4,173482,84872,263803,"GERALD D KLECZKA","JOSEPH L COOK","Democrat",0.657619511529437,88610,258354,0.34297901329184
1992,"WISCONSIN",5,162344,71085,234176,"THOMAS M BARRETT","DONALDA ANN HAMMERSMITH","Democrat",0.693256354195135,91259,233429,0.390949710618646
1992,"WISCONSIN",6,128232,143875,272137,"PEGGY A LAUTENSCHLAGER","THOMAS E PETRI","Republican",0.528685919224508,-15643,272107,-0.0574884144840081
1992,"WISCONSIN",7,166200,91772,257982,"DAVID R OBEY","DALE R VANNES","Democrat",0.644230992859967,74428,257972,0.288511931527453
1992,"WISCONSIN",8,81792,191704,273532,"CATHERINE L HELMS","TOBY ROTH","Republican",0.700846701665619,-109912,273496,-0.401877906806681
1992,"WISCONSIN",9,77362,192898,276787,"INGRID K BUXTON","F JAMES SENSENBRENNER JR","Republican",0.696918569152453,-115536,270260,-0.427499444978909
1992,"WYOMING",0,77418,113882,196977,"JON HERSCHLER","CRAIG THOMAS","Republican",0.578148717870614,-36464,191300,-0.1906116048092
1994,"ALABAMA",1,50227,103431,153767,"DON WOMACK","SONNY CALLAHAN","Republican",0.672647577178458,-53204,153658,-0.346249463093363
1994,"ALABAMA",2,44694,124465,169213,"BRIAN DOWLING","TERRY EVERETT","Republican",0.735552232984463,-79771,169159,-0.471574081189886
1994,"ALABAMA",3,93924,53757,147745,"GLEN BROWDER","BEN HAND","Democrat",0.635716944735862,40167,147681,0.271984886342861
1994,"ALABAMA",5,88693,86923,175693,"ROBERT E ""BUD"" CRAMER JR","WAYNE PARKER","Democrat",0.50481806332637,1770,175616,0.0100788083090379
1994,"ALABAMA",6,41030,155047,196222,"LARRY FORTENBERRY","SPENCER BACHUS","Republican",0.790161144010356,-114017,196077,-0.581490944883898
1994,"ALABAMA",7,116150,34814,151117,"EARL F HILLIARD","ALFRED J MIDDLETON SR","Democrat",0.768609752708167,81336,150964,0.538777456877136
1994,"ALASKA",0,68172,118537,208240,"TONY SMITH","DON YOUNG","Republican",0.569232616212063,-50365,186709,-0.26975132425325
1994,"ARIZONA",1,70627,101350,180867,"CHUCK BLANCHARD","MATT SALMON","Republican",0.560356505056201,-30723,171977,-0.178645981730115
1994,"ARIZONA",2,62589,32797,100446,"ED PASTOR","ROBERT MACDONALD","Democrat",0.623110925273281,29792,95386,0.312330950034596
1994,"ARIZONA",3,61939,145396,207335,"HOWARD LEE SPRAGUE","BOB STUMP","Republican",0.701261243880676,-83457,207335,-0.402522487761352
1994,"ARIZONA",4,69760,116714,193902,"CAROL CURE","JOHN B SHADEGG","Republican",0.601922620705305,-46954,186474,-0.251799178437745
1994,"ARIZONA",5,63436,149514,220771,"GARY AUERBACH","JIM KOLBE","Republican",0.677235687658252,-86078,212950,-0.404216952336229
1994,"ARIZONA",6,81321,107060,196068,"KARAN ENGLISH","J D HAYWORTH","Republican",0.54603504906461,-25739,188381,-0.136632675269799
1994,"ARKANSAS",1,95290,83147,178437,"BLANCHE M LAMBERT","WARREN DUPWE","Democrat",0.534026014783929,12143,178437,0.0680520295678587
1994,"ARKANSAS",2,97580,72473,170053,"RAY THORNTON","BILL POWELL","Democrat",0.573821102832646,25107,170053,0.147642205665293
1994,"ARKANSAS",3,61883,129800,191683,"BERTA L SEITZ","Y TIM HUTCHINSON","Republican",0.677159685522451,-67917,191683,-0.354319371044902
1994,"ARKANSAS",4,81370,87469,168839,"JAY BRADFORD","JAY DICKEY","Republican",0.518061585297236,-6099,168839,-0.0361231705944717
1994,"CALIFORNIA",1,93717,106870,200673,"DAN HAMBURG","FRANK RIGGS","Republican",0.532557942523409,-13153,200587,-0.0655725445816528
1994,"CALIFORNIA",2,55959,137864,214860,"MARY JACOBS","WALLY HERGER","Republican",0.641645722796239,-81905,193823,-0.422576268038365
1994,"CALIFORNIA",3,97093,89964,195157,"VIC FAZIO","TIM LEFEVER","Democrat",0.497512259360412,7129,187057,0.0381113778153183
1994,"CALIFORNIA",4,82505,144936,236323,"KATIE HIRNING","JOHN T DOOLITTLE","Republican",0.613296209002086,-62431,227441,-0.274493165260441
1994,"CALIFORNIA",5,125042,52905,182596,"ROBERT T MATSUI","ROBERT S DINSMORE","Democrat",0.684801419527262,72137,177947,0.405384749391673
1994,"CALIFORNIA",6,137642,88940,236840,"LYNN C WOOLSEY","MICHAEL J NUGENT","Democrat",0.58116027698024,48702,226582,0.214942051884086
1994,"CALIFORNIA",7,116105,45698,166601,"GEORGE MILLER","CHARLES V HUGHES","Democrat",0.696904580404679,70407,161803,0.435140263159521
1994,"CALIFORNIA",8,137642,30528,168171,"NANCY PELOSI","ELSA C CHEUNG","Democrat",0.818464539070351,107114,168170,0.636938811916513
1994,"CALIFORNIA",9,129233,40448,178875,"RONALD V DELLUMS","DEBORAH WRIGHT","Democrat",0.722476589797345,88785,169681,0.523246562667594
1994,"CALIFORNIA",10,90523,138916,234241,"ELLEN SCHWARTZ","BILL BAKER","Republican",0.593047331594384,-48393,229439,-0.210918806305815
1994,"CALIFORNIA",11,55794,99302,159814,"RANDY A PERRY","RICHARD W POMBO","Republican",0.621359830803309,-43508,155096,-0.280523030896993
1994,"CALIFORNIA",12,118408,57228,175636,"TOM LANTOS","DEBORAH WILDER","Democrat",0.674167027260926,61180,175636,0.348334054521852
1994,"CALIFORNIA",13,97344,45555,150642,"FORTNEY PETE STARK","LARRY MOLTON","Democrat",0.646194288445453,51789,142899,0.362416811874121
1994,"CALIFORNIA",14,120713,78475,199188,"ANNA G ESHOO","BEN BRINK","Democrat",0.606025463381328,42238,199188,0.212050926762656
1994,"CALIFORNIA",15,119921,80266,200204,"NORMAN Y MINETA","ROBERT WICK","Democrat",0.598994026093385,39655,200187,0.198089786050043
1994,"CALIFORNIA",16,74935,40409,115352,"ZOE LOFGREN","LYLE J SMITH","Democrat",0.649620292669395,34526,115344,0.299330697738937
1994,"CALIFORNIA",17,87222,74380,167193,"SAM FARR","BILL MCCAMPBELL","Democrat",0.52168452028494,12842,161602,0.0794668382817044
1994,"CALIFORNIA",18,91106,44046,139054,"GARY A CONDIT","TOM CARTER","Democrat",0.655184316884088,47060,135152,0.348200544572037
1994,"CALIFORNIA",19,72912,104435,183926,"RICHARD H LEHMAN","GEORGE P RADANOVICH","Republican",0.567809880060459,-31523,177347,-0.177747579603828
1994,"CALIFORNIA",20,57394,43836,101230,"CALVIN M DOOLEY","PAUL YOUNG","Democrat",0.566966314333696,13558,101230,0.133932628667391
1994,"CALIFORNIA",21,47517,116874,171629,"JOHN L EVANS","WILLIAM M THOMAS","Republican",0.68096883393832,-69357,164391,-0.421902658904685
1994,"CALIFORNIA",22,101424,102987,209008,"WALTER HOLDEN CAPPS","ANDREA H SEASTRAND","Republican",0.492741904616091,-1563,204411,-0.00764635954033785
1994,"CALIFORNIA",23,47345,114043,172340,"KEVIN READY","ELTON GALLEGLY","Republican",0.661732621562029,-66698,161388,-0.413277319255459
1994,"CALIFORNIA",24,95342,91806,193179,"ANTHONY C BEILENSON","RICH SYBERT","Democrat",0.493542258734127,3536,187148,0.0188941372603501
1994,"CALIFORNIA",25,53445,110301,169971,"JAMES H GILMARTIN","HOWARD P ""BUCK"" MCKEON","Republican",0.648940113313448,-56856,163746,-0.34722069546737
1994,"CALIFORNIA",26,55145,28423,88138,"HOWARD L BERMAN","GARY E FORSCH","Democrat",0.625666568336019,26722,83568,0.319763545854873
1994,"CALIFORNIA",27,70267,88341,166774,"DOUG KAHN","CARLOS J MOORHEAD","Republican",0.529704870063679,-18074,158608,-0.113953898920609
1994,"CALIFORNIA",28,50022,110179,164277,"TOMMY RANDLE","DAVID DREIER","Republican",0.670690358358139,-60157,160201,-0.375509516170311
1994,"CALIFORNIA",29,129413,53801,190376,"HENRY A WAXMAN","PAUL STEPANEK","Democrat",0.679775812077153,75612,183214,0.41269771960658
1994,"CALIFORNIA",30,43943,18741,66425,"XAVIER BECERRA","DAVID A RAMIREZ","Democrat",0.661543093714716,25202,62684,0.402048369599898
1994,"CALIFORNIA",31,50541,34926,85467,"MATTHEW G MARTINEZ","JOHN V FLORES","Democrat",0.591351047772825,15615,85467,0.182702095545649
1994,"CALIFORNIA",32,98017,22190,126306,"JULIAN C DIXON","ERNIE A FARHAT","Democrat",0.776028058841227,75827,120207,0.630803530576422
1994,"CALIFORNIA",34,72439,40068,117455,"ESTEBAN EDWARD TORRES","ALBERT J NUNEZ","Democrat",0.616738325316079,32371,112507,0.287724319375683
1994,"CALIFORNIA",35,65688,18390,84081,"MAXINE WATERS","NATE TRUMAN","Democrat",0.781246655011239,47298,84078,0.56254906158567
1994,"CALIFORNIA",36,93939,93127,195808,"JANE HARMAN","SUSAN BROOKS","Democrat",0.479750571988887,812,187066,0.0043407139726086
1994,"CALIFORNIA",38,53681,85225,145769,"PETER MATHEWS","STEPHAN HORN","Republican",0.58465791766425,-31544,138906,-0.227088822657049
1994,"CALIFORNIA",39,49696,113641,171244,"R O ""BOB"" DAVIS","EDWARD R ROYCE","Republican",0.663620331223284,-63945,163337,-0.391491211421784
1994,"CALIFORNIA",40,48003,115728,163731,"DONALD ""DON"" M RUSK","JERRY LEWIS","Republican",0.706817890320098,-67725,163731,-0.413635780640196
1994,"CALIFORNIA",41,50043,82100,132143,"ED TESSIER","JAY KIM","Republican",0.62129662562527,-32057,132143,-0.242593251250539
1994,"CALIFORNIA",42,58888,56259,115205,"GEORGE E BROWN JR","ROB GUZMAN","Democrat",0.511158369862419,2629,115147,0.0228316847160586
1994,"CALIFORNIA",43,59342,84500,154386,"MARK A TAKANO","KEN CALVERT","Republican",0.547329421061495,-25158,143842,-0.174900237760877
1994,"CALIFORNIA",44,65370,95521,171776,"STEVE CLUTE","SONNY BONO","Republican",0.556078846870343,-30151,160891,-0.187400165329322
1994,"CALIFORNIA",45,55849,124875,180724,"BRETT WILLIAMSON","DANA ROHRABACHER","Republican",0.690970762045993,-69026,180724,-0.381941524091986
1994,"CALIFORNIA",46,33004,50616,88697,"MICHAEL P ""MIKE"" FARBER","ROBERT K DORNAN","Republican",0.570661916412055,-17612,83620,-0.210619469026549
1994,"CALIFORNIA",47,53669,154071,214997,"GARY KINGSBURY","CHRISTOPHER COX","Republican",0.716619301664674,-100402,207740,-0.483306055646481
1994,"CALIFORNIA",48,43523,143570,195636,"ANDREI LESCHICK","RON PACKARD","Republican",0.733862888220982,-100047,187093,-0.534744752609665
1994,"CALIFORNIA",49,85597,90283,186118,"LYNN SCHENK","BRIAN P BILBRAY","Republican",0.485084731192039,-4686,175880,-0.0266431657948601
1994,"CALIFORNIA",50,59214,36955,104451,"BOB FILNER","MARY AICE ACEVEDO","Democrat",0.566906970732688,22259,96169,0.231457122357516
1994,"CALIFORNIA",51,57374,138547,206988,"RITA K TAMERIUS","RANDY ""DUKE"" CUNNINGHAM","Republican",0.669347981525499,-81173,195921,-0.414314953476146
1994,"CALIFORNIA",52,53024,109201,170686,"JANET M GATIL","DUNCAN HUNTER","Republican",0.639777134621469,-56177,162225,-0.346290645708121
1994,"COLORADO",1,93123,61978,155255,"PATRICIA SCHROEDER","WILLIAM F EGGERT","Democrat",0.599806769508228,31145,155101,0.200804636978485
1994,"COLORADO",2,105938,80723,186661,"DAVID E SKAGGS","PATRICIA ""PAT"" MILLER","Democrat",0.567542228960522,25215,186661,0.135084457921044
1994,"COLORADO",3,63427,145365,208792,"LINDA POWERS","SCOTT MCINNIS","Republican",0.696219203800912,-81938,208792,-0.392438407601824
1994,"COLORADO",4,52202,136251,188453,"CATHY KIPP","WAYNE ALLARD","Republican",0.722997245997676,-84049,188453,-0.445994491995352
1994,"COLORADO",6,49701,124079,177709,"JOHN HALLEN","DAN SCHAEFER","Republican",0.698214496733424,-74378,173780,-0.428000920704339
1994,"CONNECTICUT",1,88946,46865,188907,"BARBARA B KENNELLY","DOUGLAS T PUTNAM","Democrat",0.470845442466399,42081,135811,0.309849717622284
1994,"CONNECTICUT",2,79188,79167,186073,"SAM GEJDENSON","EDWARD W MUNSTER","Democrat",0.425574908772364,21,158355,0.000132613431846168
1994,"CONNECTICUT",3,111261,53110,175355,"ROSA L DELAURO","SUSAN JOHNSON","Democrat",0.63449003450144,58151,164371,0.35377895127486
1994,"CONNECTICUT",4,34962,109436,147062,"JONATHAN D KANTROWITZ","CHRISTOPHER SHAYS","Republican",0.74414872638751,-74474,144398,-0.515755065859638
1994,"CONNECTICUT",5,57579,93471,179053,"JAMES H MALONEY","GARY A FRANKS","Republican",0.52202979006216,-35892,151050,-0.237616683217478
1994,"CONNECTICUT",6,44159,123101,192717,"CHARLOTTE KOSKOFF","NANCY L JOHNSON","Republican",0.638765651188011,-78942,167260,-0.471971780461557
1994,"DELAWARE",0,51793,137945,195008,"CAROL ANN DESANTIS","MICHAEL N CASTLE","Republican",0.707381235641615,-86152,189738,-0.454057700618748
1994,"FLORIDA",1,70416,112974,183520,"VINCE WHIBBS JR","JOE SCARBOROUGH","Republican",0.615595030514385,-42558,183390,-0.232062816947489
1994,"FLORIDA",2,117420,74040,191468,"DOUGLAS ""PETE"" PETERSON","CAROLE GRIFFIN","Democrat",0.613261746088119,43380,191460,0.226574741460357
1994,"FLORIDA",3,63855,46907,110762,"CORRINE BROWN","MARC LITTLE","Democrat",0.576506383055561,16948,110762,0.153012766111121
1994,"FLORIDA",5,125792,94097,219889,"KAREN L THURMAN","DON ""BIG DADDY"" GARLITS","Democrat",0.572070453728927,31695,219889,0.144140907457854
1994,"FLORIDA",7,47758,131731,179489,"EDWARD D GODDARD","JOHN L MICA","Republican",0.733922413072667,-83973,179489,-0.467844826145335
1994,"FLORIDA",11,76821,72129,148959,"SAM GIBBONS","MARK SHARPE","Democrat",0.515719090487987,4692,148950,0.0315005035246727
1994,"FLORIDA",12,57210,106140,163350,"ROBERT CONNORS","CHARLES T CANADY","Republican",0.649770431588613,-48930,163350,-0.299540863177227
1994,"FLORIDA",15,100526,117044,217902,"SUE MUNSEY","DVE WELDON","Republican",0.5371405494213,-16518,217570,-0.0759203934365951
1994,"FLORIDA",16,88653,122760,211413,"JOHN COMERFORD","MARK ADAM FOLEY","Republican",0.580664386769026,-34107,211413,-0.161328773538051
1994,"FLORIDA",19,147595,75788,223383,"HARRY JOHNSTON","PETER J TSAKANIKAS","Democrat",0.660726196711478,71807,223383,0.321452393422955
1994,"FLORIDA",20,114623,72525,187148,"PETER DEUTSCH","BEVERLY ""BEV"" KENNEDY","Democrat",0.612472481672259,42098,187148,0.224944963344519
1994,"FLORIDA",22,69221,119696,188917,"HERMINE L WIENER","E CLAY SHAW JR","Republican",0.63359041272093,-50475,188917,-0.267180825441861
1994,"GEORGIA",1,27197,88788,115985,"RAYMOND BECKWORTH","JACK KINGSTON","Republican",0.765512781825236,-61591,115985,-0.531025563650472
1994,"GEORGIA",2,65383,33429,98813,"SANFORD D BISHOP JR","JOHN CLAYTON","Democrat",0.66168419135134,31954,98812,0.323381775492855
1994,"GEORGIA",3,49828,94717,144545,"FRED OVERBY","MAC COLLINS","Republican",0.655276903386489,-44889,144545,-0.310553806772977
1994,"GEORGIA",4,65566,90063,155629,"COMER YATES","JOHN LINDER","Republican",0.578703197990092,-24497,155629,-0.157406395980184
1994,"GEORGIA",5,85094,37999,123093,"JOHN LEWIS","DALE DIXON","Democrat",0.691298449140081,47095,123093,0.382596898280162
1994,"GEORGIA",6,66700,119432,186132,"BEN JONES","NEWT GINGRICH","Republican",0.641652160832098,-52732,186132,-0.283304321664195
1994,"GEORGIA",7,65978,71265,137243,"GEORGE ""BUDDY"" DARDEN","BOB BARR","Republican",0.519261455957681,-5287,137243,-0.0385229119153618
1994,"GEORGIA",8,53408,89591,142999,"CRAIG MATHIS","SAXBY CHAMBLISS","Republican",0.626514870733362,-36183,142999,-0.253029741466724
1994,"GEORGIA",9,79145,57568,136713,"NATHAN DEAL","ROBERT L CASTELLO","Democrat",0.578913490304507,21577,136713,0.157826980609013
1994,"GEORGIA",10,51192,96099,147291,"DON JOHNSON","CHARLIE NORWOOD","Republican",0.652443122797727,-44907,147291,-0.304886245595454
1994,"GEORGIA",11,71560,37533,109093,"CYNTHIA A MCKINNEY","WOODROW LOVETT","Democrat",0.655954094213194,34027,109093,0.311908188426389
1994,"HAWAII",1,94754,76623,176706,"NEIL ABERCROMBIE","ORSON SWINDLE","Democrat",0.536224010503322,18131,171377,0.105795993628083
1994,"HAWAII",2,124431,42891,177396,"PATSY T MINK","ROBERT H ""LOPAKA"" GARNER","Democrat",0.701430697422715,81540,167322,0.487323842650697
1994,"IDAHO",1,89826,111728,201554,"LARRY LAROCCO","HELEN CHENOWETH","Republican",0.554332833880747,-21902,201554,-0.108665667761493
1994,"IDAHO",2,47936,143593,191529,"PENNY FLETCHER","MICHAEL D CRAPO","Republican",0.749719363647281,-95657,191529,-0.499438727294561
1994,"ILLINOIS",1,112474,36038,148512,"BOBBY L RUSH","WILLIAM J KELLY","Democrat",0.757339474251239,76436,148512,0.514678948502478
1994,"ILLINOIS",3,92353,78163,170516,"WILLIAM O LIPINSKI","JIM NALEPA","Democrat",0.541608998569049,14190,170516,0.0832179971380985
1994,"ILLINOIS",4,46695,15384,62079,"LUIS V GUTIERREZ","STEVEN VALTIERRA","Democrat",0.752186729812014,31311,62079,0.504373459624027
1994,"ILLINOIS",5,63065,75328,138393,"DAN ROSTENKOWSKI","MICHAEL PATRICK FLANAGAN","Republican",0.544304986523885,-12263,138393,-0.0886099730477698
1994,"ILLINOIS",6,37163,115664,157378,"TOM BERRY","HENRY J HYDE","Republican",0.734943893047313,-78501,152827,-0.513659235606274
1994,"ILLINOIS",7,93457,24011,117468,"CARDISS COLLINS","CHARLES ""CHUCK"" MOBLEY","Democrat",0.795595396193006,69446,117468,0.591190792386011
1994,"ILLINOIS",8,47654,88225,135879,"ROBERT C WALBERG","PHILIP M CRANE","Republican",0.649290913238985,-40571,135879,-0.298581826477969
1994,"ILLINOIS",9,94404,48419,142823,"SIDNEY R YATES","GEORGE EDWARD LARNEY","Democrat",0.66098597564818,45985,142823,0.32197195129636
1994,"ILLINOIS",10,38191,114884,153075,"ANDREW M KRUPP","JOHN EDWARD PORTER","Republican",0.750507920953781,-76693,153075,-0.501015841907562
1994,"ILLINOIS",11,63150,97241,160395,"FRANK GIGLIO","JERRY WELLER","Republican",0.606259546743976,-34091,160391,-0.212549332568536
1994,"ILLINOIS",12,101391,52419,153810,"JERRY F COSTELLO","JAN MORRIS","Democrat",0.659196411156622,48972,153810,0.318392822313244
1994,"ILLINOIS",13,45709,124312,170021,"WILLIAM A RILEY","HARRIS W FAWELL","Republican",0.731156739461596,-78603,170021,-0.462313478923192
1994,"ILLINOIS",14,33891,110204,144095,"STEVE DENARI","J DENNIS HASTERT","Republican",0.764800999340713,-76313,144095,-0.529601998681425
1994,"ILLINOIS",15,50874,108857,159731,"PAUL ALEXANDER","THOMAS W EWING","Republican",0.681502025280002,-57983,159731,-0.363004050560004
1994,"ILLINOIS",16,48736,117238,165974,"PETE SULLIVAN","DONALD A MANZULLO","Republican",0.706363647318255,-68502,165974,-0.412727294636509
1994,"ILLINOIS",17,95312,79471,174783,"LANE EVANS","JIM ANDERSON","Democrat",0.545316192078177,15841,174783,0.0906323841563539
1994,"ILLINOIS",18,78332,119838,199125,"G DOUGLAS STEPHENS","RAY LAHOOD","Republican",0.601822975517891,-41506,198170,-0.209446434879144
1994,"ILLINOIS",19,115045,81995,197040,"GLENN POSHARD","BRENT WINTERS","Democrat",0.583866220056841,33050,197040,0.167732440113682
1994,"ILLINOIS",20,108034,88964,196998,"RICHARD J DURBIN","BILL OWENS","Democrat",0.54840150661428,19070,196998,0.0968030132285607
1994,"INDIANA",1,68612,52920,121532,"PETER J VISCLOSKY","JOHN LARSON","Democrat",0.564559128459994,15692,121532,0.129118256919988
1994,"INDIANA",2,78241,93592,171833,"JOSEPH H HOGSETT","DAVID M MCINTOSH","Republican",0.544668369870747,-15351,171833,-0.0893367397414932
1994,"INDIANA",3,72497,58878,131375,"TIM ROEMER","RICHARD BURKETT","Democrat",0.551832540437678,13619,131375,0.103665080875357
1994,"INDIANA",4,71235,88584,159819,"JILL L LONG","MARK E SOUDER","Republican",0.554277025885533,-17349,159819,-0.108554051771066
1994,"INDIANA",5,45224,111031,159658,"J D BEATTY","STEPHEN E BUYER","Republican",0.695430232121159,-65807,156255,-0.421151323157659
1994,"INDIANA",6,40815,136876,177691,"NATALIE M BRUNER","DAN BURTON","Republican",0.770303504398084,-96061,177691,-0.540607008796169
1994,"INDIANA",7,55941,104359,160300,"MICHAEL M HARMLESS","JOHN T MYERS","Republican",0.651023081721772,-48418,160300,-0.302046163443543
1994,"INDIANA",8,84857,93529,178386,"FRANK MCCLOSKEY","JOHN N HOSTETTLER","Republican",0.524306840222887,-8672,178386,-0.0486136804457749
1994,"INDIANA",9,91459,84315,175774,"LEE H HAMILTON","JEAN LEISING","Democrat",0.520321549262121,7144,175774,0.0406430985242414
1994,"INDIANA",10,58573,50998,109571,"ANDREW JACOBS JR","MARVIN BAILEY SCOTT","Democrat",0.53456662803114,7575,109571,0.0691332560622793
1994,"IOWA",1,69461,110448,183461,"GLEN WINEKAUF","JAMES A LEACH","Republican",0.602024408457383,-40987,179909,-0.227820731592083
1994,"IOWA",2,86087,111076,198487,"DAVE NAGLE","JIM NUSSLE","Republican",0.559613475945528,-24989,197163,-0.126742847288792
1994,"IOWA",3,79310,111862,193531,"ELAINE BAXTER","JIM LIGHTFOOT","Republican",0.578005590835577,-32552,191172,-0.170275981838345
1994,"IOWA",4,98824,111935,213206,"NEAL SMITH","GREG GANSKE","Republican",0.525008677054117,-13111,210759,-0.062208494061938
1994,"IOWA",5,73627,114796,188721,"SHEILA MCGUIRE","TOM LATHAM","Republican",0.608284186709481,-41169,188423,-0.218492434575397
1994,"KANSAS",1,49477,169531,219008,"TERRY L NICHOLS","PAT ROBERTS","Republican",0.774085878141438,-120054,219008,-0.548171756282876
1994,"KANSAS",2,71025,135725,206750,"JOHN CARLIN","SAM BROWNBACK","Republican",0.656469165659008,-64700,206750,-0.312938331318017
1994,"KANSAS",3,78401,102218,180619,"JUDY HANCOCK","JAN MEYERS","Republican",0.565931601880201,-23817,180619,-0.131863203760402
1994,"KANSAS",4,99366,111653,211019,"DAN GLICKMAN","TODD TIAHRT","Republican",0.529113492149996,-12287,211019,-0.0582269842999919
1994,"KENTUCKY",1,62387,64849,127236,"THOMAS J BARLOW III","ED WHITFIELD","Republican",0.50967493476689,-2462,127236,-0.0193498695337797
1994,"KENTUCKY",2,60867,90535,151402,"DAVID ADKISSON","RON LEWIS","Republican",0.597977569649014,-29668,151402,-0.195955139298028
1994,"KENTUCKY",3,67663,67238,152523,"MIKE WARD","SUSAN B STOKES","Democrat",0.443624895917337,425,134901,0.00315045848437002
1994,"KENTUCKY",4,33717,96695,130412,"SALLY HARRIS SKAGGS","JIM BUNNING","Republican",0.741457841302948,-62978,130412,-0.482915682605895
1994,"KENTUCKY",5,21318,82291,103609,"WALTER ""DOC"" BLEVINS","HAROLD ROGERS","Republican",0.79424567363839,-60973,103609,-0.588491347276781
1994,"KENTUCKY",6,70085,49032,119117,"SCOTTY BAESLER","MATTHEW ERIC WILLS","Democrat",0.588371097324479,21053,119117,0.176742194648959
1994,"MAINE",1,126373,136316,262769,"DENNIS L DUTREMBLE","JAMES B LONGLEY JR","Republican",0.518767434514726,-9943,262689,-0.0378508426314006
1994,"MAINE",2,109615,97754,239894,"JOHN ELIAS BALDACCI","RICHARD A BENNETT","Democrat",0.45693097784855,11861,207369,0.0571975560474324
1994,"MARYLAND",1,57712,120975,178814,"RALPH T GIES","WAYNE T GILCHREST","Republican",0.676540986723635,-63263,178687,-0.354043662941344
1994,"MARYLAND",2,74275,125162,199480,"GERRY L BREWSTER","ROBERT L EHRLICH JR","Republican",0.627441347503509,-50887,199437,-0.255153256416813
1994,"MARYLAND",3,117269,47966,165235,"BENJAMIN L CARDIN","ROBERT RYAN TOUSEY","Democrat",0.709710412442884,69303,165235,0.419420824885769
1994,"MARYLAND",4,93148,30999,124147,"ALBERT RUSSELL WYNN","MICHELE DYSON","Democrat",0.750304075007854,62149,124147,0.500608150015707
1994,"MARYLAND",5,98821,69211,168045,"STENY H HOYER","DONALD DEVINE","Democrat",0.588062721294891,29610,168032,0.176216434964769
1994,"MARYLAND",6,63411,122809,186220,"PAUL MULDOWNEY","ROSCOE G BARTLETT","Republican",0.659483406723231,-59398,186220,-0.318966813446461
1994,"MARYLAND",7,97016,22007,119023,"KWEISI MFUME","KENNETH KONDNER","Democrat",0.815102963292809,75009,119023,0.630205926585618
1994,"MARYLAND",8,60660,143449,204109,"STEVEN VAN GRACK","CONSTANCE A MORELLA","Republican",0.702805853735014,-82789,204109,-0.405611707470028
1994,"MASSACHUSETTS",2,117178,72732,200123,"RICHARD E NEAL","JOHN M BRIARE","Democrat",0.585529899112046,44446,189910,0.234037175504186
1994,"MASSACHUSETTS",3,93689,115810,212035,"KEVIN O'SULLIVAN","PETER BLUTE","Republican",0.546183413115759,-22121,209499,-0.105590002816243
1994,"MASSACHUSETTS",5,140725,60734,201524,"MARTIN T MEEHAN","DAVID E COLEMAN","Democrat",0.69830392409837,79991,201459,0.397058458544915
1994,"MASSACHUSETTS",6,113481,120952,239444,"JOHN F TIERNEY","PETER G TORKILDSEN","Republican",0.505136900486126,-7471,234433,-0.0318683803048206
1994,"MASSACHUSETTS",7,146246,80674,226988,"EDWARD J MARKEY","BRAD BAILEY","Democrat",0.644289565968245,65572,226920,0.288965274105412
1994,"MASSACHUSETTS",9,146287,63369,209698,"JOHN JOSEPH MOAKLEY","MICHAEL M MURPHY","Democrat",0.69760798863127,82918,209656,0.395495478307322
1994,"MASSACHUSETTS",10,172753,78487,251309,"GERRY E STUDDS","KEITH JASON HEMEON","Democrat",0.687412707065803,94266,251240,0.375202993153956
1994,"MICHIGAN",1,121433,89660,213549,"BART STUPAK","GIL ZIEGLER","Democrat",0.568642325648914,31773,211093,0.150516596950159
1994,"MICHIGAN",2,46097,146164,194187,"MARCUS HOOVER","PETER HOEKSTRA","Republican",0.752697142445169,-100067,192261,-0.520474771274465
1994,"MICHIGAN",3,43580,136711,185077,"BETSY J FLORY","VERNON J EHLERS","Republican",0.738670931558216,-93131,180291,-0.516559340177824
1994,"MICHIGAN",4,50544,145176,198534,"DAMION FRASIER","DAVE CAMP","Republican",0.731239989120251,-94632,195720,-0.483507050889025
1994,"MICHIGAN",5,126456,61342,193190,"JAMES A BARCIA","WILLIAM T ANDERSON","Democrat",0.654568041824111,65114,187798,0.346723607280163
1994,"MICHIGAN",6,42348,121923,165966,"DAVID TAYLOR","FRED UPTON","Republican",0.734626369256354,-79575,164271,-0.484412951768724
1994,"MICHIGAN",7,57326,115621,177500,"KIM MCCAUGHTRY","NICK SMITH","Republican",0.651385915492958,-58295,172947,-0.337068581704222
1994,"MICHIGAN",8,95383,109663,212481,"BOB MITCHELL","DICK CHRYSLER","Republican",0.516107322537074,-14280,205046,-0.0696429093959404
1994,"MICHIGAN",9,97096,89148,189563,"DALE E KILDEE","MEGAN O'NEILL","Democrat",0.512209661168055,7948,186244,0.0426752002749082
1994,"MICHIGAN",10,121876,73862,195822,"DAVID E BONIOR","DONALD J LOBSINGER","Democrat",0.622381550591864,48014,195738,0.245297285146471
1994,"MICHIGAN",11,69168,154696,226884,"MIKE BRESHGOLD","JOE KNOLLENBERG","Republican",0.681828599636819,-85528,223864,-0.382053389557946
1994,"MICHIGAN",12,103508,92762,199018,"SANDER M LEVIN","JOHN PAPPAGEORGE","Democrat",0.520093659869961,10746,196270,0.0547511081673205
1994,"MICHIGAN",13,89573,77908,172678,"LYNN N RIVERS","JOHN A SCHALL","Democrat",0.518728500445917,11665,167481,0.0696496916068091
1994,"MICHIGAN",14,128463,26215,157631,"JOHN CONYERS JR","RICHARD CHARLES FOURNIER","Democrat",0.814960255279736,102248,154678,0.661037768784184
1994,"MICHIGAN",15,119442,20074,142014,"BARBARA-ROSE COLLINS","JOHN W SAVAGE II","Democrat",0.841057923866661,99368,139516,0.712233722297084
1994,"MICHIGAN",16,105849,71159,178980,"JOHN D DINGELL","KEN LARKIN","Democrat",0.59140127388535,34690,177008,0.195979842718973
1994,"MISSISSIPPI",1,47192,80553,127745,"BILL WHEELER","ROGER F WICKER","Republican",0.630576539199186,-33361,127745,-0.261153078398372
1994,"MISSISSIPPI",2,68014,49270,126692,"BENNIE G THOMPSON","BILL JORDAN","Democrat",0.536845262526442,18744,117284,0.159817195866444
1994,"MISSISSIPPI",3,83163,39826,122989,"G V ""SONNY"" MONTGOMER","DUTCH DABBS","Democrat",0.676182422818301,43337,122989,0.352364845636602
1994,"MISSISSIPPI",4,82939,38200,121139,"MIKE PARKER","MIKE WOOD","Democrat",0.68465977100686,44739,121139,0.36931954201372
1994,"MISSISSIPPI",5,73179,48575,121754,"GENE TAYLOR","GEORGE BARLOS","Democrat",0.601039801567094,24604,121754,0.202079603134189
1994,"MISSOURI",1,97061,50303,153018,"WILLIAM ""BILL"" CLAY","DONALD R COUNTS","Democrat",0.634310996091963,46758,147364,0.317295947449852
1994,"MISSOURI",2,70480,154882,230287,"PAT KELLY","JAMES M TALENT","Republican",0.67256076113719,-84402,225362,-0.374517443047186
1994,"MISSOURI",3,117601,80977,203940,"RICHARD A GEPHARD","GARY GILL","Democrat",0.576645091693635,36624,198578,0.184431306589854
1994,"MISSOURI",4,137876,65616,203492,"IKE SKELTON","JAMES A NOLAND JR","Democrat",0.677549977394689,72260,203492,0.355099954789377
1994,"MISSOURI",5,100391,77120,177511,"KAREN MCCARTHY","RON FREEMAN","Democrat",0.565548050543347,23271,177511,0.131096101086693
1994,"MISSOURI",6,140108,71709,211817,"PAT DANNER","TINA TUCKER","Democrat",0.661457767790121,68399,211817,0.322915535580241
1994,"MISSOURI",7,77836,112228,195916,"JAMES R FOSSARD","MEL HANCOCK","Republican",0.572837338451173,-34392,190064,-0.18094957488004
1994,"MISSOURI",8,49987,129320,185586,"JAMES L ""JAY"" THOMPSON","BILL EMERSON","Republican",0.696819803217915,-79333,179307,-0.44244229171198
1994,"MISSOURI",9,103443,92301,204942,"HAROLD L VOLKMER","KENNY HULSHOF","Democrat",0.504742805281494,11142,195744,0.0569212849435998
1994,"MONTANA",0,171372,148715,352133,"PAT WILLIAMS","CY JAMISON","Democrat",0.486668389500558,22657,320087,0.0707838806324531
1994,"NEBRASKA",1,70369,117967,188550,"PATRICK COMBS","DOUG BEREUTER","Republican",0.625653672765845,-47598,188336,-0.25272916489678
1994,"NEBRASKA",2,90750,92516,185310,"PETER HOADLAND","JON CHRISTENSEN","Republican",0.49924990556365,-1766,183266,-0.00963626641057261
1994,"NEBRASKA",3,41943,154919,196903,"GIL CHAPIN","BILL BARRETT","Republican",0.786778261377429,-112976,196862,-0.573884243784986
1994,"NEVADA",1,72333,73769,152167,"JAMES H BILBRAY","JOHN E ENSIGN","Republican",0.484789737590936,-1436,146102,-0.00982874977755267
1994,"NEVADA",2,65390,142202,223932,"JANET GREESON","BARBARA F VUCANOVICH","Republican",0.635023132022221,-76812,207592,-0.370014258738294
1994,"NEW HAMPSHIRE",1,42481,97017,147822,"BILL VERGE","WILLIAM H ZELIFF JR","Republican",0.656309615618785,-54536,139498,-0.390944673041907
1994,"NEW HAMPSHIRE",2,74243,83121,161573,"DICK SWETT","CHARLES F BASS","Republican",0.514448577423208,-8878,157364,-0.0564169695737272
1994,"NEW JERSEY",1,108155,41505,149660,"ROBERT E ANDREWS","JAMES N HOGAN","Democrat",0.722671388480556,66650,149660,0.445342776961112
1994,"NEW JERSEY",2,56151,102566,158717,"LOUIS N MAGAZZU","FRANK A LOBIONDO","Republican",0.646219371585904,-46415,158717,-0.292438743171809
1994,"NEW JERSEY",3,54441,115750,174328,"JAMES B SMITH","JIM SAXTON","Republican",0.663978247900509,-61309,170191,-0.360236440234795
1994,"NEW JERSEY",4,49537,109818,161767,"RALPH WALSH","CHRISTOPHER H SMITH","Republican",0.678865281546916,-60281,159355,-0.378281196071664
1994,"NEW JERSEY",5,41275,139964,188505,"BILL AUER","MARGE ROUKEMA","Republican",0.742494894034641,-98689,181239,-0.544524081461496
1994,"NEW JERSEY",6,88922,55287,147331,"FRANK PALLONE JR","MIKE HERSON","Democrat",0.603552544949807,33635,144209,0.233237870035851
1994,"NEW JERSEY",7,64231,98814,165857,"KAREN CARROLL","BOB FRANKS","Republican",0.595778290937374,-34583,163045,-0.212107087000521
1994,"NEW JERSEY",8,68661,70494,141368,"HERB KLEIN","WILLIAM J MARTINI","Republican",0.498655990040179,-1833,139155,-0.0131723617548777
1994,"NEW JERSEY",9,99984,57651,159888,"ROBERT G TORRICELLI","PETER J RUSSO","Democrat",0.625337736415491,42333,157635,0.268550766010087
1994,"NEW JERSEY",10,74622,21524,98368,"DONALD M PAYNE","JIM FORD","Democrat",0.758600357839948,53098,96146,0.552264264764005
1994,"NEW JERSEY",11,50211,127868,179580,"FRANK HERBET","RODNEY P FRELINGHUYSEN","Republican",0.712039202583807,-77657,178079,-0.436081739003476
1994,"NEW JERSEY",12,55977,125939,184280,"JOSEPH D YOUSSOUF","DICK ZIMMER","Republican",0.6834111135229,-69962,181916,-0.384584093757558
1994,"NEW JERSEY",13,67688,24071,95467,"ROBERT MENENDEZ","FERNANDO A ALONSO","Democrat",0.709019870740675,43617,91759,0.475343018123563
1994,"NEW MEXICO",1,42316,119996,162312,"PETER L ZOLLINGER","STEVEN SCHIFF","Republican",0.739292227315294,-77680,162312,-0.478584454630588
1994,"NEW MEXICO",2,45316,89966,142180,"BENJAMIN ANTHONY CHAVEZ","JOE SKEEN","Republican",0.632761288507526,-44650,135282,-0.330051300246892
1994,"NEW MEXICO",3,99900,53515,157112,"BILL RICHARDSON","F GREGG BEMIS JR","Democrat",0.635852130963898,46385,153415,0.302349835413747
1994,"NEW YORK",1,78692,72045,184033,"GEORGE J HOCHBRUECKNER","MICHAEL P FORBES","Democrat",0.427597224410839,6647,150737,0.0440966716864473
1994,"NEW YORK",2,40358,86857,162546,"JAMES L MANFRE","RICK LAZIO","Republican",0.534353352281816,-46499,127215,-0.365515072908069
1994,"NEW YORK",3,77774,98628,218772,"NORMA GRILL","PETER T KING","Republican",0.450825516976578,-20854,176402,-0.118218614301425
1994,"NEW YORK",4,65286,87815,196690,"PHILIP M SCHILIRO","DAN FRISA","Republican",0.446463978849967,-22529,153101,-0.147151226967819
1994,"NEW YORK",5,89581,63665,190775,"GARY L ACKERMAN","GRANT M LALLY","Democrat",0.469563622067881,25916,153246,0.169113712592825
1994,"NEW YORK",6,68596,13956,111990,"FLOYD H FLAKE","DENNY D BHAGWANDIN","Democrat",0.612518974908474,54640,82552,0.661885841651323
1994,"NEW YORK",8,103268,21132,161225,"JERROLD NADLER","DAVID L ASKREN","Democrat",0.640521011009459,82136,124400,0.660257234726688
1994,"NEW YORK",9,90783,30371,158807,"CHARLES E SCHUMER","JAMES P MCCALL","Democrat",0.571656161252338,60412,121154,0.498638096967496
1994,"NEW YORK",10,74264,7995,116192,"EDOLPHUS TOWNS","AMELIA SMITH PARKER","Democrat",0.639148994767282,66269,82259,0.805613975370476
1994,"NEW YORK",11,59850,6311,92251,"MAJOR R OWENS","GARY S POPKIN","Democrat",0.648773455030298,53539,66161,0.809222956122187
1994,"NEW YORK",13,32060,83509,158567,"TYRONE G BUTLER","SUSAN MOLINARI","Republican",0.52664804152188,-51449,115569,-0.445179935795931
1994,"NEW YORK",14,96795,50290,169347,"CAROLYN B MALONEY","CHARLES MILLARD","Democrat",0.571577884462081,46505,147085,0.316177720365775
1994,"NEW YORK",17,70486,16896,118987,"ELIOT L ENGEL","EDWARD T MARSHALL","Democrat",0.592384041954163,53590,87382,0.613284200407407
1994,"NEW YORK",18,91663,55636,182550,"NITA M LOWEY","ANDREW C HARTZELL JR","Democrat",0.502125445083539,36027,147299,0.244584145174102
1994,"NEW YORK",19,70696,100173,208689,"HAMILTON FISH JR","SUE W KELLY","Republican",0.480010925348245,-29477,170869,-0.172512275485899
1994,"NEW YORK",20,52345,120334,203209,"GREGORY B JULIAN","BENJAMIN A GILMAN","Republican",0.592168653947414,-67989,172679,-0.393730563646998
1994,"NEW YORK",21,131916,68745,242005,"MICHAEL R MCNULTY","JOSEPH A GOMEZ","Democrat",0.545096175698849,63171,200661,0.314814537952068
1994,"NEW YORK",22,57064,129579,234916,"L ROBERT LAWRENCE JR","GERALD B H SOLOMON","Republican",0.551597166646801,-72515,186643,-0.388522473385018
1994,"NEW YORK",23,40786,124486,205688,"CHARLES W SKEELE JR","SHERWOOD K BOEHLERT","Republican",0.605217611139201,-83700,165272,-0.506437872113849
1994,"NEW YORK",24,34032,108278,184879,"DANNY M FRANCIS","JOHN M MCHUGH","Republican",0.585669546027402,-74246,142310,-0.52172018832127
1994,"NEW YORK",25,81710,96363,209747,"RHEA JEZER","JAMES T WALSH","Republican",0.459424926220637,-14653,178073,-0.0822864780174423
1994,"NEW YORK",26,90852,82917,206782,"MAURICE D HINCHEY","BOB MOPPERT","Democrat",0.439361259684112,7935,173769,0.0456640712670269
1994,"NEW YORK",27,52160,122592,220574,"WILLIAM A LONG JR","BILL PAXON","Republican",0.555786266740414,-70432,174752,-0.403039736312031
1994,"NEW YORK",28,110987,61321,207274,"LOUISE MCINTOSH SLAUGHTER","RENEE FORGENSI DAVISON","Democrat",0.535460308577053,49666,172308,0.288239663857743
1994,"NEW YORK",29,97619,69290,193783,"JOHN J LAFALCE","WILLIAM E MILLER JR","Democrat",0.503754199284767,28329,166909,0.169727216627024
1994,"NEW YORK",30,58577,106551,202226,"DAVID A FRANCYZK","JACK QUINN","Republican",0.526890706437352,-47974,165128,-0.290526137299549
1994,"NORTH CAROLINA",1,66827,42602,109429,"EVA M CLAYTON","TED TYLER","Democrat",0.610688208792916,24225,109429,0.221376417585832
1994,"NORTH CAROLINA",2,62122,79207,141329,"RICHARD MOORE","DAVID FUNDERBURK","Republican",0.560444070219134,-17085,141329,-0.120888140438268
1994,"NORTH CAROLINA",3,65013,72464,137477,"H MARTIN LANCASTER","WALTER B JONES JR","Republican",0.527099078391295,-7451,137477,-0.0541981567825891
1994,"NORTH CAROLINA",4,76558,77773,154331,"DAVID E PRICE","FRED HEINEMAN","Republican",0.503936344609962,-1215,154331,-0.00787268921992341
1994,"NORTH CAROLINA",5,63194,84741,147935,"A P ""SANDY"" SANDS","RICHARD BURR","Republican",0.572825903268327,-21547,147935,-0.145651806536655
1994,"NORTH CAROLINA",7,62670,58849,121519,"CHARLIE ROSE","ROBERT C ANDERSON","Democrat",0.515721821278977,3821,121519,0.0314436425579539
1994,"NORTH CAROLINA",8,62845,57140,119985,"W G ""BILL"" HEFNER","SHERRILL MORGAN","Democrat",0.523773805058966,5705,119985,0.0475476101179314
1994,"NORTH CAROLINA",9,44379,82374,126753,"RORY BLAKE","SUE MYRICK","Republican",0.64987810939386,-37995,126753,-0.299756218787721
1994,"NORTH CAROLINA",10,42939,107829,150768,"ROBERT WAYNE AVERY","CASS BALLENGER","Republican",0.715198185291309,-64890,150768,-0.430396370582617
1994,"NORTH CAROLINA",11,76862,115826,192688,"MAGGIE PALMER LAUTERER","CHARLES H TAYLOR","Republican",0.601106451880761,-38964,192688,-0.202212903761521
1994,"NORTH CAROLINA",12,57655,29933,87621,"MELVIN L WATT","JOSEPH A ""JOE"" MARTINO","Democrat",0.658004359685464,27722,87588,0.316504544001461
1994,"NORTH DAKOTA",0,123134,105988,235389,"EARL POMEROY","GARY PORTER","Democrat",0.523108556474602,17146,229122,0.0748334948193539
1994,"OHIO",1,72822,92997,165819,"DAVID MANN","STEVE CHABOT","Republican",0.560834403777613,-20175,165819,-0.121668807555226
1994,"OHIO",2,43730,150128,193858,"LES MANN","ROB PORTMAN","Republican",0.774422515449453,-106398,193858,-0.548845030898905
1994,"OHIO",3,105342,72314,177656,"TONY P HALL","DAVID A WESTBROCK","Democrat",0.592954924123024,33028,177656,0.185909848246049
1994,"OHIO",5,49335,135879,185214,"JARROD TUDOR","PAUL E GILLMOR","Republican",0.733632446791279,-86544,185214,-0.467264893582559
1994,"OHIO",6,87861,91263,179124,"TED STRICKLAND","FRANK A CREMANS","Republican",0.509496214912575,-3402,179124,-0.0189924298251491
1994,"OHIO",9,118120,38665,156785,"MARCY KAPTUR","R RANDY WHITMAN","Democrat",0.753388398124821,79455,156785,0.506776796249641
1994,"OHIO",10,70918,95226,183639,"FRANCIS E GAUL","MARTIN R HOKE","Republican",0.518549981213141,-24308,166144,-0.146306818181818
1994,"OHIO",11,114220,33705,147928,"LOUIS STOKES","JAMES J SYKORA","Democrat",0.772132388729652,80515,147925,0.544296095994592
1994,"OHIO",12,57294,114608,172345,"CYNTHIA L RUCCIA","JOHN R KASICH","Republican",0.664991731700949,-57314,171902,-0.333410896906377
1994,"OHIO",13,93147,86422,189776,"SHERROD BROWN","GREGORY A WHITE","Democrat",0.490826026473316,6725,179569,0.0374507849350389
1994,"OHIO",14,96274,89106,185404,"THOMAS C SAWYER","LYNN SLABY","Democrat",0.519266035252745,7168,185380,0.0386665228179955
1994,"OHIO",15,46480,112912,159696,"BILL BUCKEL","DEBORAH PRYCE","Republican",0.707043382426611,-66432,159392,-0.416783778357759
1994,"OHIO",16,45781,137322,183103,"J MICHAEL FINN","RALPH REGULA","Republican",0.74997132761342,-91541,183103,-0.49994265522684
1994,"OHIO",17,149004,43490,192494,"JAMES A TRAFICANT JR","MIKE G MEISTER","Democrat",0.774070880131329,105514,192494,0.548141760262657
1994,"OHIO",18,87926,103115,191041,"GREG L DIDONATO","ROBERT W NEY","Republican",0.539753246685266,-15189,191041,-0.079506493370533
1994,"OHIO",19,89701,99997,206242,"ERIC FINGERHUT","STEVEN C LATOURETTE","Republican",0.484852745803474,-10296,189698,-0.0542757435502746
1994,"OKLAHOMA",1,63753,107085,170838,"STUART PRICE","STEVE LARGENT","Republican",0.626821901450497,-43332,170838,-0.253643802900994
1994,"OKLAHOMA",2,75943,82479,158422,"VIRGIL R COOPER","TOM A COBURN","Republican",0.520628448069081,-6536,158422,-0.0412568961381626
1994,"OKLAHOMA",3,115731,41147,156878,"BILL K BREWSTER","DARREL DEWAYNE TALLANT","Democrat",0.737713382373564,74584,156878,0.475426764747128
1994,"OKLAHOMA",4,67237,80251,155401,"DAVID PERRYMAN","J C WATTS JR","Republican",0.516412378298724,-13014,147488,-0.0882376871338685
1994,"OKLAHOMA",6,45399,106961,152360,"JEFFREY S TOLLETT","FRANK D LUCAS","Republican",0.702028091362562,-61562,152360,-0.404056182725125
1994,"OREGON",1,121147,120846,253989,"ELIZABETH FURSE","BILL WITT","Democrat",0.47697734941277,301,241993,0.00124383763166703
1994,"OREGON",2,90822,134255,234381,"SUE C KUPILLAS","WES COOLEY","Republican",0.572806669482595,-43433,225077,-0.192969517098593
1994,"OREGON",3,161624,43211,222822,"RON WYDEN","EVERETT HALL","Democrat",0.725350279595372,118413,204835,0.578089681939122
1994,"OREGON",4,158981,78947,238149,"PETER A DEFAZIO","JOHN D NEWKIRK","Democrat",0.667569462815296,80034,237928,0.336379072660637
1994,"OREGON",5,114015,121369,243616,"CATHERINE WEBBER","JIM BUNN","Republican",0.498197983712071,-7354,235384,-0.0312425653400401
1994,"PENNSYLVANIA",1,99669,22595,122264,"THOMAS M FOGLIETTA","ROGER F GORDON","Democrat",0.815194987895047,77074,122264,0.630389975790094
1994,"PENNSYLVANIA",2,120553,19824,140377,"CHAKA FATTAH","LAWRENCE R WATSON","Democrat",0.858780284519544,100729,140377,0.717560569039088
1994,"PENNSYLVANIA",3,92702,55209,147911,"ROBERT A BORSKI","JAMES C HASHER","Democrat",0.626741756867305,37493,147911,0.253483513734611
1994,"PENNSYLVANIA",4,119115,66509,185630,"RON KLINK","ED PEGLOW","Democrat",0.64167968539568,52606,185624,0.28340085333793
1994,"PENNSYLVANIA",6,90023,68610,158633,"TIM HOLDEN","FRED LEVERING","Democrat",0.567492262013578,21413,158633,0.134984524027157
1994,"PENNSYLVANIA",7,59845,137480,197325,"SARA NICHOLS","CURT WELDON","Republican",0.696718611427847,-77635,197325,-0.393437222855695
1994,"PENNSYLVANIA",8,44559,110499,167174,"JOHN P MURRAY","JAMES C GREENWOOD","Republican",0.660981970880639,-65940,155058,-0.425260225206052
1994,"PENNSYLVANIA",10,50635,106992,162890,"DANIEL J SCHREFFLER","JOSEPH M MCDADE","Republican",0.656835901528639,-56357,157627,-0.357533925025535
1994,"PENNSYLVANIA",11,101966,51295,153277,"PAUL E KANJORSKI","J ANDREW PODOLAK","Democrat",0.665240055585639,50671,153261,0.330619009402262
1994,"PENNSYLVANIA",12,117825,53147,171005,"JOHN P MURTHA","BILL CHOBY","Democrat",0.689014941083594,64678,170972,0.378295861310624
1994,"PENNSYLVANIA",13,88073,96254,194788,"MARJORIE MARGOLIES-MEZVINSKY","JON D FOX","Republican",0.49414748341787,-8181,184327,-0.0443830800696588
1994,"PENNSYLVANIA",14,105310,53221,164210,"WILLIAM J COYNE","JOHN ROBERT CLARK","Democrat",0.641312952926131,52089,158531,0.328572960493531
1994,"PENNSYLVANIA",15,72073,71602,150909,"PAUL MCHALE","JIM YEAGER","Democrat",0.477592456380998,471,143675,0.00327823212110666
1994,"PENNSYLVANIA",16,47680,109759,157455,"BILL CHERTOK","ROBERT S WALKER","Republican",0.697081705884221,-62079,157439,-0.39430509594192
1994,"PENNSYLVANIA",18,101784,83881,185750,"MICHAEL F DOYLE","JOHN MCCARTY","Democrat",0.547962314939435,17903,185665,0.0964263593030458
1994,"PENNSYLVANIA",20,95251,84156,179419,"FRANK MASCARA","MIKE MCCORMICK","Democrat",0.53088580362169,11095,179407,0.0618426259844934
1994,"PENNSYLVANIA",21,84796,89439,180829,"BILL LEAVENS","PHIL ENGLISH","Republican",0.494605400682413,-4643,174235,-0.0266479180417253
1994,"RHODE ISLAND",1,89832,76069,165901,"PATRICK J KENNEDY","KEVIN VIGILANTE","Democrat",0.54147955708525,13763,165901,0.0829591141704993
1994,"RHODE ISLAND",2,119659,56348,176007,"JACK REED","A JOHN ELLIOT","Democrat",0.679853642184686,63311,176007,0.359707284369372
1994,"SOUTH CAROLINA",1,47769,97803,147471,"ROBERT BARBER","MARSHALL ""MARK"" SANFORD","Republican",0.663201578615457,-50034,145572,-0.343706207237656
1994,"SOUTH CAROLINA",3,59932,90123,150068,"JAMES E BRYAN JR","LINDSEY O GRAHAM","Republican",0.600547751685902,-30191,150055,-0.201199560161274
1994,"SOUTH CAROLINA",4,39396,109626,149176,"JERRY L FOWLER","BOB INGLIS","Republican",0.734876923901968,-70230,149022,-0.471272697990901
1994,"SOUTH CAROLINA",5,77311,70967,148363,"JOHN M SPRATT JR","LARRY BIGHAM","Democrat",0.521093534102168,6344,148278,0.0427844993862879
1994,"SOUTH CAROLINA",6,88635,50259,138923,"JAMES E CLYBURN","GARY MCLEOD","Democrat",0.638015303441475,38376,138894,0.276297032269212
1994,"SOUTH DAKOTA",0,183036,112054,305922,"TIM JOHNSON","JAN BERKHOUT","Democrat",0.598309372977426,70982,295090,0.240543562980786
1994,"TENNESSEE",1,34691,102947,141227,"J CARR ""JACK"" CHRISTIAN","JAMES H ""JIMMY"" QUILLEN","Republican",0.728947014381103,-68256,137638,-0.495909559859922
1994,"TENNESSEE",3,73839,84583,161853,"RANDY BUTTON","ZACH WAMP","Republican",0.522591487337275,-10744,158422,-0.0678188635416798
1994,"TENNESSEE",4,60489,81539,143976,"JEFF WHORLEY","VAN HILLEARY","Republican",0.566337445129744,-21050,142028,-0.148210212070859
1994,"TENNESSEE",5,95953,61692,159304,"BOB CLEMENT","JOHN OSBORNE","Democrat",0.602326369708231,34261,157645,0.217330077071902
1994,"TENNESSEE",6,90933,88759,179699,"BART GORDON","STEVE GILL","Democrat",0.50602952715374,2174,179692,0.0120984796206843
1994,"TENNESSEE",7,65851,102587,170383,"HAROLD BYRD","ED BRYANT","Republican",0.602096453284659,-36736,168438,-0.218098053883328
1994,"TENNESSEE",8,97951,55573,153538,"JOHN S TANNER","NEAL R MORRIS","Democrat",0.637959332543084,42378,153524,0.276035017326281
1994,"TENNESSEE",9,94805,69226,164040,"HAROLD E FORD","ROD DEBERRY","Democrat",0.577938307729822,25579,164031,0.155940035724954
1994,"TEXAS",1,86480,63911,156392,"JIM CHAPMAN","MIKE BLANKENSHIP","Democrat",0.552969461353522,22569,150391,0.150068820607616
1994,"TEXAS",2,87709,66071,153780,"CHARLES WILSON","DONNA PETERSON","Democrat",0.570353752113409,21638,153780,0.140707504226818
1994,"TEXAS",4,99303,67267,168947,"RALPH M HALL","DAVID L BRIDGES","Democrat",0.587776048109762,32036,166570,0.192327549978988
1994,"TEXAS",5,61877,58521,123616,"JOHN BRYANT","PETE SESSIONS","Democrat",0.500558180170852,3356,120398,0.0278742171796874
1994,"TEXAS",6,44286,152038,201012,"TERRY JESMORE","JOE BARTON","Republican",0.756362804210694,-107752,196324,-0.548847822986492
1994,"TEXAS",9,71643,81353,156797,"JACK BROOKS","STEVE STOCKMAN","Republican",0.518842835003221,-9710,152996,-0.0634657115218698
1994,"TEXAS",10,113738,80382,201986,"LLOYD DOGGETT","JO BAYLOR","Democrat",0.563098432564633,33356,194120,0.171831856583557
1994,"TEXAS",11,76667,52876,129543,"CHET EDWARDS","JIM BROYLES","Democrat",0.591826652154111,23791,129543,0.183653304308222
1994,"TEXAS",12,96372,43959,140331,"PETE GEREN","ERNEST J ANDERSON JR","Democrat",0.686747760651602,52413,140331,0.373495521303205
1994,"TEXAS",13,63923,79466,143389,"BILL SARPALIUS","WILLIAM M ""MAC"" THORNBERRY","Republican",0.554198718172245,-15543,143389,-0.108397436344489
1994,"TEXAS",14,86175,68793,154968,"GREG LAUGHLIN","JIM DEATS","Democrat",0.556082546074028,17382,154968,0.112165092148056
1994,"TEXAS",15,61527,41119,104366,"E DE LA GARZA","TOM HAUGHEY","Democrat",0.58953107333806,20408,102646,0.198819242834597
1994,"TEXAS",16,49815,37409,87224,"RONALD D COLEMAN","BOBBY ORTIZ","Democrat",0.571115747959277,12406,87224,0.142231495918555
1994,"TEXAS",17,83497,72108,155605,"CHARLES W STENHOLM","PHIL BOONE","Democrat",0.536595867742039,11389,155605,0.0731917354840783
1994,"TEXAS",18,84790,28153,115390,"SHEILA JACKSON-LEE","JERRY BURLEY","Democrat",0.73481237542248,56637,112943,0.501465340924183
1994,"TEXAS",20,60114,36035,96149,"HENRY B GONZALEZ","CARL BILL COLYER","Democrat",0.625217110942392,24079,96149,0.250434221884783
1994,"TEXAS",22,38826,120302,163144,"SCOTT DOUGLAS CUNNINGHAM","TOM DELAY","Republican",0.737397636443878,-81476,159128,-0.512015484389925
1994,"TEXAS",23,44101,73815,117916,"ROLANDO L RIOS","HENRY BONILLA","Republican",0.62599647206486,-29714,117916,-0.251992944129719
1994,"TEXAS",24,65019,58062,123081,"MARTIN FROST","ED HARRISON","Democrat",0.528261876325347,6957,123081,0.0565237526506934
1994,"TEXAS",25,61959,53321,118529,"KEN BENTSEN","GENE FONTENOT","Democrat",0.522732833315054,8638,115280,0.0749306037473976
1994,"TEXAS",26,39763,135398,177191,"LEEARL ANN BRYANT","RICHARD K ARMEY","Republican",0.764135875975642,-95635,175161,-0.545983409548929
1994,"TEXAS",27,65325,44693,110018,"SOLOMON P ORTIZ","EROL A STONE","Democrat",0.593766474576887,20632,110018,0.187532949153775
1994,"TEXAS",28,73986,28777,104375,"FRANK TEJEDA","DAVID C SLATTER","Democrat",0.708847904191617,45209,102763,0.439934606813736
1994,"TEXAS",29,44102,15952,60054,"GENE GREEN","HAROLD ""OILMAN"" EIDE","Democrat",0.734372398174976,28150,60054,0.468744796349952
1994,"TEXAS",30,73166,25848,100742,"EDDIE BERNICE JOHNSON","LUCY CAIN","Democrat",0.726271068670465,47318,99014,0.477892015270568
1994,"UTAH",1,57664,104954,162618,"BOBBIE CORAY","JAMES V HANSEN","Republican",0.645402108007724,-47290,162618,-0.290804216015447
1994,"UTAH",2,66911,85507,186585,"KAREN SHEPHERD","ENID G WALDHOTZ","Republican",0.458273709033416,-18596,152418,-0.1220065871485
1994,"UTAH",3,91505,61839,155146,"BILL ORTON","DIXIE THOMPSON","Democrat",0.589799285833989,29666,153344,0.193460454924875
1994,"VIRGINIA",1,45173,142930,192496,"MARY F SINCLAIR","HERBERT H BATEMAN","Republican",0.742508935250603,-97757,188103,-0.519699313673891
1994,"VIRGINIA",2,81372,56375,137802,"OWEN B PICKETT","J L ""JIM"" CHAPMAN IV","Democrat",0.590499412200113,24997,137747,0.181470376850313
1994,"VIRGINIA",3,108532,28080,136620,"ROBERT C SCOTT","THOMAS E ""TOM"" WARD","Democrat",0.79440784658176,80452,136612,0.588908734225397
1994,"VIRGINIA",4,115055,71678,186755,"NORMAN SISISKY","A GEORGE SWEET III","Democrat",0.616074536156997,43377,186733,0.232294238297462
1994,"VIRGINIA",5,95308,83555,178897,"L F PAYNE","GEORGE C LANDRITH III","Democrat",0.532753483848248,11753,178863,0.0657095095128674
1994,"VIRGINIA",8,120281,79568,202673,"JAMES P MORAN","KYLE E MCSLARROW","Democrat",0.593473230277343,40713,199849,0.203718807699813
1994,"VIRGINIA",9,102876,72133,175024,"RICK BOUCHER","S H ""STEVE"" FAST","Democrat",0.587782247006125,30743,175009,0.175665251501351
1994,"VIRGINIA",11,84104,98216,185680,"LESLIE L BYRNE","THOMAS M DAVIS","Republican",0.528953037483843,-14112,182320,-0.0774023694602896
1994,"WASHINGTON",1,94110,100554,194664,"MARIA CANTWELL","RICK WHITE","Republican",0.516551596597214,-6444,194664,-0.0331031931944273
1994,"WASHINGTON",2,89096,107430,196526,"HARRIT A SPANEL","JACK METCALF","Republican",0.546645227603472,-18334,196526,-0.0932904552069446
1994,"WASHINGTON",3,85826,100188,192634,"JOLENE UNSOELD","LINDA SMITH","Republican",0.520095102629858,-14362,186014,-0.0772092423150946
1994,"WASHINGTON",4,81198,92828,174026,"JAY INSLEE","RICHARD ""DOC"" HASTINGS","Republican",0.53341454725156,-11630,174026,-0.0668290945031202
1994,"WASHINGTON",5,106074,110057,216131,"THOMAS S FOLEY","GEORGE R NETHERCUTT JR","Republican",0.509214319093513,-3983,216131,-0.0184286381870255
1994,"WASHINGTON",6,105480,75322,180802,"NORMAN D DICKS","BENJAMIN GREGG","Democrat",0.583400626099269,30158,180802,0.166801252198538
1994,"WASHINGTON",7,148353,49091,197444,"JIM MCDERMOTT","KEITH HARRIS","Democrat",0.751367476347724,99262,197444,0.502734952695448
1994,"WASHINGTON",8,44165,140409,184574,"JIM WYRICK","JENNIFER DUNN","Republican",0.760719277904797,-96244,184574,-0.521438555809594
1994,"WASHINGTON",9,72451,77833,150284,"MIKEKREIDLER","RANDY TATE","Republican",0.517906097788188,-5382,150284,-0.0358121955763754
1994,"WEST VIRGINIA",1,103177,43590,146767,"ALAN B MOLLOHAN","SALLY ROSSY RILEY","Democrat",0.702998630482329,59587,146767,0.405997260964658
1994,"WEST VIRGINIA",2,90757,51691,142448,"ROBERT E WISE JR","SAM CRAVOTTA","Democrat",0.637123722340784,39066,142448,0.274247444681568
1994,"WEST VIRGINIA",3,74967,42382,117349,"NICK J RAHALL JR","BEN WALDMAN","Democrat",0.638837996063026,32585,117349,0.277675992126051
1994,"WISCONSIN",1,82817,83937,169855,"PETER W BARCA","MARK W NEUMANN","Republican",0.49416855553266,-1120,166754,-0.00671648056418437
1994,"WISCONSIN",2,55406,133734,193249,"THOMAS C HECHT","SCOTT L KLUG","Republican",0.692029454227447,-78328,189140,-0.414127101617849
1994,"WISCONSIN",3,65758,89338,160313,"HARVEY STOWER","STEVE GUNDERSON","Republican",0.557272335992714,-23580,155096,-0.152034868726466
1994,"WISCONSIN",4,93789,78225,174689,"GERALD D KLECZKA","TOM REYNOLDS","Democrat",0.536891275352197,15564,172014,0.0904810073598661
1994,"WISCONSIN",5,87806,51145,140640,"THOMAS M BARRETT","STEVEN B HOLLINGSHEAD","Democrat",0.624331626848692,36661,138951,0.263841210210794
1994,"WISCONSIN",7,97184,81706,178921,"DAVID R OBEY","SCOTT WEST","Democrat",0.543167096092689,15478,178890,0.0865224439599754
1994,"WISCONSIN",8,65065,114319,179460,"STAN GRUSZYNSKI","TOBY ROTH","Republican",0.637016605371671,-49254,179384,-0.274572983097712
1994,"WYOMING",0,81022,104426,196197,"BOB SCHUSTER","BARBARA CUBIN","Republican",0.532250747972701,-23404,185448,-0.126202493421336
1996,"ALABAMA",1,69470,132206,205417,"DON WOMACK","SONNY CALLAHAN","Republican",0.643598144262646,-62736,201676,-0.311073206529285
1996,"ALABAMA",2,74317,132563,209793,"BOB GAINES","TERRY EVERETT","Republican",0.631875229392782,-58246,206880,-0.281544856921887
1996,"ALABAMA",3,92325,98353,195047,"T D ""TED"" LITTLE","BOB RILEY","Republican",0.504252821114911,-6028,190678,-0.0316135054909324
1996,"ALABAMA",4,99250,102741,205917,"ROBERT T ""BOB"" WILSON JR","ROBERT B ADERHOLT","Republican",0.498943749180495,-3491,201991,-0.0172829482501696
1996,"ALABAMA",5,114442,86727,205547,"ROBERT E ""BUD"" CRAMER JR","WAYNE PARKER","Democrat",0.556768038453492,27715,201169,0.137769735893701
1996,"ALABAMA",6,69592,180781,254859,"MARY LYNN BATES","SPENCER BACHUS","Republican",0.709337319851369,-111189,250373,-0.444093412628358
1996,"ALABAMA",7,136651,52142,192113,"EARL F HILLIARD","JOE POWELL","Democrat",0.711305325511548,84509,188793,0.447627825184196
1996,"ALASKA",0,85114,138834,233700,"GEORGIANNA ""GEORG"" LINCOLN","DON YOUNG","Republican",0.594069319640565,-53720,223948,-0.239877114330112
1996,"ARIZONA",1,89738,135634,225372,"JOHN COX","MATT SALMON","Republican",0.601822764141065,-45896,225372,-0.203645528282129
1996,"ARIZONA",2,81982,38786,126101,"ED PASTOR","JIM BUSTER","Democrat",0.650129657972577,43196,120768,0.357677530471648
1996,"ARIZONA",3,88214,175231,263445,"ALEXANDER ""BIG AL"" SCHNEIDER","BOB STUMP","Republican",0.665152119038129,-87017,263445,-0.330304238076259
1996,"ARIZONA",4,74857,150486,225343,"MARIA ELENA MILTON","JOHN B SHADEGG","Republican",0.667808629511456,-75629,225343,-0.335617259022912
1996,"ARIZONA",5,67597,179349,260898,"MORT NELSON","JIM KOLBE","Republican",0.687429570176851,-111752,246946,-0.452536181999304
1996,"ARIZONA",6,118957,121431,255287,"STEVE OWENS","J D HAYWORTH","Republican",0.475664644106437,-2474,240388,-0.0102916950929331
1996,"ARKANSAS",1,105280,88436,199450,"MARION BERRY","WARREN DUPWE","Democrat",0.527851591877664,16844,193716,0.0869520328728654
1996,"ARKANSAS",2,114841,104548,219389,"VIC SNYDER","BUD CUMMINS","Democrat",0.523458332003883,10293,219389,0.046916664007767
1996,"ARKANSAS",3,102994,137093,246132,"ANN HENRY","ASA HUTCHINSON","Republican",0.556989745339899,-34099,240087,-0.142027681632075
1996,"ARKANSAS",4,72391,125956,198347,"VINCENT TOLLIVER","JAY DICKEY","Republican",0.635028510640443,-53565,198347,-0.270057021280887
1996,"CALIFORNIA",1,96522,110243,222119,"MICHELA ALIOTO","FRANK RIGGS","Republican",0.496324042517749,-13721,206765,-0.0663603607960728
1996,"CALIFORNIA",2,80401,144913,238326,"ROBERTS A BRADEN","WALLY HERGER","Republican",0.608045282512189,-64512,225314,-0.286320423941699
1996,"CALIFORNIA",3,118663,91134,221737,"VIC FAZIO","TIM LEFEVER","Democrat",0.535152004401611,27529,209797,0.131217319599422
1996,"CALIFORNIA",4,97948,164048,271315,"KATIE HIRNING","JOHN T DOOLITTLE","Republican",0.604640362678068,-66100,261996,-0.252293928151575
1996,"CALIFORNIA",5,142618,52940,202460,"ROBERT T MATSUI","ROBERT S DINSMORE","Democrat",0.704425565543811,89678,195558,0.458574949631311
1996,"CALIFORNIA",6,156958,86278,253836,"LYNN C WOOLSEY","DUANE C HUGHES","Democrat",0.618344127704502,70680,243236,0.290581986219145
1996,"CALIFORNIA",7,137089,42542,190917,"GEORGE MILLER","NORMAN H REECE","Democrat",0.718055490082078,94547,179631,0.526340108333194
1996,"CALIFORNIA",8,175216,25739,207738,"NANCY PELOSI","JUSTIN RAIMONDO","Democrat",0.843447034245059,149477,200955,0.743833196486776
1996,"CALIFORNIA",9,154806,37126,200968,"RONALD V DELLUMS","DEBORAH WRIGHT","Democrat",0.770301739580431,117680,191932,0.613133818227289
1996,"CALIFORNIA",10,137726,133633,283183,"ELLEN O TAUSCHER","BILL BAKER","Democrat",0.486349816196594,4093,271359,0.0150833397823547
1996,"CALIFORNIA",11,65536,107477,181096,"JASON SILVA","RICHARD W POMBO","Republican",0.593480805760481,-41941,173013,-0.242415309832209
1996,"CALIFORNIA",12,149049,49276,207908,"TOM LANTOS","STORM JENKINS","Democrat",0.716898820632203,99773,198325,0.503078280600025
1996,"CALIFORNIA",13,114408,53385,175539,"FORTNEY PETE STARK","JAMES S FAY","Democrat",0.651752601985883,61023,167793,0.363680248878082
1996,"CALIFORNIA",14,148773,71571,229633,"ANNA G ESHOO","BEN BRINK","Democrat",0.647872910252446,77202,220344,0.350370330029409
1996,"CALIFORNIA",15,79048,132737,226868,"DICK LANE","TOM CAMPBELL","Republican",0.585084718867359,-53689,211785,-0.253507094459003
1996,"CALIFORNIA",16,94020,43197,143207,"ZOE LOFGREN","CHUCK WOJSLAW","Democrat",0.656532152757896,50823,137217,0.370384136076434
1996,"CALIFORNIA",17,115116,73856,195545,"SAM FARR","JESS BROWN","Democrat",0.588693139686517,41260,188972,0.218339224858709
1996,"CALIFORNIA",18,108827,52695,165586,"GARY A CONDIT","BILL CONRAD","Democrat",0.657223436763978,56132,161522,0.347519223387526
1996,"CALIFORNIA",19,58452,137402,206379,"PAUL BARILE","GEORGE P RADANOVICH","Republican",0.665775103087039,-78950,195854,-0.403106395580381
1996,"CALIFORNIA",20,65381,45276,115705,"CALVIN M DOOLEY","TRICE HARVEY","Democrat",0.565066332483471,20105,110657,0.181687557045646
1996,"CALIFORNIA",21,50694,125916,191152,"DEBORAH A VOLLMER","WILLIAM M THOMAS","Republican",0.65872185485896,-75222,176610,-0.425921521997622
1996,"CALIFORNIA",22,118299,107987,244186,"WALTER H CAPPS","ANDREA H SEASTRAND","Democrat",0.484462663707174,10312,226286,0.0455706495320082
1996,"CALIFORNIA",23,70035,118880,199507,"ROBERT R UNRUHE","ELTON GALLEGLY","Republican",0.595868816633,-48845,188915,-0.258555434983988
1996,"CALIFORNIA",24,106193,93629,214848,"BRAD SHERMAN","RICH SYBERT","Democrat",0.494270367887995,12564,199822,0.0628759596040476
1996,"CALIFORNIA",25,65089,122428,196203,"DIANE TRAUTMAN","HOWARD P ""BUCK"" MCKEON","Republican",0.623986381451864,-57339,187517,-0.30578027592165
1996,"CALIFORNIA",26,67525,29332,102515,"HOWARD L BERMAN","BILL GLASS","Democrat",0.658684095010486,38193,96857,0.394323590447774
1996,"CALIFORNIA",27,82014,95310,189930,"DOUG KAHN","JAMES E ROGAN","Republican",0.501816458695309,-13296,177324,-0.0749813899979698
1996,"CALIFORNIA",28,69037,113389,186885,"DAVID LEVERING","DAVID DREIER","Republican",0.606731412365893,-44352,182426,-0.243123239011983
1996,"CALIFORNIA",29,145278,52857,214817,"HENRY A WAXMAN","PAUL STEPANEK","Democrat",0.676287258457199,92421,198135,0.466454689984102
1996,"CALIFORNIA",30,58283,15078,80590,"XAVIER BECERRA","PATRICIA JEAN PARKER","Democrat",0.723203871448071,43205,73361,0.58893690107823
1996,"CALIFORNIA",31,69285,28705,102690,"MATTHEW G MARTINEZ","JOHN V FLORES","Democrat",0.674700555068653,40580,97990,0.414123890192877
1996,"CALIFORNIA",32,124712,18768,151427,"JULIAN C DIXON","LARRY ARDITO","Democrat",0.82357835788862,105944,143480,0.738388625592417
1996,"CALIFORNIA",33,47478,8147,57828,"LUCILLE ROYBAL-ALLARD","JOHN P LEONARD","Democrat",0.821020958705126,39331,55625,0.707074157303371
1996,"CALIFORNIA",34,94730,36852,138440,"ESTEBAN EDWARD TORRES","DAVID G NUNEZ","Democrat",0.684267552730425,57878,131582,0.439862595187792
1996,"CALIFORNIA",35,92762,13116,108488,"MAXINE WATERS","ERIC CARLSON","Democrat",0.855043875820367,79646,105878,0.752243147773853
1996,"CALIFORNIA",36,117752,98538,224459,"JANE HARMAN","SUSAN BROOKS","Democrat",0.524603602439644,19214,216290,0.0888344352489713
1996,"CALIFORNIA",37,87247,15399,102646,"JUANITA MILLENDER-MCDONALD","MICHAEL E VOETEE","Democrat",0.849979541336243,71848,102646,0.699959082672486
1996,"CALIFORNIA",38,71627,88136,167645,"RICK ZBUR","STEPHEN HORN","Republican",0.525729965104835,-16509,159763,-0.103334313952542
1996,"CALIFORNIA",39,61392,120761,192290,"R O ""BOB"" DAVIS","EDWARD R ROYCE","Republican",0.628014977377919,-59369,182153,-0.325929301191855
1996,"CALIFORNIA",40,44102,98821,152261,"ROBERT ""BOB"" CONAWAY","JERRY LEWIS","Republican",0.649023715856326,-54719,142923,-0.382856503152047
1996,"CALIFORNIA",41,47346,83934,143445,"RICHARD L WALDRON","JAY KIM","Republican",0.585130189271149,-36588,131280,-0.278702010968921
1996,"CALIFORNIA",42,52166,51170,103336,"GEORGE E BROWN JR","LINDA M WILDE","Democrat",0.504819230471472,996,103336,0.00963846094294341
1996,"CALIFORNIA",43,67422,97247,177640,"GUY C KIMBROUGH","KEN CALVERT","Republican",0.547438639945958,-29825,164669,-0.181120915290674
1996,"CALIFORNIA",44,73844,110643,191518,"ANITA RUFUS","SONNY BONO","Republican",0.577715932706064,-36799,184487,-0.199466629084976
1996,"CALIFORNIA",45,68312,125326,205522,"SALLY J ALEXANDER","DANA ROHRABACHER","Republican",0.609793598738821,-57014,193638,-0.294436009460953
1996,"CALIFORNIA",46,47964,46980,102784,"LORETTA SANCHEZ","ROBERT K DORNAN","Democrat",0.466648505603985,984,94944,0.0103640040444894
1996,"CALIFORNIA",47,70362,160078,243777,"TINA LOUISE LAINE","CHRISTOPHER COX","Republican",0.656657518962002,-89716,230440,-0.389324770005207
1996,"CALIFORNIA",48,59558,145814,221391,"DAN FARRELL","RON PACKARD","Republican",0.658626592770257,-86256,205372,-0.419998831388894
1996,"CALIFORNIA",49,86657,108806,206768,"PETER NAVARRO","BRIAN P BILBRAY","Republican",0.526222626325157,-22149,195463,-0.113315563559344
1996,"CALIFORNIA",50,73200,38351,118340,"BOB FILNER","JIM BAIZE","Democrat",0.618556701030928,34849,111551,0.312404191804645
1996,"CALIFORNIA",51,66250,149032,229024,"RITA TAMERIUS","RANDY ""DUKE"" CUNNINGHAM","Republican",0.650726561408411,-82782,215282,-0.384528200221105
1996,"CALIFORNIA",52,53104,116746,178321,"DARITY WESLEY","DUNCAN HUNTER","Republican",0.654695745313227,-63642,169850,-0.37469531939947
1996,"COLORADO",1,112631,79540,197839,"DIANA DEGETTE","JOE ROGERS","Democrat",0.569306355167586,33091,192171,0.172195596630085
1996,"COLORADO",2,145894,97865,255784,"DAVID E SKAGGS","PATRICIA ""PAT"" MILLER","Democrat",0.570379695367967,48029,243759,0.197034776151855
1996,"COLORADO",3,82953,183523,266476,"ALBERT L GURULE","SCOTT MCINNIS","Republican",0.688703673126285,-100570,266476,-0.377407346252571
1996,"COLORADO",4,92837,137012,244067,"GUY KELLER","BOB SCHAFFER","Republican",0.561370443361864,-44175,229849,-0.19219139522034
1996,"COLORADO",5,73660,188805,262465,"MIKE ROBINSON","JOEL HEFLEY","Republican",0.719353056598023,-115145,262465,-0.438706113196045
1996,"COLORADO",6,88600,146018,234618,"JOAN FITZ-GERALD","DAN SCHAEFER","Republican",0.622364865440844,-57418,234618,-0.244729730881689
1996,"CONNECTICUT",1,145169,53666,215136,"BARBARA B KENNELLY","KENT SLEATH","Democrat",0.674777814963558,91503,198835,0.460195639600674
1996,"CONNECTICUT",2,106544,100332,223249,"SAM GJDENSON","EDWARD W MUNSTER","Democrat",0.477242899184319,6212,206876,0.030027649413175
1996,"CONNECTICUT",3,137108,59335,211352,"ROSA L DELAURO","JOHN COPPOLA","Democrat",0.648718725159923,77773,196443,0.395906191617925
1996,"CONNECTICUT",4,75902,121949,201712,"BILL FINCH","CHRISTOPHER SHAYS","Republican",0.604569881811692,-46047,197851,-0.232735745586325
1996,"CONNECTICUT",5,105359,98782,215130,"JAMES H MALONEY","GARY A FRANKS","Democrat",0.489745735136894,6577,204141,0.0322179278048016
1996,"CONNECTICUT",6,104225,113020,227756,"CHARLOTTE KOSKOFF","NANCY L JOHNSON","Republican",0.496232810551643,-8795,217245,-0.040484245897489
1996,"DELAWARE",0,73258,185577,266831,"DENNIS E WILLIAMS","MICHAEL N CASTLE","Republican",0.695485157271831,-112319,258835,-0.433940541271466
1996,"FLORIDA",1,66495,175946,242545,"KEVIN BECK","JOE SCARBOROUGH","Republican",0.725415902203715,-109451,242441,-0.451454168230621
1996,"FLORIDA",2,138151,94122,232400,"ALLEN BOYD","BILL SUTTON","Democrat",0.594453528399312,44029,232273,0.189557115979903
1996,"FLORIDA",3,98085,62196,160281,"CORRINE BROWN","PRESTON JAMES FIELDS","Democrat",0.611956501394426,35889,160281,0.223913002788852
1996,"FLORIDA",5,161050,100051,261101,"KAREN L THURMAN","DAVE GENTRY","Democrat",0.616811119068866,60999,261101,0.233622238137732
1996,"FLORIDA",6,78908,161527,240442,"NEWELL O'BRIEN","CLIFF STEARNS","Republican",0.671791949825738,-82619,240435,-0.343623016615717
1996,"FLORIDA",7,87832,143667,231557,"GEORGE STUART JR","JOHN L MICA","Republican",0.620439027971515,-55835,231499,-0.241188946820505
1996,"FLORIDA",8,65794,136515,202326,"AL KRULICK","BILL MCCOLLUM","Republican",0.674727914356039,-70721,202309,-0.349569223316807
1996,"FLORIDA",9,73809,161708,235517,"JERRY PROVENZANO","MICHAEL BILIRAKIS","Republican",0.686608609994183,-87899,235517,-0.373217219988366
1996,"FLORIDA",10,57375,114443,171820,"HENRY GREEN","C W BILL YOUNG","Republican",0.666063322081248,-57068,171818,-0.332142150414974
1996,"FLORIDA",11,108522,78881,187403,"JIM DAVIS","MARK SHARPE","Democrat",0.579083579238326,29641,187403,0.158167158476652
1996,"FLORIDA",12,76513,122584,199097,"MIKE CANADY","CHARLES T CANADY","Republican",0.615699884980688,-46071,199097,-0.231399769961376
1996,"FLORIDA",13,96098,173671,269904,"SANFORD GORDON","DAN MILLER","Republican",0.643454709822752,-77573,269769,-0.287553425337974
1996,"FLORIDA",14,63842,176992,240834,"JIM NOLAN","PORTER J GOSS","Republican",0.734912844531918,-113150,240834,-0.469825689063836
1996,"FLORIDA",15,115981,139014,270350,"JOHN L BYRON","DAVE WELDON","Republican",0.514200110967265,-23033,254995,-0.0903272613188494
1996,"FLORIDA",16,98827,175714,274541,"JIM STUBER","MARK FOLEY","Republican",0.640028265359272,-76887,274541,-0.280056530718545
1996,"FLORIDA",17,114638,14525,129165,"CARRIE P MEEK","WELLINGTON ROLLE","Democrat",0.887531452018736,100113,129163,0.775090389662674
1996,"FLORIDA",19,188766,99101,287867,"ROBERT WEXLER","BEVERLY KENNEDY","Democrat",0.655740324524867,89665,287867,0.311480649049735
1996,"FLORIDA",20,159256,85777,245033,"PETER DEUTSCH","JIM JACOBS","Democrat",0.649936947268327,73479,245033,0.299873894536654
1996,"FLORIDA",22,84517,137098,221618,"KENNETH D COOPER","E CLAY SHAW JR","Republican",0.618623036034979,-52581,221615,-0.237262820657446
1996,"FLORIDA",23,102161,36907,139089,"ALCEE L HASTINGS","ROBERT PAUL BROWN","Democrat",0.734500931058531,65254,139068,0.469223689130497
1996,"GEORGIA",1,50622,108616,159238,"ROSEMARY D KASZANS","JACK KINGSTON","Republican",0.682098494078047,-57994,159238,-0.364196988156093
1996,"GEORGIA",2,88256,75282,163538,"SANFORD D BISHOP JR","DARREL BUSH EALUM","Democrat",0.539666621824897,12974,163538,0.0793332436497939
1996,"GEORGIA",3,76538,120251,196789,"JIM CHAFIN","MAC COLLINS","Republican",0.611065659157778,-43713,196789,-0.222131318315556
1996,"GEORGIA",4,127157,92985,220142,"CYNTHIA A MCKINNEY","JOHN M MITNICK","Democrat",0.577613540351228,34172,220142,0.155227080702456
1996,"GEORGIA",6,127135,174155,301290,"MICHAEL COLES","NEWT GINGRICH","Republican",0.578031132795645,-47020,301290,-0.156062265591291
1996,"GEORGIA",7,81765,112009,193774,"CHARLIE WATTS","BOB BARR","Republican",0.578039365446345,-30244,193774,-0.156078730892689
1996,"GEORGIA",8,84506,93619,178125,"JIM WIGGINS","SAXBY CHAMBLISS","Republican",0.525580350877193,-9113,178125,-0.051160701754386
1996,"GEORGIA",9,69662,132532,202194,"MCCRACKEN ""KEN"" POSTON","NATHAN DEAL","Republican",0.655469499589503,-62870,202194,-0.310938999179006
1996,"GEORGIA",10,88054,96723,184777,"DAVID BELL","CHARLIE NORWOOD","Republican",0.523458006137127,-8669,184777,-0.0469160122742549
1996,"GEORGIA",11,80940,145821,226761,"TOMMY STEPHENSON","JOHN LINDER","Republican",0.643060314604363,-64881,226761,-0.286120629208726
1996,"HAWAII",1,86732,80053,172206,"NEIL ABERCROMBIE","ORSON SWINDLE","Democrat",0.50365260211607,6679,166785,0.0400455676469706
1996,"HAWAII",2,109178,55729,180963,"PATSY T MINK","TOM PICO JR","Democrat",0.603316700098915,53449,164907,0.324116016906499
1996,"IDAHO",1,125899,132344,264778,"DAN WILLIAMS","HELEN CHENOWETH","Republican",0.499830046302941,-6445,258243,-0.0249571140360048
1996,"IDAHO",2,67625,157646,229248,"JOHN D SEIDL","MICHAEL D CRAPO","Republican",0.687665759352317,-90021,225271,-0.399612022852475
1996,"ILLINOIS",1,174005,25659,203113,"BOBBY L RUSH","NOEL NAUGHTON","Democrat",0.856690610645306,148346,199664,0.742978203381681
1996,"ILLINOIS",3,137153,67214,209916,"WILLIAM O LIPINSKI","JIM NALEPA","Democrat",0.653370872158387,69939,204367,0.342222570180117
1996,"ILLINOIS",5,117544,65768,183326,"ROD R BLAGOJEVICH","MICHAEL PATRICK FLANAGAN","Democrat",0.641174737898607,51776,183312,0.282447412062495
1996,"ILLINOIS",6,68807,132401,205954,"STEPHEN DE LA ROSA","HENRY J HYDE","Republican",0.642866853763462,-63594,201208,-0.316060991610672
1996,"ILLINOIS",7,149568,27241,181095,"DANNY K DAVIS","RANDY BOROW","Democrat",0.825909053259339,122327,176809,0.691859577283962
1996,"ILLINOIS",8,74068,127763,205305,"ELIZABETH ANNE ""BETTY"" HULL","PHILIP M CRANE","Republican",0.622308273057159,-53695,201831,-0.266039409208694
1996,"ILLINOIS",9,124319,71763,196082,"SIDNEY R YATES","JOSEPH WALSH","Democrat",0.634015360920431,52556,196082,0.268030721840863
1996,"ILLINOIS",10,65144,145626,210773,"PHILIP R TORF","JOHN EDWARD PORTER","Republican",0.690913921612351,-80482,210770,-0.381847511505432
1996,"ILLINOIS",11,102388,109896,212284,"CLEM BALANOFF","JERRY WELLER","Republican",0.51768385747395,-7508,212284,-0.0353677149479
1996,"ILLINOIS",12,150005,55690,209519,"JERRY F COSTELLO","SHAPLEY R HUNTER","Democrat",0.715949388838244,94315,205695,0.458518680570748
1996,"ILLINOIS",13,94693,141651,236344,"SUSAN W HYNES","HARRIS W FAWELL","Republican",0.599342483837119,-46958,236344,-0.198684967674238
1996,"ILLINOIS",14,74332,134432,208764,"DOUG MAINS","J DENNIS HASTERT","Republican",0.643942442183518,-60100,208764,-0.287884884367036
1996,"ILLINOIS",15,90065,121019,211084,"LAUREL LUNT PRUSSING","THOMAS W EWING","Republican",0.573321521290102,-30954,211084,-0.146643042580205
1996,"ILLINOIS",16,90575,137523,228100,"CATHERINE M LEE","DONALD A MANZULLO","Republican",0.602906619903551,-46948,228098,-0.205823812571789
1996,"ILLINOIS",17,120008,109240,231173,"LANE EVANS","MARK BAKER","Democrat",0.519126368563803,10768,229248,0.0469709659408152
1996,"ILLINOIS",18,98413,143110,241523,"MIKE CURRAN","RAY LAHOOD","Republican",0.59253156014127,-44697,241523,-0.18506312028254
1996,"ILLINOIS",19,158668,75751,237955,"GLENN POSHARD","BRENT WINTERS","Democrat",0.666798344224748,82917,234419,0.353712796317705
1996,"ILLINOIS",20,119688,120926,240618,"JAY C HOFFMAN","JOHN SHIMKUS","Republican",0.50256423043995,-1238,240614,-0.00514517027271896
1996,"INDIANA",1,133553,56418,193113,"PETER J VISCLOSKY","MICHAEL EDWARD PETYO","Democrat",0.691579541511965,77135,189971,0.406035658074127
1996,"INDIANA",2,85105,123113,212883,"R MARC CARMICHAEL","DAVID M MCINTOSH","Republican",0.578312970035184,-38008,208218,-0.182539453841647
1996,"INDIANA",3,114288,80699,197312,"TIM ROEMER","JOE ZAKAS","Democrat",0.579224781057412,33589,194987,0.172262766235698
1996,"INDIANA",4,81740,121344,207880,"GERALD L HOUSEMAN","MARK E SOUDER","Republican",0.583721377717914,-39604,203084,-0.195012901065569
1996,"INDIANA",5,63578,125191,211111,"DOUGLAS L CLARK","STEPHEN E BUYER","Republican",0.593010312110691,-61613,188769,-0.326393634548045
1996,"INDIANA",6,59661,193193,257857,"CARRIE JEAN DILLARD-TRAMMELL","DAN BURTON","Republican",0.749225345831216,-133532,252854,-0.52809921931233
1996,"INDIANA",7,72705,130010,209840,"ROBERT F HELLMANN","EDWARD A PEASE","Republican",0.619567289363324,-57305,202715,-0.282687516957305
1996,"INDIANA",8,106201,109860,219864,"JONATHAN WEINZAPFEL","JOHN N HOSTETTLER","Republican",0.499672524833533,-3659,216061,-0.0169350322362666
1996,"INDIANA",9,128123,96442,226844,"LEE H HAMILTON","JEAN LEISING","Democrat",0.56480665126695,31681,224565,0.14107719368557
1996,"INDIANA",10,85965,72796,162373,"JULIA CARSON","VIRGINIA BLANKENBAKER","Democrat",0.529429153861787,13169,158761,0.0829485830903055
1996,"IOWA",1,111595,129242,244596,"BOB RUSH","JAMES A LEACH","Republican",0.528389671131171,-17647,240837,-0.0732736248998285
1996,"IOWA",2,109731,127827,239299,"DONNA L SMITH","JIM NUSSLE","Republican",0.534172729514123,-18096,237558,-0.0761750814537923
1996,"IOWA",3,115914,111895,234875,"LEONARD L BOSWELL","MIKE MAHAFFEY","Democrat",0.49351357104843,4019,227809,0.017641972002862
1996,"IOWA",4,119790,133419,256509,"CONNIE MCBURNEY","GREG GANSKE","Republican",0.520133796474977,-13629,253209,-0.0538251010035188
1996,"IOWA",5,75785,147576,225479,"MACDONALD SMITH","TOM LATHAM","Republican",0.654499975607485,-71791,223361,-0.321412422043239
1996,"KANSAS",1,63948,191899,261145,"JOHN DIVINE","JERRY MORAN","Republican",0.734836967967987,-127951,255847,-0.500107486114748
1996,"KANSAS",2,114644,131592,252078,"JOHN FRIEDAN","JIM RYUN","Republican",0.522028895817961,-16948,246236,-0.0688282785620299
1996,"KANSAS",3,126848,139169,279264,"JUDY HANCOCK","VINCE SNOWBARGER","Republican",0.498342070585539,-12321,266017,-0.0463165887894383
1996,"KANSAS",4,119544,128486,256391,"RANDY RATHBUN","TODD TIAHRT","Republican",0.501133035090935,-8942,248030,-0.0360520904729267
1996,"KENTUCKY",1,96684,111473,208157,"DENNIS L NULL","ED WHITFIELD","Republican",0.535523667231945,-14789,208157,-0.0710473344638902
1996,"KENTUCKY",2,90483,125433,215916,"JOE WRIGHT","RON LEWIS","Republican",0.580934252209192,-34950,215916,-0.161868504418385
1996,"KENTUCKY",3,125326,126625,251951,"MIKE WARD","ANNE M NORTHUP","Republican",0.502577882207255,-1299,251951,-0.00515576441450917
1996,"KENTUCKY",4,68939,149135,218074,"DENNY BOWMAN","JIM BUNNING","Republican",0.68387336408742,-80196,218074,-0.36774672817484
1996,"KENTUCKY",6,125999,100231,226230,"SCOTTY BAESLER","ERNEST FLETCHER","Democrat",0.55695089068647,25768,226230,0.113901781372939
1996,"LOUISIANA",5,97363,135990,233353,"FRANCIS THOMPSON","JOHN COOKSEY","Republican",0.58276516693593,-38627,233353,-0.165530333871859
1996,"MAINE",1,173745,140354,314164,"THOMAS H ALLEN","JAMES B LONGLEY JR","Democrat",0.553039176990362,33391,314099,0.106307247078151
1996,"MAINE",2,205439,70856,285636,"JOHN ELIAS BALDACCI","PAUL R YOUNG","Democrat",0.71923356999818,134583,276295,0.487098934110281
1996,"MARYLAND",1,81825,131033,212876,"STEVEN R EASTAUGH","WAYNE T GILCHREST","Republican",0.615536744395799,-49208,212858,-0.231177592573453
1996,"MARYLAND",2,88344,143075,231419,"CONNIE GALIAZZO DEJULIIS","ROBERT L EHRLICH JR","Republican",0.618250878277065,-54731,231419,-0.236501756554129
1996,"MARYLAND",3,130204,63229,193433,"BENJAMIN L CARDIN","PATRICK L MCDONOUGH","Democrat",0.673121959541547,66975,193433,0.346243919083093
1996,"MARYLAND",4,142094,24700,166794,"ALBERT RUSSELL WYNN","JOHN B KIMBLE","Democrat",0.851913138362291,117394,166794,0.703826276724582
1996,"MARYLAND",5,121288,91806,213094,"STENY H HOYER","JOHN S MORGAN","Democrat",0.569176044374783,29482,213094,0.138352088749566
1996,"MARYLAND",6,100910,132853,233788,"STEPHEN CRAWFORD","ROSCOE G BARTLETT","Republican",0.568262699539754,-31943,233763,-0.136646945838306
1996,"MARYLAND",7,115764,22929,138695,"ELIJAH E CUMMINGS","KENNETH KONDNER","Democrat",0.834665993727243,92835,138693,0.669356059786723
1996,"MARYLAND",8,96229,152538,249146,"DONALD MOOERS","CONSTANCE A MORELLA","Republican",0.612243423534795,-56309,248767,-0.226352369888289
1996,"MASSACHUSETTS",1,129232,115801,245111,"JOHN W OLVER","JANE MARIA SWIFT","Democrat",0.527238679618622,13431,245033,0.0548130251843629
1996,"MASSACHUSETTS",2,162995,49885,227411,"RICHARD E NEAL","MARK STEELE","Democrat",0.716741934207228,113110,212880,0.531332205937617
1996,"MASSACHUSETTS",3,135044,115694,255097,"JAMES P MCGOVERN","PETER BLUTE","Democrat",0.529382940606906,19350,250738,0.077172187701904
1996,"MASSACHUSETTS",4,183844,72701,256637,"BARNEY FRANK","JONATHAN P RAYMOND","Democrat",0.716358124510495,111143,256545,0.433230037615233
1996,"MASSACHUSETTS",6,133002,132642,276379,"JOHN F TIERNEY","PETER F TORKILDSEN","Democrat",0.48123048422637,360,265644,0.00135519718118986
1996,"MASSACHUSETTS",7,177053,76407,253570,"EDWARD J MARKEY","PATRICIA H LONG","Democrat",0.698241116851363,100646,253460,0.397088297956285
1996,"MASSACHUSETTS",8,147126,27303,174620,"JOSEPH P KENNEDY II","R PHILIP HYDE","Democrat",0.842549536135609,119823,174429,0.686944258122216
1996,"MASSACHUSETTS",9,172009,66079,238152,"JOHN JOSEPH MOAKLEY","PAUL V GRYSKA","Democrat",0.722265611878128,105930,238088,0.444919525553577
1996,"MASSACHUSETTS",10,160745,123520,295923,"WILLIAM D DELAHUNT","EDWARD B TEAGUE III","Democrat",0.54319873750942,37225,284265,0.130951752765905
1996,"MICHIGAN",1,181486,69957,256791,"BART STUPAK","BOB CARR","Democrat",0.706745952934488,111529,251443,0.443555795945801
1996,"MICHIGAN",2,83603,165608,253699,"DAN KRUSZYNSKI","PETER HOEKSTRA","Republican",0.652773562371156,-82005,249211,-0.32905850865331
1996,"MICHIGAN",3,72791,169466,247043,"BETSY J FLORY","VERNON J EHLERS","Republican",0.685977744765081,-96675,242257,-0.399059676294183
1996,"MICHIGAN",4,79691,159561,243645,"LISA A DONALDSON","DAVE CAMP","Republican",0.654891337807055,-79870,239252,-0.333832110076405
1996,"MICHIGAN",5,162675,65542,232451,"JAMES A BARCIA","LAWRENCE H SIMS","Democrat",0.699824909335731,97133,228217,0.425616847123571
1996,"MICHIGAN",6,66243,146170,215834,"CLARENCE J ANNEN","FRED UPTON","Republican",0.677233429394813,-79927,212413,-0.376281112737921
1996,"MICHIGAN",7,93725,120227,218544,"KIM H TUNNICLIFF","NICK SMITH","Republican",0.550127205505528,-26502,213952,-0.123868905174993
1996,"MICHIGAN",8,141086,115836,262421,"DEBBIE STABENOW","DICK CHRYSLER","Democrat",0.537632277904588,25250,256922,0.0982788550610691
1996,"MICHIGAN",9,136856,89733,231200,"DALE E KILDEE","PATRICK M NOWAK","Democrat",0.591937716262976,47123,226589,0.20796684746391
1996,"MICHIGAN",10,132829,106444,244281,"DAVID E BONIOR","SUSY HEINTZ","Democrat",0.543754937960791,26385,239273,0.11027153084552
1996,"MICHIGAN",11,99303,169165,276618,"MORRIS FRUMIN","JOE KNOLLENBERG","Republican",0.61154733242233,-69862,268468,-0.260224682271258
1996,"MICHIGAN",12,133436,94235,232475,"SANDER M LEVIN","JOHN PAPPAGEORGE","Democrat",0.573979997849231,39201,227671,0.172182667094184
1996,"MICHIGAN",13,123133,89907,217658,"LYNN N RIVERS","JOE FITZSIMMONS","Democrat",0.565717777430648,33226,213040,0.155961321817499
1996,"MICHIGAN",14,157722,22152,183695,"JOHN CONYERS JR","WILLIAM A ASHE","Democrat",0.858608018726694,135570,179874,0.753694252643517
1996,"MICHIGAN",15,143683,16009,162600,"CAROLYN C KILPATRICK","STEPHEN HUME","Democrat",0.883659286592866,127674,159692,0.799501540465396
1996,"MICHIGAN",16,136854,78723,220612,"JOHN D DINGELL","JAMES R DESANA","Democrat",0.620337968922815,58131,215577,0.269653070596585
1996,"MINNESOTA",1,123147,137486,261062,"MARY RIEDER","GIL GUTKNECHT","Republican",0.526641181022133,-14339,260633,-0.0550160570610782
1996,"MINNESOTA",2,144083,107807,262353,"DAVID MINGE","GARY B REVIER","Democrat",0.549195168341891,36276,251890,0.144015244749692
1996,"MINNESOTA",3,87350,205816,293583,"STANLEY J LEINO","JIM RAMSTAD","Republican",0.701048766447649,-118466,293166,-0.404091879685912
1996,"MINNESOTA",4,145831,94110,255759,"BRUCE F VENTO","DENNIS NEWINSKI","Democrat",0.570189123354408,51721,239941,0.215557157801293
1996,"MINNESOTA",5,158261,70109,246041,"MARTIN OLAV SABO","JACK ULDRICH","Democrat",0.64323019334176,88152,228370,0.386005167053466
1996,"MINNESOTA",6,164921,129988,295481,"BILL LUTHER","TAD JUDE","Democrat",0.558144178475097,34933,294909,0.118453489042383
1996,"MINNESOTA",7,170936,80132,251599,"COLLIN C PETERSON","DARRELL MCKIGNEY","Democrat",0.679398566766959,90804,251068,0.3616709417369
1996,"MINNESOTA",8,185333,69460,275338,"JAMES L OBERSTAR","ANDY LARSON","Democrat",0.673110867370287,115873,254793,0.454773090312528
1996,"MISSISSIPPI",1,55998,123724,182966,"HENRY BOYD JR","ROGER F WICKER","Republican",0.676213066908606,-67726,179722,-0.376837560231914
1996,"MISSISSIPPI",2,102503,65263,171933,"BENNIE G THOMPSON","DANNY COVINGTON","Democrat",0.596179907289467,37240,167766,0.221975847311136
1996,"MISSISSIPPI",3,68658,115443,188144,"JOHN ARTHUR EAVES JR","CHARLES W ""CHIP"" PICKERING JR","Republican",0.613588527936049,-46785,184101,-0.254126810826666
1996,"MISSISSIPPI",4,66836,112444,183663,"KEVIN ANTOINE","MIKE PARKER","Republican",0.61223000822158,-45608,179280,-0.254395359214636
1996,"MISSISSIPPI",5,103415,71114,177445,"GENE TAYLOR","DENNIS DOLLAR","Democrat",0.582800304319648,32301,174529,0.185075259698961
1996,"MISSOURI",1,131659,51857,187653,"WILLIAM ""BILL"" CLAY","DANIEL F O'SULLIVAN JR","Democrat",0.701608820535776,79802,183516,0.434850367270429
1996,"MISSOURI",2,100372,165999,270726,"JOAN KELLY HORN","JAMES M TALENT","Republican",0.613162385585426,-65627,266371,-0.246374417635553
1996,"MISSOURI",3,137300,90202,232755,"RICHARD A GEPHARDT","DEBORAH LYNN ""DEBBIE"" WHEELEHAN","Democrat",0.589890657558377,47098,227502,0.207022355847421
1996,"MISSOURI",4,153566,81650,240789,"IKE SKELTON","BILL PHELPS","Democrat",0.637761691771634,71916,235216,0.305744507176383
1996,"MISSOURI",5,144223,61803,213971,"KAREN MCCARTHY","PENNY BENNETT","Democrat",0.674030592930818,82420,206026,0.400046596060691
1996,"MISSOURI",6,169006,72064,246282,"PAT DANNER","JEFF BAILEY","Democrat",0.686229606711006,96942,241070,0.402132160783175
1996,"MISSOURI",7,79306,162558,250584,"RUTH BAMBERGER","ROY BLUNT","Republican",0.648716598027009,-83252,241864,-0.344209969238911
1996,"MISSOURI",8,83084,23477,222854,"EMILY FIREBAUGH","RICHARD KLINE","Democrat",0.372818078203667,59607,106561,0.559369750659247
1996,"MISSOURI",9,117685,123580,250230,"HAROLD L VOLKMER","KENNY C HULSHOF","Republican",0.493865643607881,-5895,241265,-0.024433713965971
1996,"MONTANA",0,174516,211975,404426,"BILL YELLOWTAIL","RICK HILL","Republican",0.524137913981791,-37459,386491,-0.0969207562401194
1996,"NEBRASKA",1,67152,157108,224260,"PATRICK J COMBS","DOUG BEREUTER","Republican",0.700561847855168,-89956,224260,-0.401123695710336
1996,"NEBRASKA",2,88447,125201,219938,"JAMES MARTIN DAVIS","JON CHRISTENSEN","Republican",0.569255881202884,-36754,213648,-0.172030629821014
1996,"NEBRASKA",3,48833,167758,216591,"JOHN WEBSTER","BILL BARRETT","Republican",0.774538184873794,-118925,216591,-0.549076369747589
1996,"NEVADA",1,75081,86472,172593,"BOB COFFIN","JOHN E ENSIGN","Republican",0.501016843093289,-11391,161553,-0.0705093684425545
1996,"NEVADA",2,97742,162310,277192,"THOMAS ""SPIKE"" WILSON","JIM GIBBONS","Republican",0.585550809547173,-64568,260052,-0.248288803777706
1996,"NEW HAMPSHIRE",1,115462,123939,247577,"JOE KEEFE","JOHN E SUNUNU","Republican",0.500607891686223,-8477,239401,-0.0354092088170058
1996,"NEW HAMPSHIRE",2,105824,122957,243260,"DEBORAH ARNIE ARNESEN","CHARLES F BASS","Republican",0.505455068650826,-17133,228781,-0.074888211870741
1996,"NEW JERSEY",1,160413,44287,210734,"ROBERT E ANDREWS","MEL SUPLEE","Democrat",0.761210815530479,116126,204700,0.567298485588666
1996,"NEW JERSEY",2,83890,133131,220718,"RUTH KATZ","FRANK A LOBIONDO","Republican",0.60317237379824,-49241,217021,-0.226895093101589
1996,"NEW JERSEY",3,81590,157503,245278,"JOHN LEONARDI","JIM SAXTON","Republican",0.642140754572363,-75913,239093,-0.317504067454923
1996,"NEW JERSEY",4,77565,146404,230114,"KEVIN JOHN MEARA","CHRISTOPHER H SMITH","Republican",0.636223784732785,-68839,223969,-0.307359500645179
1996,"NEW JERSEY",5,62956,181323,254333,"BILL AUER","MARGE ROUKEMA","Republican",0.712935403585064,-118367,244279,-0.48455659307595
1996,"NEW JERSEY",6,124635,73402,203478,"FRANK PALLONE JR","STEVEN J CORODEMUS","Democrat",0.612523221183617,51233,198037,0.258704181541833
1996,"NEW JERSEY",7,97285,128821,232571,"LARRY LERNER","BOB FRANKS","Republican",0.553899669348285,-31536,226106,-0.139474405809664
1996,"NEW JERSEY",8,98861,92609,193091,"WILLIAM J PASCRELL JR","WILLIAM J MARTINI","Democrat",0.511991755182789,6252,191470,0.0326526348775265
1996,"NEW JERSEY",9,117646,89005,210930,"STEVEN R ROTHMAN","KATHLEEN A DONOVAN","Democrat",0.557749016261319,28641,206651,0.138595990341203
1996,"NEW JERSEY",10,127126,22086,151060,"DONALD M PAYNE","VANESSA WILLIAMS","Democrat",0.841559645174103,105040,149212,0.703964828566067
1996,"NEW JERSEY",11,78742,169091,255158,"CHRIS EVANGEL","RODNEY P FRELINGHUYSEN","Republican",0.66269135202502,-90349,247833,-0.364555971157998
1996,"NEW JERSEY",12,125594,135811,269221,"DAVID M DELVECCHIO","MIKE PAPPAS","Republican",0.504459161803871,-10217,261405,-0.0390849448174289
1996,"NEW JERSEY",13,115459,25427,146473,"ROBERT MENENDEZ","CARLOS E MUNOZ","Democrat",0.78826131778553,90032,140886,0.639041494541686
1996,"NEW MEXICO",1,71635,109290,193078,"JOHN WERTHEIM","STEVEN SCHIFF","Republican",0.566040667502253,-37655,180925,-0.208124913638248
1996,"NEW MEXICO",2,74915,95091,170006,"E SHIRLEY BACA","JOE SKEEN","Republican",0.559339082150042,-20176,170006,-0.118678164300084
1996,"NEW MEXICO",3,124594,56580,185271,"BILL RICHARDSON","BILL REDMOND","Democrat",0.672495965369648,68014,181174,0.375407067239229
1996,"NEW YORK",1,93816,90001,235506,"NORA L BREDES","MICHAEL P FORBES","Democrat",0.398359277470638,3815,183817,0.0207543371940571
1996,"NEW YORK",2,53055,97105,203172,"KENNETH J HERMAN","RICK LAZIO","Republican",0.477944795542693,-44050,150160,-0.293353755993607
1996,"NEW YORK",3,93145,111310,259409,"DAL A LAMAGNA","PETER T KING","Republican",0.429090740876377,-18165,204455,-0.0888459563229072
1996,"NEW YORK",4,119946,78004,236238,"CAROLYN MCCARTHY","DAN FRISA","Democrat",0.507733726157519,41942,197950,0.211881788330386
1996,"NEW YORK",5,116005,59394,224495,"GARY L ACKERMAN","GRANT M LALLY","Democrat",0.51673756653823,56611,175399,0.322755545926716
1996,"NEW YORK",6,102799,13986,153238,"FLOYD H FLAKE","JORAWAR MISIR","Democrat",0.670845351675172,88813,116785,0.76048293873357
1996,"NEW YORK",7,78848,24826,151185,"THOMAS J MANTON","ROSE BIRTLEY","Democrat",0.521533220888316,54022,103674,0.521075679533924
1996,"NEW YORK",8,123809,25005,197860,"JERROLD NADLER","MICHAEL BENJAMIN","Democrat",0.625740422520974,98804,148814,0.663942908597309
1996,"NEW YORK",9,102556,27829,178160,"CHARLES E SCHUMER","ROBERT J VERGA","Democrat",0.575639874270319,74727,130385,0.573125742991909
1996,"NEW YORK",10,97125,6827,153666,"EDOLPHUS TOWNS","AMELIA SMITH PARKER","Democrat",0.632052633633985,90298,103952,0.868650915807296
1996,"NEW YORK",11,87559,5369,133934,"MAJOR R OWENS","CLAUDETTE HAYLE","Democrat",0.653747368106679,82190,92928,0.884448174931129
1996,"NEW YORK",12,58947,7824,100185,"NYDIA M VELAZQUEZ","MIGUEL I PRADO","Democrat",0.588381494235664,51123,66771,0.765646762816193
1996,"NEW YORK",13,51448,74836,183921,"TYRONE G BUTLER","SUSAN MOLINARI","Republican",0.406892089538443,-23388,126284,-0.185201609071616
1996,"NEW YORK",14,122504,42641,211303,"CAROLYN B MALONEY","JEFFREY E LIVINGSTON","Democrat",0.579755138355821,79863,165145,0.483593205970511
1996,"NEW YORK",15,108680,5951,155236,"CHARLES B RANGEL","EDWARD R ADAMS","Democrat",0.700095338710093,102729,114631,0.896171192783802
1996,"NEW YORK",16,86971,2878,130722,"JOSE E SERRANO","RODNEY TORRES","Democrat",0.665312648215297,84093,89849,0.935936960901067
1996,"NEW YORK",17,97891,11488,153797,"ELIOT L ENGEL","DENIS MCCARTHY","Democrat",0.636494860107804,86403,109379,0.789941396428931
1996,"NEW YORK",18,118194,51656,213574,"NITA M LOWEY","KERRY J KATSORHIS","Democrat",0.553410059276878,66538,169850,0.391745657933471
1996,"NEW YORK",19,83975,98705,243986,"RICHARD S KLEIN","SUE W KELLY","Republican",0.404551900518882,-14730,182680,-0.0806328005255091
1996,"NEW YORK",20,77756,122479,245812,"YASH P AGGARWAL","BENJAMIN A GILMAN","Republican",0.498262900102517,-44723,200235,-0.223352560741129
1996,"NEW YORK",21,136964,62630,267608,"MICHAEL R MCNULTY","NANCY NORMAN","Democrat",0.511808316642253,74334,199594,0.372426024830406
1996,"NEW YORK",22,94192,119467,265794,"STEVE JAMES","GERALD B H SOLOMON","Republican",0.449472147603031,-25275,213659,-0.118295976298682
1996,"NEW YORK",23,50436,118653,226149,"BRUCE W HAPANOWICZ","SHERWOOD L BOEHLERT","Republican",0.524667365321094,-68217,169089,-0.403438425917712
1996,"NEW YORK",24,43692,108777,209946,"DONALD RAVENSCROFT","JOHN M MCHUGH","Republican",0.518118944871538,-65085,152469,-0.426873659563583
1996,"NEW YORK",25,103199,106327,242136,"MARTY MACK","JAMES T WALSH","Republican",0.43912098985694,-3128,209526,-0.0149289348338631
1996,"NEW YORK",26,117097,78946,238437,"MAURICE D HINCHEY","SUE WITTIG","Democrat",0.491102471512391,38151,196043,0.194605265171416
1996,"NEW YORK",27,91679,117818,260311,"THOMAS M FRICANO","BILL PAXON","Republican",0.452604768911033,-26139,209497,-0.124770283106679
1996,"NEW YORK",28,133084,85038,250094,"LOUISE MCINTOSH SLAUGHTER","GEOFF H ROSENBERGER","Democrat",0.532135916895247,48046,218122,0.220271224360679
1996,"NEW YORK",29,126210,66438,238399,"JOHN J LAFALCE","DAVID B CALLARD","Democrat",0.529406583081305,59772,192648,0.310265354428803
1996,"NEW YORK",30,97686,97320,241405,"FRANCIS J PORDUM","JACK QUINN","Democrat",0.404656075889066,366,195006,0.0018768653272207
1996,"NEW YORK",31,49502,119395,225718,"BRUCE D MACBAIN","AMO HOUGHTON","Republican",0.528956485526188,-69893,168897,-0.413820257316589
1996,"NORTH CAROLINA",1,108759,54666,165028,"EVA M CLAYTON","TED TYLER","Democrat",0.65903361853746,54093,163425,0.330995869664984
1996,"NORTH CAROLINA",2,113820,98951,216629,"BOB ETHERIDGE","DAVID FUNDERBURK","Democrat",0.525414418198856,14869,212771,0.0698826437813424
1996,"NORTH CAROLINA",3,68887,118159,188579,"GEORGE PARROTT","WALTER B JONES JR","Republican",0.626575599616076,-49272,187046,-0.263421832062701
1996,"NORTH CAROLINA",4,157194,126466,288984,"DAVID E PRICE","FRED HEINEMAN","Democrat",0.543953990532348,30728,283660,0.108326870196714
1996,"NORTH CAROLINA",5,74320,130177,209698,"NEIL GRIST CASHION JR","RICHARD BURR","Republican",0.620783221585328,-55857,204497,-0.2731433712964
1996,"NORTH CAROLINA",6,58022,167828,228543,"MARK COSTLEY","HOWARD COBLE","Republican",0.734338833392403,-109806,225850,-0.486189949081249
1996,"NORTH CAROLINA",7,87487,75811,165440,"MIKE MCINTYRE","BILL CASTER","Democrat",0.528814071566731,11676,163298,0.0715011818883269
1996,"NORTH CAROLINA",8,103129,81676,186908,"W G ""BILL"" HEFNER","CURTIS BLACKWOOD","Democrat",0.551763434416932,21453,184805,0.116084521522686
1996,"NORTH CAROLINA",9,83078,147755,234710,"MICHEL C ""MIKE"" DAISLEY","SUE MYRICK","Republican",0.629521537216139,-64677,230833,-0.280189574280974
1996,"NORTH CAROLINA",10,65103,158585,226597,"BEN NEILL","CASS BALLENGER","Republican",0.699854808316085,-93482,223688,-0.417912449483209
1996,"NORTH CAROLINA",11,91257,132860,228025,"JAMES MARK FERGUSON","CHARLES H TAYLOR","Republican",0.582655410590944,-41603,224117,-0.185630719668744
1996,"NORTH CAROLINA",12,124675,46581,174399,"MELVIN L WATT","JOSEPH A ""JOE"" MARTINO JR","Democrat",0.714883686259669,78094,171256,0.456007380763302
1996,"NORTH DAKOTA",0,144833,113684,263010,"EARL POMEROY","KEVIN CRAMER","Democrat",0.550674879282157,31149,258517,0.120491108901929
1996,"OHIO",1,94719,118324,218424,"MARK P LONGABAUGH","STEVE CHABOT","Republican",0.541717027432883,-23605,213043,-0.110799228324798
1996,"OHIO",2,58715,186853,259473,"THOMAS R CHANDLER","ROB PORTMAN","Republican",0.720125022642048,-128138,245568,-0.521802514985666
1996,"OHIO",3,144583,75732,227203,"TONY P HALL","DAVID A WESTBROCK","Democrat",0.636360435381575,68851,220315,0.31251163107369
1996,"OHIO",4,69096,147608,227761,"PAUL ANTHONY MCCLAIN","MICHAEL G OXLEY","Republican",0.648082858786184,-78512,216704,-0.3623006497342
1996,"OHIO",5,81170,145892,238523,"ANNIE SAUNDERS","PAUL E GILMOR","Republican",0.611647514076211,-64722,227062,-0.28504109009874
1996,"OHIO",6,118003,111907,229926,"TED STRICKLAND","FRANK A CREMEANS","Democrat",0.513221645224985,6096,229910,0.0265147231525379
1996,"OHIO",7,61419,158087,233001,"RICHARD K BLAIN","DAVID L HOBSON","Republican",0.678482066600573,-96668,219506,-0.440388873197088
1996,"OHIO",8,61515,165815,235943,"JEFFREY D KITCHEN","JOHN A BOEHNER","Republican",0.702775670394968,-104300,227330,-0.458804381295913
1996,"OHIO",9,170617,46040,221334,"MARCY KAPTUR","RANDY WHITMAN","Democrat",0.770857617898741,124577,216657,0.57499642291733
1996,"OHIO",10,110723,104546,225696,"DENNIS J KUCINICH","MARTIN R HOKE","Democrat",0.490584680277896,6177,215269,0.0286943312785399
1996,"OHIO",11,153546,28821,189039,"LOUIS STOKES","JAMES J SYKORA","Democrat",0.812245092282545,124725,182367,0.683923078188488
1996,"OHIO",12,78762,151667,237434,"CYNTHIA L RUCCIA","JOHN R KASICH","Republican",0.638775407060488,-72905,230429,-0.316388128230388
1996,"OHIO",13,148690,87108,244505,"SHERROD BROWN","KENNETH C BLAIR JR","Democrat",0.60812662317744,61582,235798,0.261164216829659
1996,"OHIO",14,124136,95307,228435,"THOMAS C SAWYER","JOYCE GEORGE","Democrat",0.543419353426576,28829,219443,0.131373522964961
1996,"OHIO",15,64665,156776,221441,"CLIFF ARNEBECK JR","DEBORAH PRYCE","Republican",0.70798090687813,-92111,221441,-0.41596181375626
1996,"OHIO",16,64902,159314,231827,"THOMAS E BURKHART","RALPH REGULA","Republican",0.68721072178823,-94412,224216,-0.421076105184287
1996,"OHIO",18,108332,117365,233843,"ROBERT L BURCH","ROBERT W NEY","Republican",0.501896571631394,-9033,225697,-0.0400226852815943
1996,"OHIO",19,101152,135012,246819,"THOMAS J COYNE JR","STEVEN C LATOURETTE","Republican",0.547008131464758,-33860,236164,-0.143374942836334
1996,"OKLAHOMA",1,57996,143415,210407,"RANDOLPH JOHN AMEN","STEVE LARGENT","Republican",0.681607551079574,-85419,201411,-0.424102953661915
1996,"OKLAHOMA",2,90120,112273,202393,"GLEN D JOHNSON","TOM A COBURN","Republican",0.554727683269678,-22153,202393,-0.109455366539357
1996,"OKLAHOMA",3,86647,98526,191508,"DARRYL ROBERTS","WES WATKINS","Republican",0.514474591139796,-11879,185173,-0.06415082112403
1996,"OKLAHOMA",4,73950,106923,185373,"ED CROCKER","J C WATTS JR","Republican",0.576799210240974,-32973,180873,-0.182299182299182
1996,"OKLAHOMA",5,57594,148362,212791,"JAMES L FORSYTHE","ERNEST J ISTOOK JR","Republican",0.697219337284002,-90768,205956,-0.440715492629494
1996,"OKLAHOMA",6,64173,113499,177672,"PAUL M BARBY","FRANK D LUCAS","Republican",0.638811968121032,-49326,177672,-0.277623936242064
1996,"OREGON",1,144588,126146,278604,"ELIZABETH FURSE","BILL WITT","Democrat",0.518973166214412,18442,270734,0.0681185222395414
1996,"OREGON",2,97195,164062,266056,"MIKE DUGAN","ROBERT F SMITH","Republican",0.616644616171032,-66867,261257,-0.255943381421359
1996,"OREGON",3,165922,65259,247909,"EARL BLUMENAUER","SCOTT BRUUN","Democrat",0.669285907328899,100663,231181,0.43542938217241
1996,"OREGON",4,177270,76649,269856,"PETER A DEFAZIO","JOHN D NEWKIRK","Democrat",0.656905905371754,100621,253919,0.396272039508662
1996,"OREGON",5,139521,125409,272636,"DARLENE HOOLEY","JIM BUNN","Democrat",0.511748265086049,14112,264930,0.0532669006907485
1996,"PENNSYLVANIA",1,145210,20734,165945,"THOMAS M FOGLIETTA","JAMES D CELLA","Democrat",0.875048962005484,124476,165944,0.750108470327339
1996,"PENNSYLVANIA",2,168887,23047,191937,"CHAKA FATTAH","LARRY G MURPHY","Democrat",0.879908511647051,145840,191934,0.759844529890483
1996,"PENNSYLVANIA",3,121120,54681,175801,"ROBERT A BORSKI","JOSEPH M MCCOLGAN","Democrat",0.688960813647249,66439,175801,0.377921627294498
1996,"PENNSYLVANIA",4,142621,79448,222167,"RON KLINK","PAUL T ADAMETZ","Democrat",0.641954025575356,63173,222069,0.284474645267912
1996,"PENNSYLVANIA",5,76627,116303,193003,"RUTH C RUDY","JOHN E PETERSON","Republican",0.602596850826153,-39676,192930,-0.205649717514124
1996,"PENNSYLVANIA",6,115193,80061,196729,"TIM HOLDEN","CHRISTIAN Y LEINBACH","Democrat",0.585541531751801,35132,195254,0.179929732553494
1996,"PENNSYLVANIA",7,79875,165087,246666,"JOHN F INNELLI","CURT WELDON","Republican",0.669273430468731,-85212,244962,-0.347858035123815
1996,"PENNSYLVANIA",8,79856,133749,226322,"JOHN P MURRAY","JAMES C GREENWOOD","Republican",0.590967736234215,-53893,213605,-0.252302146485335
1996,"PENNSYLVANIA",9,50650,142105,192822,"MONTE KEMMLER","BUD SHUSTER","Republican",0.736975033969153,-91455,192755,-0.474462400456538
1996,"PENNSYLVANIA",10,75536,124670,208540,"JOE CULLEN","JOSEPH M MCDADE","Republican",0.597822959624053,-49134,200206,-0.245417220263129
1996,"PENNSYLVANIA",11,128258,60339,188609,"PAUL E KANJORSKI","STEPHEN A URBAN","Democrat",0.680020571658829,67919,188597,0.360127679655562
1996,"PENNSYLVANIA",12,136815,58643,195481,"JOHN P MURTHA","BILL CHOBY","Democrat",0.699888991769021,78172,195458,0.399942698687186
1996,"PENNSYLVANIA",13,120220,120304,245979,"JOSEPH M HOEFFEL","JON D FOX","Republican",0.489082401343204,-84,240524,-0.000349237498129085
1996,"PENNSYLVANIA",14,122922,78921,202578,"WILLIAM J COYNE","BILL RAVOTTI","Democrat",0.606788496282913,44001,201843,0.217996165336425
1996,"PENNSYLVANIA",15,109812,82803,200363,"PAUL MCHALE","BOB KILBANKS","Democrat",0.548065261550286,27009,192615,0.140222724086909
1996,"PENNSYLVANIA",16,78598,124511,209602,"JAMES G BLAINE","JOSEPH R PITTS","Republican",0.594035362257994,-45913,203109,-0.226051036635501
1996,"PENNSYLVANIA",17,57911,150678,208616,"PAUL KATTL","GEORGE W GEKAS","Republican",0.722274418069563,-92767,208589,-0.444735820201449
1996,"PENNSYLVANIA",18,120410,86829,214990,"MICHAEL F DOYLE","DAVID B FAWCETT","Democrat",0.560072561514489,33581,207239,0.16203996352038
1996,"PENNSYLVANIA",19,74944,130716,208963,"SCOTT L CHRONISTER","WILLIAM F GOODLING","Republican",0.6255461493183,-55772,205660,-0.271185451716425
1996,"PENNSYLVANIA",20,113394,97004,210402,"FRANK MASCARA","MIKE MCCORMICK","Democrat",0.538939743918784,16390,210398,0.0778999800378331
1996,"PENNSYLVANIA",21,104004,106875,210888,"RONALD A DINICOLA","PHIL ENGLISH","Republican",0.506785592352339,-2871,210879,-0.0136144424053604
1996,"RHODE ISLAND",1,121781,49199,175425,"PATRICK J KENNEDY","GIOVANNI D CICIONE","Democrat",0.694205500926322,72582,170980,0.424505790150895
1996,"RHODE ISLAND",2,118827,58458,184318,"ROBERT A WEYGAND","RICHARD E WILD","Democrat",0.644684729652014,60369,177285,0.340519502495981
1996,"SOUTH CAROLINA",3,73417,114273,189525,"DEBBIE DORN","LINDSEY O GRAHAM","Republican",0.602944202611793,-40856,187690,-0.217678086205978
1996,"SOUTH CAROLINA",4,54126,138165,194792,"DARRELL E CURRY","BOB INGLIS","Republican",0.709295042917574,-84039,192291,-0.43704073513581
1996,"SOUTH CAROLINA",5,97335,81455,179949,"JOHN M SPRATT JR","LARRY L BIGHAM","Democrat",0.540903255922511,15880,178790,0.0888192851949214
1996,"SOUTH CAROLINA",6,120132,51974,173054,"JAMES E CLYBURN","GARY MCLEOD","Democrat",0.69418794133623,68158,172106,0.396023380939653
1996,"SOUTH DAKOTA",0,119547,186393,323203,"RICK WEILAND","JOHN R THUNE","Republican",0.576705661766753,-66846,305940,-0.218493822318102
1996,"TENNESSEE",1,58657,117676,181708,"KAY C SMITH","WILLIAM L JENKINS","Republican",0.647610451933872,-59019,176333,-0.334701955958329
1996,"TENNESSEE",2,61020,150953,213574,"STEPHEN SMITH","JOHN J DUNCAN JR","Republican",0.706794834577243,-89933,211973,-0.424266298066263
1996,"TENNESSEE",3,85714,113408,201444,"CHARLES N ""CHUCK"" JOLLY","ZACH WAMP","Republican",0.562975318202577,-27694,199122,-0.139080563674531
1996,"TENNESSEE",4,73331,103091,178063,"MARK STEWART","VAN HILLEARY","Republican",0.578958009243919,-29760,176422,-0.16868644500119
1996,"TENNESSEE",5,140264,46201,193783,"BOB CLEMENT","STEVEN L EDMONDSON","Democrat",0.72381994292585,94063,186465,0.504453918966026
1996,"TENNESSEE",6,123846,94599,227571,"BART GORDON","STEVE GILL","Democrat",0.544208181183015,29247,218445,0.133887248506489
1996,"TENNESSEE",7,64512,126737,193742,"DON TROTTER","ED BRYANT","Republican",0.654153461820359,-62225,191249,-0.325361178359103
1996,"TENNESSEE",8,123681,55024,183898,"JOHN S TANNER","TOM WATSON","Democrat",0.672552175662596,68657,178705,0.384191824515263
1996,"TENNESSEE",9,116345,70951,190414,"HAROLD E FORD JR","ROD DEBERRY","Democrat",0.611010745008245,45394,187296,0.242365026482146
1996,"TEXAS",1,102697,93105,199170,"MAX SANDLIN","ED MERRITT","Democrat",0.51562484309886,9592,195802,0.0489882636540995
1996,"TEXAS",2,102908,89838,196971,"JIM TURNER","BRIAN BABIN","Democrat",0.52245254377548,13070,192746,0.0678094487045127
1996,"TEXAS",3,47654,142325,195026,"LEE COLE","SAM JOHNSON","Republican",0.729774491606247,-94671,189979,-0.498323498913038
1996,"TEXAS",4,132126,71065,207177,"RALPH M HALL","JERRY RAY HALL","Democrat",0.637744537279717,61061,203191,0.300510357250075
1996,"TEXAS",5,70922,80196,151119,"JOHN POULAND","PETE SESSIONS","Republican",0.530681118853354,-9274,151118,-0.0613692611072142
1996,"TEXAS",7,28187,152024,186831,"AL J K SIEGMUND","BILL ARCHER","Republican",0.813697940919869,-123837,180211,-0.687177808235901
1996,"TEXAS",8,37935,207094,193659,"CYNTHIA ""CJ"" NEWMAN","GENE FONTENOT","Republican",1.06937451912898,-169159,245029,-0.690363181500965
1996,"TEXAS",8,37935,207094,51370,"CYNTHIA ""CJ"" NEWMAN","GENE FONTENOT","Republican",4.03141911621569,-169159,245029,-0.690363181500965
1996,"TEXAS",9,160894,141041,189840,"GERALDINE SAM","STEVE STOCKMAN","Democrat",0.847524230931311,19853,301935,0.0657525626376538
1996,"TEXAS",9,160894,141041,112095,"GERALDINE SAM","STEVE STOCKMAN","Democrat",1.43533609884473,19853,301935,0.0657525626376538
1996,"TEXAS",10,132066,97204,234991,"LLOYD DOGGETT","TERESA DOGGETT","Democrat",0.562004502300088,34862,229270,0.152056527238627
1996,"TEXAS",11,99990,74549,175935,"CHET EDWARDS","JAY MATHIS","Democrat",0.568334896410606,25441,174539,0.14576111929139
1996,"TEXAS",12,69859,98349,170204,"HUGH PARMER","KAY GRANGER","Republican",0.577830133251862,-28490,168208,-0.169373632645296
1996,"TEXAS",13,56066,116098,173627,"SAMUEL BROWN SILVERMAN","WILLIAM M ""MAC"" THORNBERRY","Republican",0.668663283936254,-60032,172164,-0.34869078320671
1996,"TEXAS",14,93200,99961,195699,"CHARLES ""LEFTY"" MORRIS","RON PAUL","Republican",0.510789528817214,-6761,193161,-0.0350018896153986
1996,"TEXAS",15,86347,50914,138594,"RUBEN HINOJOSA","TOM HAUGHEY","Democrat",0.623021198608886,35433,137261,0.258143245350099
1996,"TEXAS",16,90260,35271,127784,"SILVESTRE REYES","RICK LEDESMA","Democrat",0.706348212608777,54989,125531,0.438051158677936
1996,"TEXAS",17,99678,91429,192994,"CHARLES W STENHOLM","RUDY IZZARD","Democrat",0.516482377690498,8249,191107,0.0431643006273972
1996,"TEXAS",18,110523,27165,137688,"MIKE LAMSON","GEORGE A YOUNG","Democrat",0.802706118180234,83358,137688,0.605412236360467
1996,"TEXAS",19,38316,156910,195226,"JOHN W SAWYER","LARRY COMBEST","Republican",0.803735158226875,-118594,195226,-0.607470316453751
1996,"TEXAS",20,88190,47616,138409,"HENRY B GONZALEZ","JAMES WALKER","Democrat",0.63716954822302,40574,135806,0.298764413943419
1996,"TEXAS",21,60338,205830,269307,"GORDON H WHARTON","LAMAR S SMITH","Republican",0.764295023894663,-145492,266168,-0.546617174115596
1996,"TEXAS",22,59030,126056,185086,"SCOTT DOUGLAS CUNNINGHAM","TOM DELAY","Republican",0.681067179581384,-67026,185086,-0.362134359162768
1996,"TEXAS",23,59596,101332,163839,"CHARLES P JONES","HENRY BONILLA","Republican",0.618485220246706,-41736,160928,-0.259345794392523
1996,"TEXAS",24,82503,54551,139637,"MARION JACOB","ED HARRISON","Democrat",0.590839104248874,27952,137054,0.20394880849884
1996,"TEXAS",25,94796,84615,128393,"BEVERLEY CLARK","BRENT PERRY","Democrat",0.738326855825473,10181,179411,0.0567467992486525
1996,"TEXAS",25,94796,84615,51288,"BEVERLEY CLARK","BRENT PERRY","Democrat",1.84830759631883,10181,179411,0.0567467992486525
1996,"TEXAS",26,58623,163708,222342,"JERRY FRANKEL","RICHARD K ARMEY","Republican",0.736289140153457,-105085,222331,-0.472651137268307
1996,"TEXAS",27,97350,50964,150600,"SOLOMON P ORTIZ","JOE GARDNER","Democrat",0.646414342629482,46386,148314,0.312755370362879
1996,"TEXAS",28,110148,34191,146135,"FRANK TEJEDA","MARK L CUDE","Democrat",0.753741403496767,75957,144339,0.526240309271922
1996,"TEXAS",29,61751,28381,91472,"GENE GREEN","JACK RODRIGUEZ","Democrat",0.67508089907294,33370,90132,0.370234766786491
1996,"TEXAS",30,79397,28425,113072,"EDDIE BERNICE JOHNSON","JOHN HENDRY","Democrat",0.70218091127777,50972,107822,0.472742111999406
1996,"UTAH",1,65866,150126,219779,"GREGORY J SANDERS","JAMES V HANSEN","Republican",0.683077091077856,-84260,215992,-0.390107041001519
1996,"UTAH",2,100283,129963,236321,"ROSS C ANDERSON","MERRILL COOK","Republican",0.549942662734162,-29680,230246,-0.128905605309104
1996,"UTAH",3,98178,106220,207715,"BILL ORTON","CHRIS CANNON","Republican",0.511373757311701,-8042,204398,-0.0393448076791358
1996,"VERMONT",0,23830,83021,254706,"JACK LONG","SUSAN W SWEETSER","Republican",0.325948348291756,-59191,106851,-0.553958315785533
1996,"VIRGINIA",2,106215,57586,163996,"OWEN B PICKETT","JOHN F TATE","Democrat",0.647668235810629,48629,163801,0.296878529435107
1996,"VIRGINIA",3,118603,25781,144418,"ROBERT C SCOTT","ELSIE GOODWYN HOLLAND","Democrat",0.821248043872647,92822,144384,0.642882867907801
1996,"VIRGINIA",4,160100,43516,203666,"NORMAN SISISKY","ANTHONY J ""TONY"" ZEVGOLIS","Democrat",0.786090952834543,116584,203616,0.572567971082823
1996,"VIRGINIA",5,120323,70869,197923,"VIRGIL H GOODE JR","GEORGE C LANDRITH III","Democrat",0.60792833576694,49454,191192,0.258661450269886
1996,"VIRGINIA",6,61485,133576,199361,"JEFFREY W GREY","BOB GOODLATTE","Republican",0.670020716188221,-72091,195061,-0.369581823121998
1996,"VIRGINIA",7,51206,189644,252505,"RODERIC H SLAYTON","TOM BLILEY","Republican",0.751050474248035,-138438,240850,-0.574789287938551
1996,"VIRGINIA",8,152334,64562,229421,"JAMES P MORAN","JOHN E OTEY","Democrat",0.663993270014515,87772,216896,0.404673207435822
1996,"VIRGINIA",9,122908,58055,189077,"RICK BOUCHER","PATRICK C MULDOON","Democrat",0.650042046362064,64853,180963,0.358377126815979
1996,"VIRGINIA",10,59145,169266,235013,"ROBERT L ""BOB"" WEINBERG","FRANK R WOLF","Republican",0.720241007944241,-110121,228411,-0.482117761403785
1996,"VIRGINIA",11,74701,138758,216482,"THOMAS J ""TOM"" HORTON","THOMAS M DAVIS","Republican",0.640967840282333,-64057,213459,-0.300090415489626
1996,"WASHINGTON",1,122187,141948,264135,"JEFF COOPERSMITH","RICK WHITE","Republican",0.537407007780112,-19761,264135,-0.0748140155602249
1996,"WASHINGTON",2,122728,124655,256944,"KEVIN QUIGLEY","JACK METCALF","Republican",0.485144622952861,-1927,247383,-0.0077895409142908
1996,"WASHINGTON",3,122230,123117,245347,"BRIAN BAIRD","LINDA SMITH","Republican",0.501807643867665,-887,245347,-0.00361528773532996
1996,"WASHINGTON",4,96502,108647,205149,"RICK LOCKE","DOC HASTINGS","Republican",0.529600436755724,-12145,205149,-0.0592008735114478
1996,"WASHINGTON",5,105166,131618,236784,"JUDY OLSON","GEORGE R NETHERCUTT JR","Republican",0.555856814649639,-26452,236784,-0.111713629299277
1996,"WASHINGTON",6,155467,71337,235910,"NORMAN D DICKS","BILL TINSLEY","Democrat",0.659009791869781,84130,226804,0.370937020511102
1996,"WASHINGTON",7,209753,49341,259094,"JIM MCDERMOTT","FRANK KLESCHEN","Democrat",0.809563324507708,160412,259094,0.619126649015415
1996,"WASHINGTON",8,90340,170691,261031,"DAVE LITTLE","JENNIFER DUNN","Republican",0.653910838176309,-80351,261031,-0.307821676352617
1996,"WASHINGTON",9,105236,99199,209867,"ADAM SMITH","RANDY TATE","Democrat",0.501441389070221,6037,204435,0.0295301685132194
1996,"WEST VIRGINIA",2,141551,63933,205484,"ROBERT E WISE JR","GREG MORRIS","Democrat",0.688866286426194,77618,205484,0.377732572852388
1996,"WISCONSIN",1,114148,118408,232801,"LYDIA C SPOTTSWOOD","MARK W NEUMANN","Republican",0.508623244745512,-4260,232556,-0.0183181685271505
1996,"WISCONSIN",2,110467,154557,269374,"PAUL R SOGLIN","SCOTT L KLUG","Republican",0.57376361489973,-44090,265024,-0.166362291716977
1996,"WISCONSIN",3,121967,112146,234650,"RON KIND","JAMES E HARSDORF","Democrat",0.519782655018112,9821,234113,0.0419498276473327
1996,"WISCONSIN",4,134470,98438,233284,"GERLAD D KLECZKA","TOM REYNOLDS","Democrat",0.576421872052948,36032,232908,0.154704862005599
1996,"WISCONSIN",5,141179,47384,192569,"THOMAS M BARRETT","PAUL D MELOTIK","Democrat",0.733134616682851,93795,188563,0.497419960437626
1996,"WISCONSIN",6,55377,169213,231719,"AL LINDSKOOG","THOMAS E PETRI","Republican",0.730250864193269,-113836,224590,-0.506861391869629
1996,"WISCONSIN",7,137428,103365,240898,"DAVID R OBEY","SCOTT WEST","Democrat",0.570482112761418,34063,240793,0.141461753456288
1996,"WISCONSIN",8,129551,119398,249157,"JAY W JOHNSON","DAVID PROSSER","Democrat",0.519957296002119,10153,248949,0.0407834536390988
1996,"WISCONSIN",9,67740,197910,265875,"FLOYD BRENHOLT","F JAMES SENSENBRENNER","Republican",0.744372355430183,-130170,265650,-0.490005646527386
1996,"WYOMING",0,85724,116004,209983,"PETE MAXFIELD","BARBARA CUBIN","Republican",0.552444721715567,-30280,201728,-0.150103109137056
1998,"ALABAMA",2,58136,131428,189669,"JOE FONDREN","TERRY EVERETT","Republican",0.692933478849997,-73292,189564,-0.386634593066194
1998,"ALABAMA",3,73357,101731,175217,"JOE TURNHAM","BOB RILEY","Republican",0.580600055930646,-28374,175088,-0.162055652014987
1998,"ALABAMA",4,82065,106297,188476,"DON BEVILL","ROBERT B ADERHOLT","Republican",0.563981621002144,-24232,188362,-0.128645905225045
1998,"ALABAMA",5,134819,58536,193490,"ROBERT E ""BUD"" CRAMER JR","GIL AUST","Democrat",0.696775027133185,76283,193355,0.394523027591735
1998,"ALABAMA",6,60657,154761,215582,"DONNA WESSON SMALLEY","SPENCER BACHUS","Republican",0.717875332819994,-94104,215418,-0.43684371779517
1998,"ALASKA",0,77232,139676,223300,"JIM DUNCAN","DON YOUNG","Republican",0.62550828481863,-62444,216908,-0.287882420196581
1998,"ARIZONA",1,54108,98840,152948,"DAVID MENDOZA","MATT SALMON","Republican",0.646232706540785,-44732,152948,-0.29246541308157
1998,"ARIZONA",2,57178,23628,84363,"ED PASTOR","ED BARRON","Democrat",0.677761577942937,33550,80806,0.415191941192486
1998,"ARIZONA",3,66979,137618,204623,"STUART MARC STARKY","BOB STUMP","Republican",0.672544142154108,-70639,204597,-0.345259216899564
1998,"ARIZONA",4,49538,102722,158822,"ERIC EHST","JOHN B SHADEGG","Republican",0.646774376345846,-53184,152260,-0.349297254695915
1998,"ARIZONA",5,91030,103952,201473,"TOM VOLGY","JIM KOLBE","Republican",0.515959954931926,-12922,194982,-0.0662727841544348
1998,"ARIZONA",6,88001,106891,201537,"STEVE OWENS","J D HAYWORTH","Republican",0.530379037099887,-18890,194892,-0.0969254766742606
1998,"ARKANSAS",2,100334,72737,173071,"VIC SNYDER","PHIL WYRICK","Democrat",0.579727395115299,27597,173071,0.159454790230599
1998,"ARKANSAS",4,68194,92346,160540,"JUDY SMITH","JAY DICKEY","Republican",0.575221128690669,-24152,160540,-0.150442257381338
1998,"CALIFORNIA",1,121713,64692,196805,"MIKE THOMPSON","MARK C LUCE","Democrat",0.61844465333706,57021,186405,0.305898446930072
1998,"CALIFORNIA",2,70837,128372,205347,"ROBERTS ""ROB"" BRADEN","WALLY HERGER","Republican",0.625146702898021,-57535,199209,-0.288817272311994
1998,"CALIFORNIA",3,86471,100621,192006,"SANDIE DUNN","DOUG OSE","Republican",0.524051331729217,-14150,187092,-0.0756312402454407
1998,"CALIFORNIA",4,85394,155306,248224,"DAVID SHAPIRO","JOHN T DOOLITTLE","Republican",0.625668750805724,-69912,240700,-0.290452845866223
1998,"CALIFORNIA",5,130715,47307,181768,"ROBERT T MATSUI","ROBERT S DINSMORE","Democrat",0.719130980150522,83408,178022,0.468526361910326
1998,"CALIFORNIA",6,158446,69295,232981,"LYNN C WOOLSEY","KEN MCAULIFFE","Democrat",0.680081208338877,89151,227741,0.391457840265916
1998,"CALIFORNIA",7,125842,38290,164132,"GEORGE MILLER","NORMAN H REECE","Democrat",0.766712158506568,87552,164132,0.533424317013136
1998,"CALIFORNIA",8,148027,20781,172462,"NANCY PELOSI","DAVID J MARTZ","Democrat",0.858316614674537,127246,168808,0.753791289512345
1998,"CALIFORNIA",9,140722,22431,169895,"BARBARA LEE","CLAIBORNE ""CLAY"" SANDERS","Democrat",0.828288060272521,118291,163153,0.725031105771883
1998,"CALIFORNIA",10,127134,103299,237809,"ELLEN O TAUSCHER","CHARLES BALL","Democrat",0.534605502735389,23835,230433,0.103435705823385
1998,"CALIFORNIA",11,56345,95496,155449,"ROBERT L FIGUEROA","RICHARD W POMBO","Republican",0.614323668856024,-39151,151841,-0.257842084812402
1998,"CALIFORNIA",12,128135,36562,173212,"TOM LANTOS","ROBERT H EVANS","Democrat",0.739758215366141,91573,164697,0.556008913337826
1998,"CALIFORNIA",13,101671,38050,142787,"FORTNEY PETE STARK","JAMES R GOETZ","Democrat",0.71204661488791,63621,139721,0.455343148130918
1998,"CALIFORNIA",14,129663,53719,188910,"ANNA G ESHOO","JOHN C ""CHRIS"" HAUGEN","Democrat",0.686374464030491,75944,183382,0.414130067291228
1998,"CALIFORNIA",15,70059,111876,184778,"DICK LANE","TOM CAMPBELL","Republican",0.60546168916213,-41817,181935,-0.229845824058043
1998,"CALIFORNIA",16,85503,27494,117414,"ZOE LOFGREN","HORACE EUGENE THAYN","Democrat",0.728218100056211,58009,112997,0.51336761152951
1998,"CALIFORNIA",17,103719,52470,160690,"SAM FARR","BILL MCCAMPBELL","Democrat",0.645460202875101,51249,156189,0.328121698711177
1998,"CALIFORNIA",20,60599,39183,99782,"CALVIN M DOOLEY","CLIFF UNRUH","Democrat",0.607313944398789,21416,99782,0.214627888797579
1998,"CALIFORNIA",22,109517,85927,199264,"LOIS CAPPS","TOM J BORDONARO JR","Democrat",0.549607555805364,23590,195444,0.120699535416795
1998,"CALIFORNIA",23,64032,96322,160354,"DANIEL ""DAN"" GONZALEZ","ELTON GALLEGLY","Republican",0.60068348778328,-32290,160354,-0.201366975566559
1998,"CALIFORNIA",24,103491,69501,180580,"BRAD SHERMAN","RANDY HOFFMAN","Democrat",0.573103333702514,33990,172992,0.19648307436182
1998,"CALIFORNIA",27,73875,80702,159066,"BARRY A GORDON","JAMES E ROGAN","Republican",0.507349150667019,-6827,154577,-0.0441656908854487
1998,"CALIFORNIA",28,61721,90607,157200,"JANICE M NELSON","DAVID DREIER","Republican",0.576380407124682,-28886,152328,-0.189630271519353
1998,"CALIFORNIA",29,131561,40282,178094,"HENRY A WAXMAN","MIKE GOTTLIEB","Democrat",0.738716632789426,91279,171843,0.531176713628137
1998,"CALIFORNIA",30,58230,12441,70671,"XAVIER BECERRA","PATRICIA PARKER","Democrat",0.823958908180159,45789,70671,0.647917816360318
1998,"CALIFORNIA",31,61173,19786,87360,"MATTHEW G MARTINEZ","FRANK C MORENO","Democrat",0.700240384615385,41387,80959,0.511209377586186
1998,"CALIFORNIA",32,112253,14622,129492,"JULIAN C DIXON","LAURENCE ARDITO","Democrat",0.866872084761993,97631,126875,0.769505418719212
1998,"CALIFORNIA",33,43310,6364,49674,"LUCILLE ROYBAL-ALLARD","WAYNE MILLER","Democrat",0.871884688166848,36946,49674,0.743769376333696
1998,"CALIFORNIA",34,76471,32321,113075,"GRACE FLORES NAPOLITANO","ED PEREZ","Democrat",0.676285651116516,44150,108792,0.405820280903008
1998,"CALIFORNIA",36,84624,88843,181706,"JANICE HAHN","STEVEN T KUYKENDALL","Republican",0.488938174853885,-4219,173467,-0.0243216288977154
1998,"CALIFORNIA",37,70026,12301,82327,"JUANITA MILLENDER-MCDONALD","SAUL E LANKSTER","Democrat",0.850583648134877,57725,82327,0.701167296269753
1998,"CALIFORNIA",38,59767,71386,134858,"PETER MATHEWS","STEPHEN HORN","Republican",0.529341974521348,-11619,131153,-0.0885911873918248
1998,"CALIFORNIA",39,52815,97366,155465,"A ""CECY"" R GROOM","EDWARD R ROYCE","Republican",0.626288875309555,-44551,150181,-0.296648710555929
1998,"CALIFORNIA",40,47897,97406,150125,"ROBERT ""BOB"" CONAWAY","JERRY LEWIS","Republican",0.648832639467111,-49509,145303,-0.340729372414885
1998,"CALIFORNIA",41,52264,68310,128414,"EILEEN R ANSARI","GARY G MILLER","Republican",0.531951344868939,-16046,120574,-0.133080100187437
1998,"CALIFORNIA",42,62207,45328,112520,"GEORGE E BROWN JR","ELIA PIROZZI","Democrat",0.552852826164237,16879,107535,0.156962849304877
1998,"CALIFORNIA",43,56373,83012,149071,"MIKE RAYBURN","KEN CALVERT","Republican",0.556862166350263,-26639,139385,-0.191118126053736
1998,"CALIFORNIA",44,57697,97013,161528,"RALPH WAITE","MARY BONO","Republican",0.600595562379278,-39316,154710,-0.254127076465645
1998,"CALIFORNIA",45,60022,94296,160770,"PATRICIA W NEAL","DANA ROHRABACHER","Republican",0.586527337189774,-34274,154318,-0.222099819852512
1998,"CALIFORNIA",46,47964,33388,85002,"LORETTA SANCHEZ","ROBERT KENNETH ""BOB"" DORNAN","Democrat",0.564269076021741,14576,81352,0.17917199331301
1998,"CALIFORNIA",47,57938,132711,196316,"CHRISTINA AVALOS","CHRISTOPHER COX","Republican",0.676007049858392,-74773,190649,-0.392202424350508
1998,"CALIFORNIA",49,86400,90516,185519,"CHRISTINE T KEHOE","BRIAN P BILBRAY","Republican",0.48790689902382,-4116,176916,-0.0232652784372244
1998,"CALIFORNIA",51,71706,126229,206878,"DAN KRIPKE","RANDY ""DUKE"" CUNNINGHAM","Republican",0.610161544485155,-54523,197935,-0.275459115366156
1998,"COLORADO",1,116628,52452,174305,"DIANA DEGETTE","NANCY MCCLANAHAN","Democrat",0.669103009093256,64176,169080,0.379559971611072
1998,"COLORADO",2,113946,108385,228442,"MARK UDALL","BOB GREENLEE","Democrat",0.498796193344481,5561,222331,0.025012256500443
1998,"COLORADO",3,74479,156501,236653,"ROBERT REED KELLEY","SCOTT MCINNIS","Republican",0.661310019310974,-82022,230980,-0.355104338037925
1998,"COLORADO",4,89973,131318,221291,"SUSAN KIRKPATRICK","BOB SCHAFFER","Republican",0.593417716942849,-41345,221291,-0.186835433885698
1998,"COLORADO",5,55609,155790,214270,"KEN ALFORD","JOEL HEFLEY","Republican",0.727073318710039,-100181,211399,-0.473895335361094
1998,"COLORADO",6,82662,111374,199188,"HENRY L STRAUSS","TOM TANCREDO","Republican",0.559140108841898,-28712,194036,-0.147972541177926
1998,"CONNECTICUT",1,97681,69668,168264,"JOHN B LARSON","KEVIN O'CONNOR","Democrat",0.580522274520991,28013,167349,0.167392694309497
1998,"CONNECTICUT",2,99567,57860,163201,"SAM GEJDENSON","GARY M KOVAL","Democrat",0.610088173479329,41707,157427,0.264929141760943
1998,"CONNECTICUT",3,109726,42090,153851,"ROSA L DELAURO","MARTIN T REUST","Democrat",0.713196534309169,67636,151816,0.445512989408231
1998,"CONNECTICUT",4,40988,94767,137204,"JONATHAN KANTROWITZ","CHRISTOPHER SHAYS","Republican",0.690701437275881,-53779,135755,-0.396147471548009
1998,"CONNECTICUT",5,78394,76051,157157,"JAMES H MALONEY","MARK NIELSEN","Democrat",0.498826014749582,2343,154445,0.0151704490271618
1998,"CONNECTICUT",6,69201,101630,174781,"CHARLOTTE KOSKOFF","NANCY L JOHNSON","Republican",0.581470525972503,-32429,170831,-0.189830885495021
1998,"DELAWARE",0,57446,119811,180529,"DENNIS E WILLIAMS","MICHAEL N CASTLE","Republican",0.663666225370993,-62365,177257,-0.351833778073644
1998,"FLORIDA",3,66621,53530,120151,"CORRINE BROWN","BILL RANDALL","Democrat",0.554477282752536,13091,120151,0.108954565505073
1998,"FLORIDA",8,54245,104298,158575,"AL KRULICK","BILL MCCOLLUM","Republican",0.657720321614378,-50053,158543,-0.315706149120428
1998,"FLORIDA",11,85262,46176,131438,"JIM DAVIS","JOE CHILLURA","Democrat",0.648686072520884,39086,131438,0.297372145041769
1998,"FLORIDA",15,75654,129278,204932,"DAVID R GOLDING","DAVE WELDON","Republican",0.630833642378935,-53624,204932,-0.261667284757871
1998,"FLORIDA",21,28378,84018,112396,"PATRICK CUSACK","LINCOLN DIAZ-BALART","Republican",0.747517705256415,-55640,112396,-0.49503541051283
1998,"GEORGIA",2,77953,59305,137258,"SANFORD D BISHOP JR","JOSEPH FRANCIS MCCORMICK JR","Democrat",0.567930466712323,18648,137258,0.135860933424646
1998,"GEORGIA",4,100622,64146,164772,"CYNTHIA A MCKINNEY","SUNNY J WARREN","Democrat",0.610674143665186,36476,164768,0.221377937463585
1998,"GEORGIA",5,109177,29877,139054,"JOHN LEWIS","JOHN H LEWIS SR","Democrat",0.785141024350252,79300,139054,0.570282048700505
1998,"GEORGIA",6,68366,164966,233332,"GARY ""BATS"" PELPHREY","NEWT GINGRICH","Republican",0.707001182863902,-96600,233332,-0.414002365727804
1998,"GEORGIA",7,69293,85982,155275,"JAMES F ""JIM"" WILLIAMS","BOB BARR","Republican",0.553740138464015,-16689,155275,-0.107480276928031
1998,"GEORGIA",8,53079,87993,141072,"RONALD L CAIN","SAXBY CHAMBLISS","Republican",0.623745321537938,-34914,141072,-0.247490643075876
1998,"GEORGIA",10,60004,88527,148531,"MARION DENISE SPENCER FREEMAN","CHARLIE NORWOOD","Republican",0.596016993085619,-28523,148531,-0.192033986171237
1998,"GEORGIA",11,53510,120909,174419,"VINCENT LITTMAN","JOHN LINDER","Republican",0.693210028723935,-67399,174419,-0.38642005744787
1998,"HAWAII",1,116693,68905,189571,"NEIL ABERCROMBIE","GENE WARD","Democrat",0.615563561937216,47788,185598,0.257481222858005
1998,"HAWAII",2,144254,50423,207871,"PATSY T MINK","CAROL J DOUGLASS","Democrat",0.693959234332831,93831,194677,0.481982976931019
1998,"IDAHO",1,91653,113231,204884,"DAN WILLIAMS","HELEN CHENOWETH","Republican",0.552659065617618,-21578,204884,-0.105318131235236
1998,"IDAHO",2,77736,91337,173945,"RICHARD H STALLINGS","MIKE SIMPSON","Republican",0.525091264480152,-13601,169073,-0.0804445417068367
1998,"ILLINOIS",1,151890,18429,174365,"BOBBY L RUSH","MARLENE WHITE AHIMAZ","Democrat",0.871103719209704,133461,170319,0.783594314198651
1998,"ILLINOIS",2,148985,16075,166668,"JESSE L JACKSON JR","ROBERT GORDON III","Democrat",0.89390284877721,132910,165060,0.805222343390282
1998,"ILLINOIS",3,115887,44012,159899,"WILLIAM O LIPINKSI","ROBERT MARSHALL","Democrat",0.724751249226074,71875,159899,0.449502498452148
1998,"ILLINOIS",4,54244,10529,66356,"LUIS V GUTIERREZ","JOHN BIRCH","Democrat",0.817469407438664,43715,64773,0.674895403949176
1998,"ILLINOIS",5,95738,33687,129425,"ROD R BLAGOJEVICH","ALAN SPITZ","Democrat",0.739717983388063,62051,129425,0.479435966776125
1998,"ILLINOIS",6,49906,111603,165708,"THOMAS A CRAMER","HENRY J HYDE","Republican",0.673491925555797,-61697,161509,-0.382003479682247
1998,"ILLINOIS",8,47614,104242,151856,"MIKE ROTHMAN","PHILIP M CRANE","Republican",0.686452955431461,-56628,151856,-0.372905910862923
1998,"ILLINOIS",9,107878,33448,144610,"JANICE D ""JAN"" SCHAKOWSKY","HERBERT SOHN","Democrat",0.745992669939838,74430,141326,0.526654684912896
1998,"ILLINOIS",11,70458,100597,171055,"GARY S MUELLER","JERRY WELLER","Republican",0.588097395574523,-30139,171055,-0.176194791149046
1998,"ILLINOIS",12,99605,65409,165014,"JERRY F COSTELLO","WILLIAM MELVIN PRICE","Democrat",0.603615450810234,34196,165014,0.207230901620469
1998,"ILLINOIS",13,77878,121889,199767,"SUSAN W HYNES","JUDY BIGGERT","Republican",0.610155831543748,-44011,199767,-0.220311663087497
1998,"ILLINOIS",14,50844,117304,168148,"ROBERT A COZZI JR","J DENNIS HASTERT","Republican",0.697623522135262,-66460,168148,-0.395247044270524
1998,"ILLINOIS",15,65054,104255,169309,"LAUREL LUNT PRUSSING","THOMAS W EWING","Republican",0.61576762015014,-39201,169309,-0.231535240300279
1998,"ILLINOIS",17,100128,94072,194200,"LANE EVANS","MARK BAKER","Democrat",0.515592173017508,6056,194200,0.0311843460350154
1998,"ILLINOIS",19,122430,87614,210044,"DAVID D PHELPS","BRENT WINTERS","Democrat",0.582877873207518,34816,210044,0.165755746415037
1998,"ILLINOIS",20,76475,121103,197578,"RICK VERTICCHIO","JOHN SHIMKUS","Republican",0.612937675247244,-44628,197578,-0.225875350494488
1998,"INDIANA",1,92634,33503,127754,"PETER J VISCLOSKY","MICHAEL PETYO","Democrat",0.725096670162969,59131,126137,0.468783941270206
1998,"INDIANA",2,62452,99608,164296,"SHERMAN A BOLES","DAVID M MCINTOSH","Republican",0.606271607342845,-37156,162060,-0.229273108725164
1998,"INDIANA",4,54286,93671,147957,"MARK J WEHRLE","MARK E SOUDER","Republican",0.633096102245923,-39385,147957,-0.266192204491846
1998,"INDIANA",5,58504,101567,162388,"DAVID STEELE","STEPHEN E BUYER","Republican",0.625458777742198,-43063,160071,-0.269024370435619
1998,"INDIANA",6,31472,135250,187827,"BOB KERN","DAN BURTON","Republican",0.720077518141694,-103778,166722,-0.622461342834179
1998,"INDIANA",7,44823,109712,159314,"SAMUEL ""DUTCH"" HILLENBURG","EDWARD A PEASE","Republican",0.688652598013985,-64889,154535,-0.419898404892096
1998,"INDIANA",8,81871,92785,178057,"GAIL RIECKEN","JOHN N HOSTETTLER","Republican",0.521097176746772,-10914,174656,-0.062488548919018
1998,"INDIANA",9,92973,87797,183176,"BARON HILL","JEAN LEISING","Democrat",0.50756103419662,5176,180770,0.0286330696465121
1998,"INDIANA",10,69682,47017,119436,"JULIA CARSON","GARY A HOFMEISTER","Democrat",0.583425432867812,22665,116699,0.19421760255015
1998,"IOWA",1,79529,106419,188208,"BOB RUSH","JAMES A LEACH","Republican",0.565432925274165,-26890,185948,-0.144610321165057
1998,"IOWA",2,83405,104613,189574,"ROB TULLY","JIM NUSSLE","Republican",0.551832002278793,-21208,188018,-0.112797710857471
1998,"IOWA",3,107947,78063,189752,"LEONARD L BOSWELL","LARRY MCKIBBEN","Democrat",0.56888464943716,29884,186010,0.160658029138218
1998,"IOWA",4,67550,129942,199396,"JON DVORAK","GREG GANSKE","Republican",0.651678067764649,-62392,197492,-0.31592165758613
1998,"KANSAS",1,36618,152775,189393,"JIM PHILIPS","JERRY MORAN","Republican",0.806656001013765,-116157,189393,-0.61331200202753
1998,"KANSAS",2,69521,108527,178048,"JIM CLARK","JIM RYAN","Republican",0.609537877426312,-39006,178048,-0.219075754852624
1998,"KANSAS",3,103376,93938,197314,"DENNIS MOORE","VINCE SNOWBARGER","Democrat",0.523916194492028,9438,197314,0.0478323889840559
1998,"KANSAS",4,62737,94785,162693,"JIM LAWING","TODD TIAHRT","Republican",0.582600357728974,-32048,157522,-0.203450946534452
1998,"KENTUCKY",1,77402,95308,172710,"TOM BARLOW","ED WHITFIELD","Republican",0.55183834172891,-17906,172710,-0.103676683457819
1998,"KENTUCKY",2,62848,113285,177966,"BOB EVANS","RON LEWIS","Republican",0.636554173269051,-50437,176133,-0.286357468503915
1998,"KENTUCKY",3,92865,100690,195436,"CHRIS GORMAN","ANNE M NORTHUP","Republican",0.515207024294398,-7825,193555,-0.0404277853839994
1998,"KENTUCKY",4,93485,81547,175032,"KEN LUCAS","GEX ""JAY"" WILLIAMS","Democrat",0.534102335572924,11938,175032,0.0682046711458476
1998,"KENTUCKY",5,39585,142215,181800,"SIDNEY JANE BAILEY-BAMER","HAROLD ROGERS","Republican",0.782260726072607,-102630,181800,-0.564521452145215
1998,"KENTUCKY",6,90033,104046,195918,"ERNESTO SCORSONE","ERNIE FLETCHER","Republican",0.531069120754601,-14013,194079,-0.0722025566908321
1998,"LOUISIANA",6,94201,97044,191245,"MARJORIE MCCKEITHEN","RICHARD H BAKER","Republican",0.507432874062067,-2843,191245,-0.014865748124134
1998,"MAINE",1,134335,79160,222677,"THOMAS H ALLEN","ROSS J CONNELLY","Democrat",0.603272902006045,55175,213495,0.258436965736903
1998,"MAINE",2,146202,45674,191876,"JOHN ELIAS BALDACCI","JONATHAN REISMAN","Democrat",0.761960849715441,100528,191876,0.523921699430882
1998,"MARYLAND",1,60450,135771,196221,"IRVING PINDER","WAYNE T GILCHREST","Republican",0.691928998425245,-75321,196221,-0.38385799685049
1998,"MARYLAND",2,74275,125162,199446,"KENNETH T BOSLEY","ROBERT L EHRLICH JR","Republican",0.627548308815419,-50887,199437,-0.255153256416813
1998,"MARYLAND",3,137501,39667,177168,"BENJAMIN L CARDIN","COLIN FELIX HARBY","Democrat",0.776105165718414,97834,177168,0.552210331436828
1998,"MARYLAND",4,129139,21518,150657,"ALBERT RUSSELL WYNN","JOHN B KIMBLE","Democrat",0.857172252202022,107621,150657,0.714344504404044
1998,"MARYLAND",5,126792,67176,193968,"STENY H HOYER","ROBERT B OSTROM","Democrat",0.653674832962138,59616,193968,0.307349665924276
1998,"MARYLAND",6,73728,127802,201530,"TIMOTHY D MCCOWN","ROSCOE G BARTLETT","Republican",0.634158686051704,-54074,201530,-0.268317372103409
1998,"MARYLAND",7,112699,18742,131442,"ELIJAH E CUMMINGS","KENNETH KONDNER","Democrat",0.857404786902208,93957,131441,0.714822620034845
1998,"MARYLAND",8,87497,133145,220642,"RALPH G NEAS","CONSTANCE A MORELLA","Republican",0.603443587349643,-45648,220642,-0.206887174699287
1998,"MASSACHUSETTS",1,121863,48055,169976,"JOHN W OLVER","GREGORY L MORGAN","Democrat",0.716942391867087,73808,169918,0.434374227568592
1998,"MASSACHUSETTS",3,108613,79174,190878,"JAMES P MCGOVERN","MATTHEW J AMORELLO","Democrat",0.569017906725762,29439,187787,0.156768040386182
1998,"MASSACHUSETTS",5,127418,52725,180230,"MARTIN T MEEHAN","DAVID E COLEMAN","Democrat",0.706974421572435,74693,180143,0.414631709253204
1998,"MASSACHUSETTS",6,117132,90986,214706,"JOHN F TIERNEY","PETER G TORKILDSEN","Democrat",0.545546002440547,26146,208118,0.125630651841744
1998,"MASSACHUSETTS",7,137178,56977,194305,"EDWARD J MARKEY","PATRICIA H LONG","Democrat",0.705993155091223,80201,194155,0.413077180603126
1998,"MASSACHUSETTS",8,99603,14125,121887,"MICHAEL E CAPUANO","PHILIP HYDE III","Democrat",0.817174924315144,85478,113728,0.751600309510411
1998,"MASSACHUSETTS",10,164917,70466,235563,"WILLIAM D DELAHUNT","ERIC V BLEICKEN","Democrat",0.700097213908806,94451,235383,0.401265172081246
1998,"MICHIGAN",1,130129,87630,221796,"BART STUPAK","MICHELLE A MCMANUS","Democrat",0.586705801727714,42499,217759,0.195165297415951
1998,"MICHIGAN",2,63573,146854,213622,"BOB SHRAUGER","PETER HOEKSTRA","Republican",0.687447922030502,-83281,210427,-0.395771455183983
1998,"MICHIGAN",3,49489,146364,200251,"JOHN FERGUSON JR","VERNON J EHLERS","Republican",0.730902717090052,-96875,195853,-0.494631177464731
1998,"MICHIGAN",5,135254,51442,189971,"JAMES A BARCIA","DONALD W BREWSTER","Democrat",0.711971827278901,83812,186696,0.448922312208082
1998,"MICHIGAN",6,45358,113292,161627,"CLARENCE J ANNEN","FRED UPTON","Republican",0.700947242725535,-67934,158650,-0.428200441222818
1998,"MICHIGAN",7,72998,104656,182127,"JIM BERRYMAN","NICK SMITH","Republican",0.574631987569114,-31658,177654,-0.178200321974175
1998,"MICHIGAN",8,125169,84254,218040,"DEBBIE STABENOW","SUSAN GRIMES MUNSELL","Democrat",0.574064391854706,40915,209423,0.195370136040454
1998,"MICHIGAN",9,105457,79062,188525,"DALE E KILDEE","TOM MCMILLIN","Democrat",0.559379392653494,26395,184519,0.143047599434205
1998,"MICHIGAN",10,108770,94027,207524,"DAVID E BONIOR","BRIAN PALMER","Democrat",0.524132148570768,14743,202797,0.0726983140776244
1998,"MICHIGAN",11,76107,144264,225804,"TRAVIS M REEDS","JOE KNOLLENBERG","Republican",0.638890365095392,-68157,220371,-0.309282981880556
1998,"MICHIGAN",12,105824,79619,189428,"SANDER M LEVIN","LESLIE A TOUMA","Democrat",0.558650252338619,26205,185443,0.141310267845106
1998,"MICHIGAN",13,99935,68328,171887,"LYNN N RIVERS","TOM HICKEY","Democrat",0.581399407750441,31607,168263,0.187842841266351
1998,"MICHIGAN",14,126321,16140,145305,"JOHN CONYERS JR","VENDELLA M COLLINS","Democrat",0.869350676163931,110181,142461,0.77341167056247
1998,"MICHIGAN",15,108582,12887,124860,"CAROLYN C KILPATRICK","CRYSANTHEA D BOYD-FIELDS","Democrat",0.869629985583854,95695,121469,0.787814174810034
1998,"MICHIGAN",16,116145,54121,174357,"JOHN D DINGELL","WILLIAM MORSE","Democrat",0.666133278273886,62024,170266,0.364277072345624
1998,"MISSISSIPPI",1,30438,66738,99333,"REX WEATHERS","ROGER F WICKER","Republican",0.671861314970856,-36300,97176,-0.373549024450482
1998,"MISSISSIPPI",4,73252,61551,137199,"RONNIE SHOWS","DELBERT HOSEMANN","Democrat",0.533910597016013,11701,134803,0.0868007388559602
1998,"MISSISSIPPI",5,78661,19341,101095,"GENE TAYLOR","RANDY MCDONNELL","Democrat",0.778089915426084,59320,98002,0.605293769514908
1998,"MISSOURI",1,90840,30635,125051,"WILLIAM ""BILL"" CLAY","RICHMOND A SOLUADE SR","Democrat",0.726423619163381,60205,121475,0.495616381971599
1998,"MISSOURI",2,57565,142313,203259,"JOHN ROSS","JAMES M TALENT","Republican",0.700155958653737,-84748,199878,-0.423998639169894
1998,"MISSOURI",3,98287,74005,176099,"RICHARD A GEPHARDT","WILLIAM J FEDERER","Democrat",0.558134912747943,24282,172292,0.140935156594618
1998,"MISSOURI",4,133173,51005,187616,"IKE SKELTON","CECILIA D NOLAND","Democrat",0.709816859969299,82168,184178,0.446133631595522
1998,"MISSOURI",5,101313,47582,153685,"KAREN MCCARTHY","PENNY D BENNETT","Democrat",0.659225038227543,53731,148895,0.360865039121529
1998,"MISSOURI",6,136774,51679,192777,"PAT DANNER","JEFF BAILEY","Democrat",0.709493352422748,85095,188453,0.451544947546603
1998,"MISSOURI",7,43416,129746,178801,"MARC PERKEL","ROY BLUNT","Republican",0.725644711159334,-86330,173162,-0.498550490292327
1998,"MISSOURI",8,59426,104271,166524,"ANTHONY J ""TONY"" HECKEMEYER","JO ANNA EMERSON","Republican",0.626161994667435,-44845,163697,-0.273951263615094
1998,"MISSOURI",9,66861,117196,188305,"LINDA VOGT","KENNY C HULSHOF","Republican",0.622373277395714,-50335,184057,-0.273475064789712
1998,"MONTANA",0,147073,175748,331551,"DUSTY DESCHAMPS","RICK HILL","Republican",0.530078328824223,-28675,322821,-0.0888263155123118
1998,"NEBRASKA",1,48826,136058,185227,"DON ERET","DOUG BEREUTER","Republican",0.734547339210806,-87232,184884,-0.471820168321758
1998,"NEBRASKA",2,55722,106782,163003,"MICHAEL SCOTT","LEE TERRY","Republican",0.65509223756618,-51060,162504,-0.314207650273224
1998,"NEVADA",1,79315,73540,161082,"SHELLEY BERKLEY","DON CHAIREZ","Democrat",0.492388969593127,5775,152855,0.0377809034706094
1998,"NEW HAMPSHIRE",1,51783,104430,156213,"PETER FLOOD","JOHN E SUNUNU","Republican",0.668510303239807,-52647,156213,-0.337020606479614
1998,"NEW HAMPSHIRE",2,72217,85740,161295,"MARY RAUH","CHARLES F BASS","Republican",0.531572584395053,-13523,157957,-0.0856119070379913
1998,"NEW JERSEY",1,90279,27855,123342,"ROBERT E ANDREWS","RONALD L RICHARDS","Democrat",0.73194045823807,62424,118134,0.528416882523236
1998,"NEW JERSEY",2,43563,93248,141514,"DEREK HUNSBERGER","FRANK A LOBIONDO","Republican",0.658931271817629,-49685,136811,-0.363165242560905
1998,"NEW JERSEY",3,55248,97508,157239,"STEVEN J POLANSKY","JIM SAXTON","Republican",0.620126050152952,-42260,152756,-0.276650344339993
1998,"NEW JERSEY",4,52281,92991,149577,"LARRY SCHNEIDER","CHRISTOPHER H SMITH","Republican",0.621693174752803,-40710,145272,-0.28023294234264
1998,"NEW JERSEY",5,55487,106304,166818,"MIKE SCHEIDER","MARGE ROUKEMA","Republican",0.637245381193876,-50817,161791,-0.314090400578524
1998,"NEW JERSEY",6,78102,55180,137012,"FRANK PALLONE JR","MICHAEL FERGUSON","Democrat",0.570037660934809,22922,133282,0.171981212766915
1998,"NEW JERSEY",7,65776,77751,148042,"MARYANNE S CONNELLY","BOB FRANKS","Republican",0.525195552613448,-11975,143527,-0.0834337790102211
1998,"NEW JERSEY",8,81068,46289,130588,"BILL PASCRELL JR","MATTHEW J KIRNAN","Democrat",0.620792109535332,34779,127357,0.273082751635167
1998,"NEW JERSEY",9,91330,47817,141459,"STEVEN R ROTHMAN","STEVE LONEGAN","Democrat",0.645628768759853,43513,139147,0.312712455173306
1998,"NEW JERSEY",10,82244,10678,98494,"DONALD M PAYNE","WILLIAM STANLEY WNUCK","Democrat",0.835015330883099,71566,92922,0.770172833128861
1998,"NEW JERSEY",11,44160,100910,148971,"JOHN P SCOLLO","RODNEY P FRELINGHUYSEN","Republican",0.677380161239436,-56750,145070,-0.391190459778038
1998,"NEW JERSEY",12,92528,87221,184610,"RUSH HOLT","MICHAEL PAPPAS","Democrat",0.501207951898597,5307,179749,0.029524503613372
1998,"NEW JERSEY",13,70308,14615,87823,"ROBERT MENENDEZ","THERESA DE LEON","Democrat",0.800564772326156,55693,84923,0.655805847650224
1998,"NEW MEXICO",1,75040,86784,179168,"PHILLIP J MALOOF","HEATHER WILSON","Republican",0.484372209323093,-11744,161824,-0.0725726715443939
1998,"NEW MEXICO",2,61796,85077,146873,"E SHIRLEY BACA","JOE SKEEN","Republican",0.57925554730958,-23281,146873,-0.158511094619161
1998,"NEW MEXICO",3,91248,74266,171649,"TOM UDALL","BILL REDMOND","Democrat",0.531596455557562,16982,165514,0.102601592614522
1998,"NEW YORK",1,54463,75643,175332,"WILLIAM G HOLST","MICHAEL P FORBES","Republican",0.4314272351881,-21180,130106,-0.162790340184158
1998,"NEW YORK",2,37949,71760,146722,"JOHN C BACE","RICK LAZIO","Republican",0.489088207630757,-33811,109709,-0.308188024683481
1998,"NEW YORK",3,63628,95709,203992,"KEVIN N LANGBERG","PETER T KING","Republican",0.469180163927997,-32081,159337,-0.201340554924468
1998,"NEW YORK",4,86692,64509,186604,"CAROLYN MCCARTHY","GREGORY R BECKER","Democrat",0.46457739383936,22183,151201,0.146711992645551
1998,"NEW YORK",5,92189,40861,173247,"GARY L ACKERMAN","DAVID C PINZON","Democrat",0.53212465439517,51328,133050,0.385779782036828
1998,"NEW YORK",7,50924,18896,102885,"JOSEPH CROWLEY","JAMES J DILLON","Democrat",0.494960392671429,32028,69820,0.458722429103409
1998,"NEW YORK",8,108408,18383,158177,"JERROLD NADLER","THEODORE HOWARD","Democrat",0.685358806906187,90025,126791,0.710026736913503
1998,"NEW YORK",9,67274,24486,135099,"ANTHONY WEINER","LOUIS TELANO","Democrat",0.497960754705808,42788,91760,0.466303400174368
1998,"NEW YORK",10,81368,5577,119747,"EDOLPHUS TOWNS","ERNESTINE M BROWN","Democrat",0.679499277643699,75791,86945,0.871712001840244
1998,"NEW YORK",11,73674,5718,106892,"MAJOR R OWENS","DAVID GREENE","Democrat",0.689237735284212,67956,79392,0.855955259975816
1998,"NEW YORK",12,53269,6405,81722,"NYDIA M VELAZQUEZ","ROSEMARIE MARKGRAF","Democrat",0.65183182007293,46864,59674,0.785333646144049
1998,"NEW YORK",13,39153,60550,137487,"EUGENE V PRISCO","VITO FOSSELLA","Republican",0.440405274680515,-21397,99703,-0.214607383930273
1998,"NEW YORK",14,104351,32458,164799,"CAROLYN B MALONEY","STEPHANIE E KUPFERMAN","Democrat",0.63320165777705,71893,136809,0.525499053424848
1998,"NEW YORK",15,88271,5633,118109,"CHARLES B RANGEL","DAVID E CUNNINGHAM","Democrat",0.747368955795071,82638,93904,0.880026409950588
1998,"NEW YORK",16,65957,2457,90267,"JOSE E SERRANO","THOMAS W BAYLEY JR","Democrat",0.730687848272348,63500,68414,0.928172596252229
1998,"NEW YORK",17,79257,7982,114683,"ELIOT L ENGEL","PETER FIUMEFREDDO","Democrat",0.691096326395368,71275,87239,0.817008448056489
1998,"NEW YORK",19,56378,88341,188022,"DICK COLLINS","SUE W KELLY","Republican",0.469843954430864,-31963,144719,-0.220862499049883
1998,"NEW YORK",20,61753,98546,190925,"PAUL J FEINER","BENJAMIN A GILMAN","Republican",0.5161503208066,-36793,160299,-0.229527320819219
1998,"NEW YORK",21,123638,50931,218753,"MICHAEL R MCNULTY","LAUREN AYERS","Democrat",0.565194534474956,72707,174569,0.4164943374826
1998,"NEW YORK",22,81296,87786,214475,"JEAN P BORDEWICH","JOHN E SWEENY","Republican",0.409306445972724,-6490,169082,-0.0383837427993518
1998,"NEW YORK",24,31011,101689,170023,"NEIL P TALLON","JOHN M MCHUGH","Republican",0.598089670221088,-70678,132700,-0.532614920874152
1998,"NEW YORK",25,50268,102219,189887,"YVONNE ROTHENBERG","JAMES T WALSH","Republican",0.538314892541354,-51951,152487,-0.340691337622224
1998,"NEW YORK",26,99249,47084,188835,"MAURICE D HINCHEY","WILLIAM H BUD WALKER","Democrat",0.525585828898244,52165,146333,0.356481449843849
1998,"NEW YORK",27,62714,86106,206152,"BILL COOK","THOMAS M REYNOLDS","Republican",0.41768209864566,-23392,148820,-0.157183174304529
1998,"NEW YORK",28,118856,50926,193136,"LOUISE MCINTOSH SLAUGHTER","RICHARD A KAPLAN","Democrat",0.615400546764974,67930,169782,0.400101306381124
1998,"NEW YORK",29,87805,58232,184070,"JOHN J LAFALCE","CHRIS COLLINS","Democrat",0.477019612104091,29573,146037,0.202503475146709
1998,"NEW YORK",30,55199,91350,188034,"CRYSTAL D PEOPLES","JACK QUINN","Republican",0.485816394907304,-36151,146549,-0.246681997147712
1998,"NEW YORK",31,40091,95638,176573,"CALEB ROSSITER","AMO HOUGHTON","Republican",0.541634338205728,-55547,135729,-0.409249312969225
1998,"NORTH CAROLINA",1,85125,50578,136747,"EVA M CLAYTON","TED TYLER","Democrat",0.62249994515419,34547,135703,0.25457801227681
1998,"NORTH CAROLINA",2,100550,72997,175194,"BOB ETHERIDGE","DAN PAGE","Democrat",0.573935180428554,27553,173547,0.15876390833607
1998,"NORTH CAROLINA",3,50041,83529,134912,"JON WILLIAMS","WALTER B JONES","Republican",0.619136918880455,-33488,133570,-0.250714980908887
1998,"NORTH CAROLINA",4,129157,93469,224910,"DAVID E PRICE","TOM ROBERG","Democrat",0.574260815437286,35688,222626,0.160304726312291
1998,"NORTH CAROLINA",5,55806,119103,176291,"MIKE ROBINSON","RICHARD BURR","Republican",0.675604540220431,-63297,174909,-0.36188532322522
1998,"NORTH CAROLINA",8,64127,67505,133124,"MIKE TAYLOR","ROBERT C ""ROBIN"" HAYES","Republican",0.507083621285418,-3378,131632,-0.0256624528989911
1998,"NORTH CAROLINA",9,51345,120570,174082,"RORY BLAKE","SUE WILKINS MYRICK","Republican",0.692604634597489,-69225,171915,-0.402669924090393
1998,"NORTH CAROLINA",11,84356,112908,199523,"DAVID YOUNG","CHARLES H TAYLOR","Republican",0.565889646807636,-28552,197264,-0.144740043799173
1998,"NORTH CAROLINA",12,82305,62070,147088,"MELVIN L WATT","JOHN ""SCOTT"" KEADLE","Democrat",0.559562982704231,20235,144375,0.140155844155844
1998,"NORTH DAKOTA",0,119668,87511,212888,"EARL POMEROY","KEVIN CRAMER","Democrat",0.562117169591522,32157,207179,0.15521360755675
1998,"OHIO",1,82003,92421,174424,"ROXANNE QUALLS","STEVE CHABOT","Republican",0.529864009539972,-10418,174424,-0.0597280190799431
1998,"OHIO",2,49293,154344,203637,"CHARLES W SANDERS","ROB PORTMAN","Republican",0.75793691716142,-105051,203637,-0.515873834322839
1998,"OHIO",3,114198,50544,164742,"TONY P HALL","JOHN S SHONDEL","Democrat",0.693192992679462,63654,164742,0.386385985358925
1998,"OHIO",4,63529,112011,175540,"PAUL MCCLAIN","MICHAEL G OXLEY","Republican",0.638093881736356,-48482,175540,-0.276187763472713
1998,"OHIO",5,61926,123979,185905,"SUSAN DAVENPORT","PAUL E GILLMOR","Republican",0.666894381538958,-62053,185905,-0.333788763077916
1998,"OHIO",6,102852,77711,180563,"TED STRICKLAND","NANCY P HOLLISTER","Democrat",0.569618360350681,25141,180563,0.139236720701362
1998,"OHIO",7,49780,120765,179697,"DONALD E MINOR JR","DAVID L HOBSON","Republican",0.672047947378086,-70985,170545,-0.416224456888211
1998,"OHIO",8,52912,127979,180891,"JOHN W GRIFFIN","JOHN A BOEHNER","Republican",0.707492357275929,-75067,180891,-0.414984714551857
1998,"OHIO",9,130793,30312,161105,"MARCY KAPTUR","EDWARD S EMERY","Democrat",0.811849414977809,100481,161105,0.623698829955619
1998,"OHIO",10,110552,55015,165567,"DENNIS J KUCINICH","JOE SLOVENEC","Democrat",0.667717600729614,55537,165567,0.335435201459228
1998,"OHIO",11,115226,18592,143295,"STEPHANIE TUBBS JONES","JAMES D HEREFORD","Democrat",0.804117380229596,96634,133818,0.722130057241926
1998,"OHIO",12,60694,124197,184891,"EDWARD S BROWN","JOHN R KASICH","Republican",0.671730911726369,-63503,184891,-0.343461823452737
1998,"OHIO",13,116309,72666,188975,"SHERROD BROWN","GRACE L DRAKE","Democrat",0.615472946156899,43643,188975,0.230945892313798
1998,"OHIO",14,106046,63027,169073,"THOMAS C SAWYER","TOM WATKINS","Democrat",0.627220194827087,43019,169073,0.254440389654173
1998,"OHIO",15,49334,113846,173176,"ADAM CLAY MILLER","DEBORAH PRYCE","Republican",0.657400563588488,-64512,163180,-0.395342566490992
1998,"OHIO",16,66047,117426,183473,"PETER D FERGUSON","RALPH REGULA","Republican",0.640017877289846,-51379,183473,-0.280035754579693
1998,"OHIO",17,123718,57703,181421,"JAMES A TRAFICANT JR","PAUL H ALBERTY","Democrat",0.681938695079401,66015,181421,0.363877390158802
1998,"OHIO",18,74571,113119,187690,"ROBERT L BURCH","ROBERT W NEY","Republican",0.602690606851724,-38548,187690,-0.205381213703447
1998,"OHIO",19,64090,126786,190876,"ELIZABETH KELLEY","STEVEN C LATOURETTE","Republican",0.664232276451728,-62696,190876,-0.328464552903456
1998,"OKLAHOMA",1,56309,91031,147340,"HOWARD PLOWMAN","STEVE LARGENT","Republican",0.617829509976924,-34722,147340,-0.235659019953848
1998,"OKLAHOMA",2,59042,85581,148264,"KENT PHARAOH","TOM A COBURN","Republican",0.577220363675606,-26539,144623,-0.183504698422796
1998,"OKLAHOMA",3,55163,89832,144995,"WALT ROBERTS","WES WATKINS","Republican",0.619552398358564,-34669,144995,-0.239104796717128
1998,"OKLAHOMA",4,52107,83272,135379,"BEN ODOM","J C WATTS JR","Republican",0.615102785513263,-31165,135379,-0.230205571026526
1998,"OKLAHOMA",5,48182,103217,151399,"M C SMOTHERMON","ERNEST J ISTOOK JR","Republican",0.681754833255173,-55035,151399,-0.363509666510347
1998,"OKLAHOMA",6,43555,85261,131271,"PAUL M BARBY","FRANK D LUCAS","Republican",0.649503698455866,-41706,128816,-0.323764128679667
1998,"OREGON",1,119993,112827,239496,"DAVID WU","MOLLY BORDONARO","Democrat",0.501022981594682,7166,232820,0.0307791426853363
1998,"OREGON",2,74924,132316,215216,"KEVIN M CAMPBELL","GREG WALDEN","Republican",0.614805590662404,-57392,207240,-0.276934954641961
1998,"OREGON",4,157524,64143,224637,"PETER A DEFAZIO","STEVE J WEBB","Democrat",0.701237997302314,93381,221667,0.421267035688668
1998,"OREGON",5,124916,92215,227657,"DARLENE HOOLEY","MARYLIN SHANNON","Democrat",0.548702653553372,32701,217131,0.150604934348389
1998,"PENNSYLVANIA",1,77788,15898,95848,"ROBERT A BRADY","WILLIAM M HARRISON","Democrat",0.811576663049829,61890,93686,0.660610977093696
1998,"PENNSYLVANIA",2,102763,16001,118764,"CHAKA FATTAH","ANNE MARIE MULLIGAN","Democrat",0.86527062072682,86762,118764,0.730541241453639
1998,"PENNSYLVANIA",3,66270,45390,111660,"ROBERT A BORSKI","CHARLES F DOUGHERTY","Democrat",0.593498119290704,20880,111660,0.186996238581408
1998,"PENNSYLVANIA",4,103183,58485,161685,"RON KLINK","MIKE TURZAI","Democrat",0.638172990691777,44698,161668,0.276480193977782
1998,"PENNSYLVANIA",6,85374,54579,139953,"TIM HOLDEN","JOHN MECKLEY","Democrat",0.610019077833273,30795,139953,0.220038155666545
1998,"PENNSYLVANIA",7,46920,119491,166411,"MARTIN J D'URSO","CURT WELDON","Republican",0.718047484841747,-72571,166411,-0.436094969683494
1998,"PENNSYLVANIA",8,48320,93697,148200,"BILL TUTHILL","JAMES C GREENWOOD","Republican",0.6322334682861,-45377,142017,-0.31951808586296
1998,"PENNSYLVANIA",10,83760,84275,173056,"PATRICK CASEY","DON SHERWOOD","Republican",0.486981092825444,-515,168035,-0.00306483768262564
1998,"PENNSYLVANIA",11,88933,44123,133065,"PAUL E KANJORSKI","STEPHEN A URBAN","Democrat",0.668342539360463,44810,133056,0.336775493025493
1998,"PENNSYLVANIA",12,100528,46239,146780,"JOHN P MURTHA","TIMOTHY E HOLLOWAY","Democrat",0.684888949448154,54289,146767,0.369899228028099
1998,"PENNSYLVANIA",13,95105,85915,184490,"JOSEPH M HOEFFEL","JON D FOX","Democrat",0.515502195240934,9190,181020,0.0507678709534858
1998,"PENNSYLVANIA",14,83355,52745,137736,"WILLIAM J COYNE","BILL RAVOTTI","Democrat",0.605179473775919,30610,136100,0.224908155767818
1998,"PENNSYLVANIA",15,66930,81755,148706,"ROY C AFFLERBACH","PAT TOOMEY","Republican",0.549776068215136,-14825,148685,-0.0997074351817601
1998,"PENNSYLVANIA",16,40092,95979,136085,"ROBERT S YORCZYK","JOSEPH R PITTS","Republican",0.705287136716023,-55887,136071,-0.410719403840642
1998,"PENNSYLVANIA",18,98363,46945,145337,"MICHAEL F DOYLE","DICK WALKER","Democrat",0.676792557985922,51418,145308,0.353855259173617
1998,"PENNSYLVANIA",19,40674,96284,142489,"LINDA G ROPP","WILLIAM F GOODLING","Republican",0.675729354546667,-55610,136958,-0.4060368872209
1998,"PENNSYLVANIA",21,54591,94518,149115,"LARRY KLEMENS","PHIL ENGLISH","Republican",0.633859772658686,-39927,149109,-0.267770557109229
1998,"RHODE ISLAND",1,92788,38460,138895,"PATRICK J KENNEDY","RONALD G SANTA","Democrat",0.668044206054934,54328,131248,0.413933926612215
1998,"RHODE ISLAND",2,110917,38170,154053,"ROBERT A WEYGAND","JOHN O MATSON","Democrat",0.719992470123918,72747,149087,0.487949988932637
1998,"SOUTH CAROLINA",2,84864,119538,206718,"JANE SREDERICK","FLOYD SPENCE","Republican",0.578266043595623,-34674,204402,-0.169636304928523
1998,"SOUTH CAROLINA",4,73314,105264,182550,"GLENN REESE","JIM DEMINT","Republican",0.576631059983566,-31950,178578,-0.178913415986292
1998,"SOUTH CAROLINA",5,95696,66367,164931,"JOHN M SPRATT JR","MIKE BURKHOLD","Democrat",0.580218394358853,29329,162063,0.180972831553161
1998,"SOUTH CAROLINA",6,116507,41421,160576,"JAMES E CLYBURN","GARY MCLEOD","Democrat",0.725556745715425,75086,157928,0.475444506357327
1998,"SOUTH DAKOTA",0,64433,194157,258590,"JEFF MOSER","JOHN R THUNE","Republican",0.750829498433814,-129724,258590,-0.501658996867628
1998,"TENNESSEE",1,30710,68904,99689,"KAY C WHITE","WILLIAM L JENKINS","Republican",0.691189599654927,-38194,99614,-0.38342000120465
1998,"TENNESSEE",3,37144,75100,113786,"JAMES M LEWIS JR","ZACH WAMP","Republican",0.660010897649975,-37956,112244,-0.338156159794733
1998,"TENNESSEE",4,42627,62829,105479,"JERRY W COOPER","VAN HILLEARY","Republican",0.595654111244892,-20202,105456,-0.191568047337278
1998,"TENNESSEE",6,75055,62277,137436,"BART GORDON","WALT MASEY","Democrat",0.546108734247213,12778,137332,0.0930445926659482
1998,"TENNESSEE",9,75428,18078,95782,"HAROLD E FORD JR","CLAUDE BURDIKOFF","Democrat",0.787496606878119,57350,93506,0.613329625906359
1998,"TEXAS",1,80788,55191,135979,"MAX SANDLIN","DENNIS BOERNER","Democrat",0.59412115106009,25597,135979,0.18824230212018
1998,"TEXAS",2,81556,56891,139589,"JIM TURNER","BRIAN BABIN","Democrat",0.58425807191111,24665,138447,0.178154817366935
1998,"TEXAS",4,82989,58954,144080,"RALPH M HALL","JIM LOHMEYER","Democrat",0.575992504164353,24035,141943,0.169328533284487
1998,"TEXAS",5,48073,61714,110667,"VICTOR M MORALES","PETE SESSIONS","Republican",0.557654946822449,-13641,109787,-0.124249683478007
1998,"TEXAS",6,40112,112957,154886,"BEN B BOOTHE","JOE BARTON","Republican",0.729291220639696,-72845,153069,-0.475896491124917
1998,"TEXAS",7,7889,111010,118946,"DREW PARKS","BILL ARCHER","Republican",0.933280648361441,-103121,118899,-0.867299136241684
1998,"TEXAS",9,86055,49107,135162,"NICK LAMPSON","TOM COTTAR","Democrat",0.636680427930927,36948,135162,0.273360855861855
1998,"TEXAS",12,39084,66740,107741,"TOM HALL","KAY GRANGER","Republican",0.619448492217447,-27656,105824,-0.261339582703356
1998,"TEXAS",13,37027,81141,119466,"MARK HARMON","WILLIAM M ""MAC"" THORNBERRY","Republican",0.679197428557079,-44114,118168,-0.373315956942658
1998,"TEXAS",14,68014,84459,152863,"LOY SNEARY","RON PAUL","Republican",0.552514342908356,-16445,152473,-0.107855161241662
1998,"TEXAS",15,47957,34221,82178,"RUBEN HINOJOSA","TOM HAUGHEY","Democrat",0.583574679354572,13736,82178,0.167149358709144
1998,"TEXAS",17,75367,63700,140685,"CHARLES W STENHOLM","RUDY IZZARD","Democrat",0.535714539574226,11667,139067,0.0838948132914351
1998,"TEXAS",19,21162,108266,129428,"SIDNEY BLANKENSHIP","LARRY COMBEST","Republican",0.836495966869611,-87104,129428,-0.672991933739222
1998,"TEXAS",20,50356,28347,79713,"CHARLIE GONZALEZ","JAMES WALKER","Democrat",0.631716282162257,22009,78703,0.279646265072488
1998,"TEXAS",22,45386,87840,134720,"HILL KEMP","TOM DELAY","Republican",0.652019002375297,-42454,133226,-0.318661522525633
1998,"TEXAS",23,40281,73177,114720,"CHARLIE URBINA JONES","HENRY BONILLA","Republican",0.637874825662483,-32896,113458,-0.289939889650796
1998,"TEXAS",24,56321,40105,97992,"MARTIN FROST","SHAWN TERRY","Democrat",0.574751000081639,16216,96426,0.168170410470205
1998,"TEXAS",25,58591,41848,101269,"KEN BENTSEN","JOHN M SANCHEZ","Democrat",0.578567972429865,16743,100439,0.166698194924282
1998,"TEXAS",27,61638,34284,97398,"SOLOMON P ORTIZ","EROL A STONE","Democrat",0.632846670362841,27354,95922,0.28516919997498
1998,"TEXAS",30,57603,21338,79752,"EDDIE BERNICE JOHNSON","CARRIE KELLEHER","Democrat",0.722276557327716,36265,78941,0.459393724427104
1998,"UTAH",1,49307,109708,162085,"STEVE BEIERLEIN","JAMES V HANSEN","Republican",0.676854736712219,-60401,159015,-0.379844668741943
1998,"UTAH",2,77198,93718,177641,"LILY ESKELSEN","MERRILL COOK","Republican",0.527569648898621,-16520,170916,-0.0966556671113295
1998,"VIRGINIA",6,39487,89177,128730,"DAVID A BOWERS","BOB GOODLATTE","Republican",0.692744504000621,-49690,128664,-0.38619971398371
1998,"VIRGINIA",8,97545,48352,146287,"JAMES P MORAN","DEMARIS H MILLER","Democrat",0.666805662840854,49193,145897,0.337176227064299
1998,"VIRGINIA",9,87163,55918,143126,"RICK BOUCHER","J A ""JOE"" BARTA","Democrat",0.608994871651552,31245,143081,0.218372809807032
1998,"VIRGINIA",10,36476,103648,144755,"CORNELL W BROOKS","FRANK R WOLF","Republican",0.716023626126904,-67172,140124,-0.479375410350832
1998,"WASHINGTON",1,112726,99910,226473,"JAY INSLEE","RICK WHITE","Democrat",0.497745868160885,12816,212636,0.0602720141462405
1998,"WASHINGTON",2,100776,124125,224901,"GRETHE CAMMERMEYER","JACK METCALF","Republican",0.551909506849681,-23349,224901,-0.103819013699361
1998,"WASHINGTON",3,120364,99855,220219,"BRIAN BAIRD","DON BENTON","Democrat",0.546565010285216,20509,220219,0.0931300205704322
1998,"WASHINGTON",4,43043,121684,176090,"GORDON ALLEN PROSS","DOC HASTINGS","Republican",0.691032994491453,-78641,164727,-0.477402004528705
1998,"WASHINGTON",5,73545,110040,193258,"BRAD LYONS","GEORGE R NETHERCUTT JR","Republican",0.569394281219924,-36495,183585,-0.19879075087834
1998,"WASHINGTON",6,143308,66291,209599,"NORMAN D DICKS","BOB LAWRENCE","Democrat",0.683724636090821,77017,209599,0.367449272181642
1998,"WASHINGTON",8,91371,135539,226910,"HEIDI BEHRENS-BENEDICT","JENNIFER DUNN","Republican",0.59732493058922,-44168,226910,-0.194649861178441
1998,"WASHINGTON",9,111948,61108,173056,"ADAM SMITH","RON TABER","Democrat",0.646888868343195,50840,173056,0.293777736686391
1998,"WEST VIRGINIA",2,99357,29136,136153,"ROBERT E WISE JR","SALLY ANNE KAY","Democrat",0.729745213105844,70221,128493,0.546496696318087
1998,"WISCONSIN",1,81164,108475,189946,"LYDIA CAROL SPOTTSWOOD","PAUL RYAN","Republican",0.571083360534047,-27311,189639,-0.144015735159962
1998,"WISCONSIN",2,116377,103528,221693,"TAMMY BALDWIN","JOSEPHINE W MUSSER","Democrat",0.524946660471914,12849,219905,0.0584297764943953
1998,"WISCONSIN",3,128256,51001,179448,"RON KIND","TROY A BRECHLER","Democrat",0.714725157148589,77255,179257,0.430973406896244
1998,"WISCONSIN",4,105841,76666,182701,"GERALD D KLECZKA","TOM REYNOLDS","Democrat",0.579312647440353,29175,182507,0.159856882201779
1998,"WISCONSIN",5,121129,33506,154861,"THOMAS M BARRETT","JACK MELVIN","Democrat",0.782178857168687,87623,154635,0.566644032722217
1998,"WISCONSIN",7,115613,75049,190865,"DAVID R OBEY","SCOTT WEST","Democrat",0.605731799963325,40564,190662,0.212753459000745
1998,"WISCONSIN",8,93441,112418,205974,"JAY W JOHNSON","MARK GREEN","Republican",0.545787332381757,-18977,205859,-0.0921844563511918
1998,"WYOMING",0,67399,100687,174219,"SCOTT FARRIS","BARBARA CUBIN","Republican",0.577933520454141,-33288,168086,-0.198041478766822
2000,"ALABAMA",2,64958,151830,222636,"CHARLES WOODS","TERRY EVERETT","Republican",0.681965180833288,-86872,216788,-0.400723287266823
2000,"ALABAMA",4,86400,140009,231106,"MARSHA FOLSOM","ROBERT B ADERHOLT","Republican",0.605821571053975,-53609,226409,-0.236779456647041
2000,"ALABAMA",7,148243,46134,198633,"EARL F HILLIARD","ED MARTIN","Democrat",0.746316070340779,102109,194377,0.525314208985631
2000,"ALASKA",0,45372,190862,274393,"CLIFFORD MARK GREENE","DON YOUNG","Republican",0.695578968851246,-145490,236234,-0.615872397707358
2000,"ARIZONA",1,97455,123289,229971,"DAVID MENDOZA","JEFF FLAKE","Republican",0.536106726500298,-25834,220744,-0.117031493494727
2000,"ARIZONA",2,84034,32990,122605,"ED PASTOR","BILL BARENHOLTZ","Democrat",0.685404347294156,51044,117024,0.436184030626196
2000,"ARIZONA",3,94676,198367,301970,"GENE SCHARER","BOB STUMP","Republican",0.656909626784118,-103691,293043,-0.353842268882041
2000,"ARIZONA",4,71803,140396,219497,"BEN JANKOWSKI","JOHN B SHADEGG","Republican",0.639626054114635,-68593,212199,-0.32324846017182
2000,"ARIZONA",5,101564,172986,287609,"GEORGE CUNNINGHAM","JIM KOLBE","Republican",0.601462402080603,-71422,274550,-0.260142050628301
2000,"ARIZONA",6,108317,186687,304004,"LARRY NELSON","J D HAYWORTH","Republican",0.614093893501401,-78370,295004,-0.265657414814714
2000,"ARKANSAS",1,120266,79437,199956,"MARION BERRY","SUSAN MYSHKA","Democrat",0.601462321710776,40829,199703,0.204448606180178
2000,"ARKANSAS",2,126957,93692,220649,"VIC SNYDER","BOB THOMAS","Democrat",0.575379902016325,33265,220649,0.150759804032649
2000,"ARKANSAS",4,108143,104017,212160,"MIKE ROSS","JAY DICKEY","Democrat",0.509723793363499,4126,212160,0.0194475867269985
2000,"CALIFORNIA",1,155638,66987,239335,"MIKE THOMPSON","RUSSEL J ""JIM"" CHASE","Democrat",0.650293521632858,88651,222625,0.398207748455924
2000,"CALIFORNIA",2,72075,168172,255856,"STAN MORGAN","WALLY HERGER","Republican",0.657291601525858,-96097,240247,-0.399992507710814
2000,"CALIFORNIA",3,93067,129254,230182,"BOB KENT","DOUG OSE","Republican",0.561529572251523,-36187,222321,-0.162769149113219
2000,"CALIFORNIA",4,97974,197503,311423,"MARK A NORBERG","JOHN T DOOLITTLE","Republican",0.634195290649695,-99529,295477,-0.336841784639752
2000,"CALIFORNIA",5,147025,55945,214059,"ROBERT T MATSUI","KENNETH J PAYNE","Democrat",0.686843346927716,91080,202970,0.448736266443317
2000,"CALIFORNIA",6,182116,80169,283118,"LYNN C WOOLSEY","KEN MCAULIFFE","Democrat",0.643251223871319,101947,262285,0.388687877690299
2000,"CALIFORNIA",7,159692,44154,208789,"GEORGE MILLER","CHRISTOPHER A HOFFMAN","Democrat",0.764848722873331,115538,203846,0.566790616445748
2000,"CALIFORNIA",8,181847,25298,215428,"NANCY PELOSI","ADAM SPARKS","Democrat",0.844119613049371,156549,207145,0.755745975041638
2000,"CALIFORNIA",9,182352,21033,214650,"BARBARA LEE","ARNEZE WASHINGTON","Democrat",0.84953179594689,161319,203385,0.79317058780146
2000,"CALIFORNIA",10,160429,134863,304819,"ELLEN O TAUSCHER","CLAUDE B HUTCHISON JR","Democrat",0.526309055537877,25566,295292,0.0865787085325711
2000,"CALIFORNIA",11,79539,120635,208607,"TOM Y SANTOS","RICHARD W POMBO","Republican",0.578288360409766,-41096,200174,-0.20530138779262
2000,"CALIFORNIA",12,158404,44162,212556,"TOM LANTOS","MIKE GARZA","Democrat",0.745234197105704,114242,202566,0.56397421087448
2000,"CALIFORNIA",13,129012,44499,183146,"FORTNEY PETE STARK","JAMES R ""JIM"" GOETZ","Democrat",0.704421608989549,84513,173511,0.487075747358957
2000,"CALIFORNIA",14,161720,59338,230262,"ANNA G ESHOO","BILL QURAISHI","Democrat",0.702330388861384,102382,221058,0.463145418849352
2000,"CALIFORNIA",15,128545,99866,236822,"MIKE HONDA","JIM CUNNEEN","Democrat",0.54279163253414,28679,228411,0.125558751548743
2000,"CALIFORNIA",16,115118,37213,159746,"ZOE LOFGREN","HORACE ""GENE"" THAYN","Democrat",0.720631502510235,77905,152331,0.51141921211047
2000,"CALIFORNIA",17,143219,51557,208760,"SAM FARR","CLINT ENGLER","Democrat",0.686046177428626,91662,194776,0.470602127572186
2000,"CALIFORNIA",18,121003,56465,180328,"GARY A CONDIT","STEVE R WILSON","Democrat",0.671016148351892,64538,177468,0.363659927423536
2000,"CALIFORNIA",19,70578,144517,222615,"DANIEL J ROSENBERG","GEORGE RADANOVICH","Republican",0.6491790759832,-73939,215095,-0.343750435853925
2000,"CALIFORNIA",20,66235,57563,126534,"CALVIN M DOOLEY","RICH RODRIGUEZ","Democrat",0.523456146174151,8672,123798,0.0700495969240214
2000,"CALIFORNIA",21,49318,142539,199100,"PEDRO ""PETE"" MARTINEZ JR","WILLIAM M THOMAS","Republican",0.715916624811652,-93221,191857,-0.48588792694559
2000,"CALIFORNIA",22,135538,113094,255070,"LOIS CAPPS","MIKE STOKER","Democrat",0.531375700788019,22444,248632,0.0902699572058303
2000,"CALIFORNIA",23,89918,119479,221034,"MICHAEL CASE","ELTON GALLEGLY","Republican",0.540545798383959,-29561,209397,-0.141172032073048
2000,"CALIFORNIA",24,155398,70169,235444,"BRAD SHERMAN","JERRY DOYLE","Democrat",0.660021066580588,85229,225567,0.377843390212221
2000,"CALIFORNIA",25,73921,138628,222778,"SID GOLD","HOWARD P ""BUCK"" MCKEON","Republican",0.622269703471617,-64707,212549,-0.304433330667281
2000,"CALIFORNIA",27,113708,94518,215774,"ADAM B SCHIFF","JAMES E ROGAN","Democrat",0.526977300323487,19190,208226,0.0921594805643868
2000,"CALIFORNIA",28,81804,116557,205199,"JANICE M NELSON","DAVID DREIER","Republican",0.568019337326205,-34753,198361,-0.175200770312713
2000,"CALIFORNIA",29,180295,45784,238201,"HENRY A WAXMAN","JIM SCILEPPI","Democrat",0.756902783783443,134511,226079,0.594973438488316
2000,"CALIFORNIA",30,83223,11788,99920,"XAVIER BECERRA","TONY GOSS","Democrat",0.832896317053643,71435,95011,0.751860310911368
2000,"CALIFORNIA",32,137447,19924,164527,"JULIAN C DIXON","KATHY WILLIAMSON","Democrat",0.835406954481635,117523,157371,0.746789433885532
2000,"CALIFORNIA",33,60510,8260,71571,"LUCILLE ROYBAL-ALLARD","WAYNE MILLER","Democrat",0.845454164396194,52250,68770,0.759778973389559
2000,"CALIFORNIA",34,105980,33445,148687,"GRACE F NAPOLITANO","ROBERT ARTHUR CANALES","Democrat",0.712772468339532,72535,139425,0.520243858705397
2000,"CALIFORNIA",35,100569,12582,116215,"MAXINE WATERS","CARL MCGILL","Democrat",0.865370218990664,87987,113151,0.77760691465387
2000,"CALIFORNIA",36,115651,111199,238736,"JANE HARMAN","STEVEN T KUYKENDALL","Democrat",0.484430500636687,4452,226850,0.0196253030636985
2000,"CALIFORNIA",37,93269,12762,113275,"JUANITA MILLENDER-MCDONALD","VERNON VAN","Democrat",0.823385566100199,80507,106031,0.759277947015495
2000,"CALIFORNIA",38,85498,87266,180122,"GERRIE SCHIPSKE","STEPHEN HORN","Republican",0.484482739476577,-1768,172764,-0.0102336134842907
2000,"CALIFORNIA",39,64398,129294,205564,"GILL G KANEL","EDWARD R ROYCE","Republican",0.62897199898815,-64896,193692,-0.335047394833034
2000,"CALIFORNIA",41,66361,104695,177616,"RODOLFO G FAVILA","GARY G MILLER","Republican",0.589445770651293,-38334,171056,-0.224102048451969
2000,"CALIFORNIA",42,90585,53239,151577,"JOE BACA","ELIA PIROZZI","Democrat",0.59761705271908,37346,143824,0.259664590054511
2000,"CALIFORNIA",44,79302,123738,209187,"RON ODEN","MARY BONO","Republican",0.591518593411636,-44436,203040,-0.218853427895981
2000,"CALIFORNIA",45,71066,136275,219385,"TED CRISELL","DANA ROHRABACHER","Republican",0.621168265834036,-65209,207341,-0.314501232269546
2000,"CALIFORNIA",46,70381,40928,116908,"LORETTA SANCHEZ","GLORIA MATTA TUCHMAN","Democrat",0.602020392103192,29453,111309,0.264605737182079
2000,"CALIFORNIA",47,83186,181365,276401,"JOHN L GRAHAM","CHRISTOPHER COX","Republican",0.656166222264029,-98179,264551,-0.371115588298665
2000,"CALIFORNIA",48,74073,160627,261478,"PETER KOUVELIS","DARRELL ISSA","Republican",0.61430407147064,-86554,234700,-0.368785683851726
2000,"CALIFORNIA",49,113400,105515,228489,"SUSAN A DAVIS","BRIAN P BILBRAY","Democrat",0.496303979622651,7885,218915,0.0360185460110088
2000,"CALIFORNIA",50,95191,38526,139472,"BOB FILNER","BOB DIVINE","Democrat",0.682509751061145,56665,133717,0.423768107271327
2000,"CALIFORNIA",51,81408,172291,267799,"GEORGE ""JORGE"" BARRAZA","RANDY ""DUKE"" CUNNINGHAM","Republican",0.64335938521055,-90883,253699,-0.358231605169906
2000,"CALIFORNIA",52,63537,131345,202994,"CRAIG BARKACS","DUNCAN HUNTER","Republican",0.647038828733854,-67808,194882,-0.347943883991338
2000,"COLORADO",1,141831,56291,206434,"DIANA DEGETTE","JESSE L THOMAS","Democrat",0.687052520418148,85540,198122,0.431754171672
2000,"COLORADO",2,155725,109338,283116,"MARK UDALL","CAROLYN COX","Democrat",0.550039559756425,46387,265063,0.175003678370802
2000,"COLORADO",3,87921,199204,302540,"CURTIS IMRIE","SCOTT MCINNIS","Republican",0.658438553579692,-111283,287125,-0.387576839355681
2000,"COLORADO",6,110568,141410,262477,"KENNETH A TOLTZ","THOMAS G TANCREDO","Republican",0.538751966838999,-30842,251978,-0.122399574566034
2000,"CONNECTICUT",1,151932,59331,211263,"JOHN B LARSON","BOB BACKLUND","Democrat",0.719160477698414,92601,211263,0.438320955396828
2000,"CONNECTICUT",2,111520,110239,225900,"SAM GEJDENSON","ROB SIMMONS","Democrat",0.493669765382913,1281,221759,0.00577654120013167
2000,"CONNECTICUT",3,156910,60037,218205,"ROSA L DELAURO","JUNE M GOLD","Democrat",0.719094429550194,96873,216947,0.446528414774115
2000,"CONNECTICUT",4,84472,119155,206758,"STEPHANIE SANCHEZ","CHRISTOPHER SHAYS","Republican",0.576301763414233,-34683,203627,-0.170326135532125
2000,"CONNECTICUT",5,118932,98229,221821,"JAMES H MALONEY","MARK NIELSEN","Democrat",0.536162040564239,20703,217161,0.0953347976846671
2000,"CONNECTICUT",6,75471,143698,229543,"PAUL VALENTI","NANCY L JOHNSON","Republican",0.626017783160454,-68227,219169,-0.311298586935196
2000,"DELAWARE",0,96488,211797,313126,"MICHEAL C MILLER","MICHAEL N CASTLE","Republican",0.676395444645287,-115309,308285,-0.374033767455439
2000,"FLORIDA",2,185579,71754,257403,"ALLEN BOYD","DOUG DODD","Democrat",0.720966733099459,113825,257333,0.442325702494433
2000,"FLORIDA",3,102143,75228,177372,"CORRINE BROWN","JENNIFER S CARROLL","Democrat",0.575868795525788,26915,177371,0.151744084433194
2000,"FLORIDA",4,94587,203090,303286,"TOM SULLIVAN","ANDER CRENSHAW","Republican",0.669631964548314,-108503,297677,-0.364499104734326
2000,"FLORIDA",5,180338,100244,280598,"KAREN L THURMAN","PETE ENWALL","Democrat",0.642691679912188,80094,280582,0.285456657946697
2000,"FLORIDA",7,99531,171018,270560,"DAN VAUGHEN","JOHN L MICA","Republican",0.632089000591366,-71487,270549,-0.264229400219554
2000,"FLORIDA",8,121295,125253,246593,"LINDA W CHAPIN","RIC KELLER","Republican",0.507934126272846,-3958,246548,-0.0160536690624138
2000,"FLORIDA",12,94395,125224,219625,"MIKE STEDEM","ADAM H PUTNAM","Republican",0.570171883892999,-30829,219619,-0.140374922024051
2000,"FLORIDA",13,99568,175918,275587,"DANIEL E DUNN","DAN MILLER","Republican",0.638339254028673,-76350,275486,-0.277146570061637
2000,"FLORIDA",15,117511,176189,299445,"PATSY ANN KURTH","DAVE WELDON","Republican",0.588385179248276,-58678,293700,-0.199788900238338
2000,"FLORIDA",16,108782,176153,292500,"JEAN ELLIOTT BROWN","MARK FOLEY","Republican",0.602232478632479,-67371,284935,-0.236443399371787
2000,"FLORIDA",19,171080,67789,238869,"ROBERT WEXLER","MORRIS KENT THOMPSON","Democrat",0.716208465728077,103291,238869,0.432416931456154
2000,"FLORIDA",22,105256,105855,211112,"ELAINE BLOOM","E CLAY SHAW JR","Republican",0.501416309826064,-599,211111,-0.00283736991440522
2000,"FLORIDA",23,89179,27630,116813,"ALCEE L HASTINGS","BILL LAMBERT","Democrat",0.763433864381533,61549,116809,0.526920014724893
2000,"GEORGIA",1,58776,131684,190460,"JOYCE MARIE GRIGGS","JACK KINGSTON","Republican",0.691399768980363,-72908,190460,-0.382799537960727
2000,"GEORGIA",2,96430,83870,180300,"SANFORD D BISHOP JR","DYLAN GLENN","Democrat",0.534830837493067,12560,180300,0.0696616749861342
2000,"GEORGIA",3,86309,150200,236706,"GAIL NOTTI","MAC COLLINS","Republican",0.634542428159827,-63891,236509,-0.270141939630204
2000,"GEORGIA",4,139579,90277,229856,"CYNTHIA A MCKINNEY","SUNNY WARREN","Democrat",0.607245405819296,49302,229856,0.214490811638591
2000,"GEORGIA",5,137333,40606,177942,"JOHN LEWIS","HANK SCHWAB","Democrat",0.771785188432186,96727,177939,0.543596401013831
2000,"GEORGIA",6,86666,256595,343261,"BRETT DEHART","JOHNNY ISAKSON","Republican",0.747521565222964,-169929,343261,-0.495043130445929
2000,"GEORGIA",7,102272,126312,228584,"ROGER KAHN","BOB BARR","Republican",0.552584607846568,-24040,228584,-0.105169215693137
2000,"GEORGIA",8,79051,113380,192431,"JIM MARSHALL","SAXBY CHAMBLISS","Republican",0.589198206110242,-34329,192431,-0.178396412220484
2000,"GEORGIA",9,60360,183171,243531,"JAMES HARRINGTON","NATHAN DEAL","Republican",0.752146543971815,-122811,243531,-0.504293087943629
2000,"GEORGIA",10,71309,122590,193899,"DENISE FREEMAN","CHARLIE NORWOOD","Republican",0.632236370481539,-51281,193899,-0.264472740963079
2000,"HAWAII",1,108517,44989,157194,"NEIL ABERCROMBIE","PHIL MEYERS","Democrat",0.690338053615278,63528,153506,0.413847015751827
2000,"HAWAII",2,112856,65906,183230,"PATSY T MINK","RUSS FRANCIS","Democrat",0.615925339736943,46950,178762,0.262639710900527
2000,"IDAHO",1,84080,173743,268116,"LINDA PALL","C L ""BUTCH"" OTTER","Republican",0.648014292321234,-89663,257823,-0.347769593868662
2000,"IDAHO",2,58265,158912,224719,"CRAIG WILLIAMS","MICHAEL K SIMPSON","Republican",0.707158718221423,-100647,217177,-0.46343305230296
2000,"ILLINOIS",1,172271,23915,196186,"BOBBY L RUSH","RAYMOND G WARDINGLEY","Democrat",0.87810037413475,148356,196186,0.756200748269499
2000,"ILLINOIS",2,175995,19906,195901,"JESSE L JACKSON JR","ROBERT GORDON III","Democrat",0.898387450804233,156089,195901,0.796774901608466
2000,"ILLINOIS",3,145498,47005,192503,"WILLIAM O LIPINSKI","KARL GROTH","Democrat",0.75582198718981,98493,192503,0.51164397437962
2000,"ILLINOIS",6,92880,133327,226207,"BRENT CHRISTENSEN","HENRY J HYDE","Republican",0.589402626797579,-40447,226207,-0.178805253595158
2000,"ILLINOIS",7,164155,26872,191027,"DANNY K DAVIS","ROBERT DALLAS","Democrat",0.859328785983133,137283,191027,0.718657571966267
2000,"ILLINOIS",8,90777,141918,232695,"LANCE PRESSL","PHILIP M CRANE","Republican",0.60988848062915,-51141,232695,-0.219776961258299
2000,"ILLINOIS",9,147002,45344,192346,"JANICE D SCHAKOWSKY","DENNIS J DRISCOLL","Democrat",0.764258159774573,101658,192346,0.528516319549146
2000,"ILLINOIS",10,115924,121582,237506,"LAUREN BETH GASH","MARK STEVEN KIRK","Republican",0.511911278030871,-5658,237506,-0.0238225560617416
2000,"ILLINOIS",11,102485,132384,234869,"JAMES P STEVENSON","JERRY WELLER","Republican",0.563650375315601,-29899,234869,-0.127300750631203
2000,"ILLINOIS",13,98768,193250,292018,"THOMAS MASON","JUDY BIGGERT","Republican",0.661774274188577,-94482,292018,-0.323548548377155
2000,"ILLINOIS",14,66309,188597,254909,"VERN DELJONSON","J DENNIS HASTERT","Republican",0.739860106940124,-122288,254906,-0.479737628772959
2000,"ILLINOIS",15,110679,125943,236622,"F MICHAEL ""MIKE"" KELLEHER JR","TIM JOHNSON","Republican",0.532253974693815,-15264,236622,-0.0645079493876309
2000,"ILLINOIS",16,88781,178174,267005,"CHARLES W HENDRICKSON","DONALD A MANZULLO","Republican",0.667305855695586,-89393,266955,-0.334861680807627
2000,"ILLINOIS",17,132494,108853,241347,"LANE EVANS","MARK BAKER","Democrat",0.54897719880504,23641,241347,0.0979543976100801
2000,"ILLINOIS",18,85317,173706,259023,"JOYCE HARANT","RAY LAHOOD","Republican",0.670619983553584,-88389,259023,-0.341239967107168
2000,"ILLINOIS",19,155101,85137,240238,"DAVID D PHELPS","JAMES ""JIM"" EATHERLY","Democrat",0.645613932849924,69964,240238,0.291227865699848
2000,"ILLINOIS",20,94382,161393,255775,"JEFFREY S COOPER","JOHN SHIMKUS","Republican",0.630995992571596,-67011,255775,-0.261991985143192
2000,"INDIANA",1,148683,56200,207790,"PETER J VISCLOSKY","JACK REYNOLDS","Democrat",0.715544540160739,92483,204883,0.451394210354202
2000,"INDIANA",2,80885,106023,208407,"ROBERT W ROCK","MIKE PENCE","Republican",0.508730512890642,-25138,186908,-0.134493975645772
2000,"INDIANA",3,107438,98822,208315,"TIM ROEMER","CHRIS CHOCOLA","Democrat",0.515747785805151,8616,206260,0.0417725201202366
2000,"INDIANA",4,74492,131051,210430,"MICHAEL ""MIKE"" DEWAYNE FOSTER","MARK E SOUDER","Republican",0.622777170555529,-56559,205543,-0.275168699493537
2000,"INDIANA",5,81427,132051,216985,"GREG GOODNIGHT","STEVE BUYER","Republican",0.60857202110745,-50624,213478,-0.23713918998679
2000,"INDIANA",6,74881,199207,283175,"DARIN PATRICK GRIESEY","DAN BURTON","Republican",0.703476648715459,-124326,274088,-0.453598844166837
2000,"INDIANA",7,66764,135869,209665,"MICHAEL DOUGLAS GRAF","BRIAN D KERNS","Republican",0.648028998640689,-69105,202633,-0.341035270661738
2000,"INDIANA",8,100488,116879,221992,"PAUL E PERRY","JOHN N HOSTETTLER","Republican",0.526500954989369,-16391,217367,-0.0754070305060106
2000,"INDIANA",9,126420,102219,233283,"BARON P HILL","MICHAEL E BAILEY","Democrat",0.541916899216831,24201,228639,0.105848083660268
2000,"INDIANA",10,91689,62233,156702,"JULIA CARSON","MARVIN B SCOTT","Democrat",0.585116973618716,29456,153922,0.191369654760203
2000,"IOWA",1,96283,164972,266990,"BOB SIMPSON","JAMES A LEACH","Republican",0.617895801340874,-68689,261255,-0.262919369964211
2000,"IOWA",2,110327,139906,252567,"DONNA L SMITH","JIM NUSSLE","Republican",0.553936183270182,-29579,250233,-0.118205832164423
2000,"IOWA",3,156327,83810,248926,"LEONARD L BOSWELL","JAY MARCUS","Democrat",0.628005913403983,72517,240137,0.301981785397502
2000,"IOWA",4,101112,169267,275645,"MICHAEL L HUSTON","GREG GANSKE","Republican",0.614076076112391,-68155,270379,-0.252072091397631
2000,"IOWA",5,67593,159367,231806,"MIKE PALECEK","TOM LATHAM","Republican",0.687501617732069,-91774,226960,-0.40436200211491
2000,"KANSAS",2,71709,164951,244759,"STANLEY WILES","JIM RYUN","Republican",0.673932317095592,-93242,236660,-0.393991380038874
2000,"KANSAS",3,154505,144672,308710,"DENNIS MOORE","PHILL KLINE","Democrat",0.500485892909203,9833,299177,0.0328668313406445
2000,"KANSAS",4,101980,131871,242583,"CARLOS NOLLA","TODD TIAHRT","Republican",0.543611877171937,-29891,233851,-0.127820706347204
2000,"KENTUCKY",1,95806,132115,227921,"BRIAN S ROY","ED WHITFIELD","Republican",0.579652598926821,-36309,227921,-0.159305197853642
2000,"KENTUCKY",2,74537,160800,237462,"BRIAN PEDIGO","RON LEWIS","Republican",0.677160977335321,-86263,235337,-0.366550946090075
2000,"KENTUCKY",3,118875,142106,268785,"ELEANOR JORDAN","ANNE M NORTHUP","Republican",0.528697657979426,-23231,260981,-0.089014142792004
2000,"KENTUCKY",4,125872,100943,231963,"KEN LUCAS","DON BELL","Democrat",0.54263826558546,24929,226815,0.10990895663867
2000,"KENTUCKY",5,52495,145980,198475,"SIDNEY JANE BAILEY","HAROLD ROGERS","Republican",0.735508250409372,-93485,198475,-0.471016500818743
2000,"KENTUCKY",6,94167,142971,270803,"SCOTTY BAESLER","ERNIE FLETCHER","Republican",0.527952053706938,-48804,237138,-0.20580421526706
2000,"LOUISIANA",1,40917,191379,237810,"CARY J DEATON","DAVID VITTER","Republican",0.804755897565283,-150462,232296,-0.647716706271309
2000,"LOUISIANA",4,43600,122678,173967,"PHILLIP R GREEN","JIM MCCRERY","Republican",0.705179717992493,-79078,166278,-0.475577045670504
2000,"LOUISIANA",5,50163,123975,179473,"ROGER BEALL","JOHN COOKSEY","Republican",0.690772428164682,-73812,174138,-0.423870723219516
2000,"LOUISIANA",6,72192,165637,243478,"KATHY J ROGILLIO","RICHARD H BAKER","Republican",0.680295550316661,-93445,237829,-0.392908350117101
2000,"MAINE",1,202823,123915,339094,"THOMAS H ALLEN","JANE A AMERO","Democrat",0.598132081369768,78908,326738,0.241502365809915
2000,"MAINE",2,219783,79522,299305,"JOHN E BALDACCI","RICHARD H CAMPBELL","Democrat",0.734311154173836,140261,299305,0.468622308347672
2000,"MARYLAND",1,91022,165293,256682,"BENNETT BOZMAN","WAYNE T GILCHREST","Republican",0.643960230947242,-74271,256315,-0.289764547529407
2000,"MARYLAND",2,81591,178556,260432,"KENNETH T BOSLEY","ROBERT L EHRLICH JR","Republican",0.685614671008171,-96965,260147,-0.372731570996398
2000,"MARYLAND",3,169347,53827,223818,"BENJAMIN L CARDIN","COLIN HARBY","Democrat",0.756628153231644,115520,223174,0.517623020602758
2000,"MARYLAND",4,172624,24973,197969,"ALBERT RUSSELL WYNN","JOHN B KIMBLE","Democrat",0.871974905161919,147651,197597,0.747233004549664
2000,"MARYLAND",5,166231,89019,255375,"STENY H HOYER","THOMAS E ""TIM"" HUTCHINS","Democrat",0.650929025942242,77212,255250,0.302495592556317
2000,"MARYLAND",6,109136,168624,278045,"DONALD M DEARMON","ROSCOE G BARTLETT","Republican",0.606462982610729,-59488,277760,-0.214170506912442
2000,"MARYLAND",7,134066,19773,153974,"ELIJAH E CUMMINGS","KENNETH KONDNER","Democrat",0.870705443776222,114293,153839,0.74293904666567
2000,"MARYLAND",8,136917,156241,300469,"LIH YOUNG","CONSTANCE A MORELLA","Republican",0.519990414984574,-19324,293158,-0.0659166729204047
2000,"MASSACHUSETTS",1,169375,73580,259300,"JOHN W OLVER","PETER J ABAIR","Democrat",0.653200925568839,95795,242955,0.394291123870676
2000,"MASSACHUSETTS",4,200638,56553,283381,"BARNEY FRANK","MARTIN D TRAVIS","Democrat",0.708015004534531,144085,257191,0.560225668860886
2000,"MASSACHUSETTS",6,205324,83501,303845,"JOHN F TIERNEY","PAUL MCCARTHY","Democrat",0.675752439566226,121823,288825,0.421788280100407
2000,"MASSACHUSETTS",9,193020,48672,271069,"JOHN JOSEPH MOAKLEY","JANET E JEGHELIAN","Democrat",0.712069620650093,144348,241692,0.59723946179435
2000,"MASSACHUSETTS",10,234675,81192,332791,"WILLIAM D DELAHUNT","ERIC V BLEICKEN","Democrat",0.705172315357086,153483,315867,0.48591020904368
2000,"MICHIGAN",1,169649,117300,290569,"BART STUPAK","CHUCK YOB","Democrat",0.583850995804783,52349,286949,0.182433115292264
2000,"MICHIGAN",2,96370,186762,289925,"BOB SHRAUGER","PETER HOEKSTRA","Republican",0.644173493144779,-90392,283132,-0.319257448822457
2000,"MICHIGAN",3,91309,179539,276263,"TIMOTHY W STEELE","VERNON J EHLERS","Republican",0.649884349333787,-88230,270848,-0.325754666824197
2000,"MICHIGAN",4,78019,182128,267819,"LAWRENCE D HOLLENBECK","DAVE CAMP","Republican",0.680041371224596,-104109,260147,-0.400192967822039
2000,"MICHIGAN",5,184048,59274,247737,"JAMES A BARCIA","RONALD G ACTIS","Democrat",0.742916883630624,124774,243322,0.512793746558059
2000,"MICHIGAN",6,68532,159373,234640,"JAMES BUPP","FRED UPTON","Republican",0.67922349130583,-90841,227905,-0.398591518395823
2000,"MICHIGAN",7,86080,147369,241010,"JENNIE CRITTENDON","NICK SMITH","Republican",0.611464254595245,-61289,233449,-0.262536999515954
2000,"MICHIGAN",8,145019,145179,297533,"DIANNE BYRUM","MIKE ROGERS","Republican",0.48794251393963,-160,290198,-0.000551347700535496
2000,"MICHIGAN",9,158184,92926,258928,"DALE E KILDEE","GRANT GARRETT","Democrat",0.610918865476117,65258,251110,0.259878141053721
2000,"MICHIGAN",10,181818,93713,282269,"DAVID E BONIOR","TOM TURNER","Democrat",0.644130244553954,88105,275531,0.319764382229223
2000,"MICHIGAN",11,124053,170790,306302,"MATTHEW FRUMIN","JOE KNOLLENBERG","Republican",0.557586956663685,-46737,294843,-0.158514870626062
2000,"MICHIGAN",12,157720,78795,245169,"SANDER M LEVIN","BART BARON","Democrat",0.643311348498383,78925,236515,0.333699765342579
2000,"MICHIGAN",13,160084,79445,247521,"LYNN N RIVERS","CARL F BERRY","Democrat",0.646749164717337,80639,239529,0.336656521757282
2000,"MICHIGAN",14,168982,17582,189707,"JOHN CONYERS JR","WILLIAM A ASHE","Democrat",0.890752581612697,151400,186564,0.811517763341266
2000,"MICHIGAN",15,140609,14336,158751,"CAROLYN C KILPATRICK","CHRYSANTHEA D BOYD-FIELDS","Democrat",0.885720404910835,126273,154945,0.814953693245991
2000,"MICHIGAN",16,167142,62469,235517,"JOHN D DINGELL","WILLIAM MORSE","Democrat",0.70968125443174,104673,229611,0.455871016632478
2000,"MISSISSIPPI",1,59763,145967,209040,"JOE T ""JOEY"" GRIST JR","ROGER F WICKER","Republican",0.698273057787983,-86204,205730,-0.419015214115588
2000,"MISSISSIPPI",2,112777,54090,173307,"BENNIE G THOMPSON","HARDY CARAWAY","Democrat",0.650735400185797,58687,166867,0.351699257492494
2000,"MISSISSIPPI",3,54151,153899,210363,"WILLIAM CLAY THRASH","CHARLES W ""CHIP"" PICKERING","Republican",0.73158777921973,-99748,208050,-0.47944244172074
2000,"MISSISSIPPI",4,115732,79218,199034,"RONNIE SHOWS","DUNN LAMPTON","Democrat",0.581468492820322,36514,194950,0.187299307514747
2000,"MISSISSIPPI",5,153264,35309,194395,"GENE TAYLOR","RANDY MCDONNELL","Democrat",0.788415339900718,117955,188573,0.62551372677955
2000,"MISSOURI",1,149173,42730,198347,"WILLIAM LACY CLAY","Z DWIGHT BILLINGSLY","Democrat",0.752080949043847,106443,191903,0.554670849335341
2000,"MISSOURI",2,126441,164926,298062,"TED HOUSE","TODD AKIN","Republican",0.553327831122384,-38485,291367,-0.132084278590232
2000,"MISSOURI",3,147222,100967,254539,"RICHARD A GEPHARDT","BILL FEDERER","Democrat",0.578386809094088,46255,248189,0.186370064749042
2000,"MISSOURI",4,180634,84406,269889,"IKE SKELTON","JIM NOLAND","Democrat",0.66928996735695,96228,265040,0.363069725324479
2000,"MISSOURI",5,159826,66439,232137,"KAREN MCCARTHY","STEVE GORDON","Democrat",0.688498602118576,93387,226265,0.412732857490111
2000,"MISSOURI",6,127792,138925,273201,"STEVE DANNER","SAMUEL B ""SAM"" GRAVES JR","Republican",0.50850838759741,-11133,266717,-0.0417408714105213
2000,"MISSOURI",7,65510,202305,273937,"CHARLES CHRISTRUP","ROY BLUNT","Republican",0.738509219273045,-136795,267815,-0.510781696320221
2000,"MISSOURI",8,67760,162239,234066,"BOB CAMP","JO ANN EMERSON","Republican",0.693133560619654,-94479,229999,-0.410780046869769
2000,"MISSOURI",9,111662,172787,291610,"STEVEN R CARROLL","KENNY C HULSHOF","Republican",0.59252769109427,-61125,284449,-0.214889136541173
2000,"MONTANA",0,189971,211418,410521,"NANCY KEENAN","DENNIS REHBERG","Republican",0.514999232682372,-21447,401389,-0.0534319575274858
2000,"NEBRASKA",1,72859,155485,234698,"ALAN JACOBSEN","DOUG BEREUTER","Republican",0.662489667572796,-82626,228344,-0.361848789545598
2000,"NEBRASKA",2,70268,148911,226280,"SHELLEY KIEL","LEE TERRY","Republican",0.658082906133993,-78643,219179,-0.358807184994913
2000,"NEBRASKA",3,34944,182117,222093,"ROLAND E REYNOLDS","TOM OSBORNE","Republican",0.820003331937522,-147173,217061,-0.678025992693298
2000,"NEVADA",1,118469,101276,229235,"SHELLEY BERKLEY","JON PORTER","Democrat",0.516801535542129,17193,219745,0.0782406880702633
2000,"NEVADA",2,106379,229608,357418,"TIERNEY CAHILL","JIM GIBBONS","Republican",0.642407489270266,-123229,335987,-0.366767166586802
2000,"NEW HAMPSHIRE",1,128387,150609,284709,"MARTHA FULLER CLARK","JOHN E SUNUNU","Republican",0.528992761029683,-22222,278996,-0.0796498874535836
2000,"NEW HAMPSHIRE",2,110367,152581,271340,"BARNEY BRANNEN","CHARLES F BASS","Republican",0.562324021522813,-42214,262948,-0.160541247699165
2000,"NEW JERSEY",1,167327,46455,219612,"ROBERT E ANDREWS","CHARLENE CATHCART","Democrat",0.761921024352039,120872,213782,0.565398396497366
2000,"NEW JERSEY",2,74632,155187,233859,"EDWARD G JANOSIK","FRANK A LOBIONDO","Republican",0.663592164509384,-80555,229819,-0.350514970476766
2000,"NEW JERSEY",3,112848,157053,274083,"SUSAN BASS LEVIN","JIM SAXTON","Republican",0.573012554591128,-44205,269901,-0.163782275723321
2000,"NEW JERSEY",4,87956,158515,250810,"REED GUSCIORA","CHRISTOPHER H SMITH","Republican",0.632012280212113,-70559,246471,-0.286277087365248
2000,"NEW JERSEY",5,81715,175546,268524,"LINDA A MERCURIO","MARGE ROUKEMA","Republican",0.653744171843113,-93831,257261,-0.36473075981202
2000,"NEW JERSEY",6,141698,62454,209852,"FRANK PALLONE JR","BRIAN T KENNEDY","Democrat",0.675228256104302,79244,204152,0.388161761824523
2000,"NEW JERSEY",7,113479,128434,248999,"MARYANNE CONNELLY","MIKE FERGUSON","Republican",0.515801268278186,-14955,241913,-0.0618197451149794
2000,"NEW JERSEY",8,134074,60606,200132,"BILL PASCRELL JR","ANTHONY FUSCO JR","Democrat",0.66992784762057,73468,194680,0.377378261762893
2000,"NEW JERSEY",9,140462,61984,206771,"STEVEN R ROTHMAN","JOSEPH TEDESCHI","Democrat",0.679311895768749,78478,202446,0.387649052092904
2000,"NEW JERSEY",10,133073,18436,152045,"DONALD M PAYNE","DIRK B WEBER","Democrat",0.87522115163274,114637,151509,0.756634919377727
2000,"NEW JERSEY",11,80958,186140,273838,"JOHN P SCOLLO","RODNEY P FRELINGHUYSEN","Republican",0.679744958698208,-105182,267098,-0.393795535720971
2000,"NEW JERSEY",12,146162,145511,299942,"RUSH D HOLT","DICK ZIMMER","Democrat",0.48730087816978,651,291673,0.00223195153476667
2000,"NEW JERSEY",13,117856,27849,149766,"ROBERT MENENDEZ","THERESA DE LEON","Democrat",0.786934284149941,90007,145705,0.617734463470711
2000,"NEW MEXICO",1,92187,107296,213139,"JOHN J KELLY","HEATHER WILSON","Republican",0.503408573747648,-15109,199483,-0.0757407899420001
2000,"NEW MEXICO",2,72614,100742,173356,"MICHAEL A MONTOYA","JOE SKEEN","Republican",0.581127852511595,-28128,173356,-0.162255705023189
2000,"NEW MEXICO",3,135040,65979,201019,"TOM UDALL","LISA L LUTZ","Democrat",0.671777294683587,69061,201019,0.343554589367174
2000,"NEW YORK",1,97299,111003,269178,"REGINA SELTZER","FELIX J GRUCCI JR","Republican",0.412377683168758,-13704,208302,-0.0657890946798398
2000,"NEW YORK",2,90438,65880,226228,"STEVE ISRAEL","JOAN B JOHNSON","Democrat",0.39976483901197,24558,156318,0.157102828848885
2000,"NEW YORK",3,91948,122820,280477,"DAL LAMAGNA","PETER T KING","Republican",0.437896868548936,-30872,214768,-0.143745809431573
2000,"NEW YORK",4,128688,75650,253959,"CAROLYN MCCARTHY","GREGORY R BECKER","Democrat",0.506727463881965,53038,204338,0.259560140551439
2000,"NEW YORK",5,127233,56046,244628,"GARY L ACKERMAN","EDWARD ELKOWITZ","Democrat",0.52010808247625,71187,183279,0.388407837231761
2000,"NEW YORK",7,78207,24592,153374,"JOSEPH CROWLEY","ROSE ROBIES BIRTLEY","Democrat",0.509910415063831,53615,102799,0.521551766067763
2000,"NEW YORK",8,139936,27057,227602,"JERROLD NADLER","MARIAN S HENRY","Democrat",0.614827637718473,112879,166993,0.67595048894265
2000,"NEW YORK",9,96348,40866,184075,"ANTHONY D WEINER","NOACH DEAR","Democrat",0.523417085427136,55482,137214,0.404346495255586
2000,"NEW YORK",10,118812,6852,178716,"EDOLPHUS TOWNS","ERNESTINE M BROWN","Democrat",0.664808970657356,111960,125664,0.890947288006112
2000,"NEW YORK",11,105321,7088,164457,"MAJOR R OWENS","SUSAN CLEARY","Democrat",0.640416643864354,98233,112409,0.873889101406471
2000,"NEW YORK",12,81699,10052,134060,"NYDIA M VELAZQUEZ","ROSEMARY MARKGRAF","Democrat",0.609421154706848,71647,91751,0.780885221959434
2000,"NEW YORK",13,55763,95696,200523,"KATINA M JOHNSTONE","VITO FOSSELLA","Republican",0.477232038220055,-39933,151459,-0.263655510732277
2000,"NEW YORK",14,143809,45453,242213,"CAROLYN B MALONEY","C ADRIENNE RHODES","Democrat",0.59372948603089,98356,189262,0.519681711067198
2000,"NEW YORK",15,124415,6906,175726,"CHARLES B RANGEL","JOSE AGUSTIN SUERO","Democrat",0.708005645152112,117509,131321,0.894822610245125
2000,"NEW YORK",16,100891,3943,140369,"JOSE E SERRANO","AARON JUSTICE","Democrat",0.718755565687581,96948,104834,0.924776313028216
2000,"NEW YORK",17,112748,11513,165769,"ELIOT L ENGEL","PATRICK MCMANUS","Democrat",0.680151294874192,101235,124261,0.814696485623003
2000,"NEW YORK",18,126878,52923,228247,"NITA M LOWEY","JOHN G VONGLIS","Democrat",0.55588025253344,73955,179801,0.411315843627121
2000,"NEW YORK",19,82082,133963,267331,"LARRY OTIS GRAHAM","SUE W KELLY","Republican",0.501112852605945,-51881,216045,-0.240139785692795
2000,"NEW YORK",20,87602,136016,268508,"PAUL J FEINER","BENJAMIN A GILMAN","Republican",0.50656218809123,-48414,223618,-0.216503143754081
2000,"NEW YORK",21,157773,60333,267412,"MICHAEL R MCNULTY","THOMAS G PILLSWORTH","Democrat",0.589999700836163,97440,218106,0.446755247448488
2000,"NEW YORK",22,72640,153997,283505,"KENNETH F MCCALLION","JOHN E SWEENEY","Republican",0.543189714467117,-81357,226637,-0.358974924659257
2000,"NEW YORK",23,38049,110634,223411,"RICHARD W ENGLEBRECHT","SHERWOOD L BOEHLERT","Republican",0.495203906701102,-72585,148683,-0.48818627549888
2000,"NEW YORK",24,41719,128513,221394,"NEIL P TALLON","JOHN M MCHUGH","Republican",0.580471918841522,-86794,170232,-0.509857136143616
2000,"NEW YORK",25,64533,132120,253763,"FRANCIS J GAVIN","JAMES T WALSH","Republican",0.520643277388745,-67587,196653,-0.343686595170173
2000,"NEW YORK",26,124862,78103,246203,"MAURICE D HINCHEY","BOB MOPPERT","Democrat",0.507150603363891,46759,202965,0.230379622102333
2000,"NEW YORK",27,69870,144011,281394,"THOMAS W PECORARO","THOMAS M REYNOLDS","Republican",0.511777081245513,-74141,213881,-0.346646032139367
2000,"NEW YORK",28,151688,67251,255383,"LOUISE MCINTOSH SLAUGHTER","MARK C JOHNS","Democrat",0.593962793138149,84437,218939,0.385664500157578
2000,"NEW YORK",29,115685,68958,246988,"JOHN J LAFALCE","BRETT M SOMMER","Democrat",0.468383079339887,46727,184643,0.253066728768488
2000,"NEW YORK",30,62378,113638,249332,"JOHN FEE","JACK QUINN","Republican",0.455769816950893,-51260,176016,-0.291223525134079
2000,"NEW YORK",31,45193,143584,238829,"KISUN J PETERS","AMO HOUGHTON","Republican",0.6012000217729,-98391,188777,-0.521202265106448
2000,"NORTH CAROLINA",1,124171,62198,189168,"EVA M CLAYTON","DUANE E KRATZER JR","Democrat",0.656405946037385,61973,186369,0.332528478448669
2000,"NORTH CAROLINA",2,146733,103011,251838,"BOB ETHERIDGE","DOUG HAYNES","Democrat",0.582648369189717,43722,249744,0.175067268883337
2000,"NORTH CAROLINA",3,74058,121940,198455,"LEIGH HARVEY MCNAIRY","WALTER B JONES","Republican",0.614446599984883,-47882,195998,-0.244298411208278
2000,"NORTH CAROLINA",4,200885,119412,325870,"DAVID E PRICE","JESS WARD","Democrat",0.616457483045386,81473,320297,0.254367040590452
2000,"NORTH CAROLINA",7,160185,66463,229666,"MIKE MCINTYRE","JAMES R ADAMS","Democrat",0.697469368561302,93722,226648,0.413513465814832
2000,"NORTH CAROLINA",8,89505,111950,203464,"MIKE TAYLOR","ROBERT C ""ROBIN"" HAYES","Republican",0.550220186372036,-22445,201455,-0.111414459804919
2000,"NORTH CAROLINA",9,79382,181161,264220,"ED MCGUIRE","SUE WILKINS MYRICK","Republican",0.685644538642041,-101779,260543,-0.390641851824843
2000,"NORTH CAROLINA",10,70877,164182,240658,"DELMAS PARKER","CASS BALLENGER","Republican",0.682221243424278,-93305,235059,-0.396942895188017
2000,"NORTH CAROLINA",11,112234,146677,266377,"SAM NEILL","CHARLES H TAYLOR","Republican",0.550636879310151,-34443,258911,-0.133030269088606
2000,"NORTH CAROLINA",12,135570,69596,209144,"MELVIN L WATT","CHAD MITCHELL","Democrat",0.648213670963547,65974,205166,0.321564001832662
2000,"NORTH DAKOTA",0,151173,127251,285658,"EAR POMEROY","JOHN DORSO","Democrat",0.529209754321601,23922,278424,0.0859193173002327
2000,"OHIO",1,98328,116768,220428,"JOHN CRANLEY","STEVE CHABOT","Republican",0.529733064764912,-18440,215096,-0.0857291627924276
2000,"OHIO",2,64091,204184,277541,"CHARLES W SANDERS","ROB PORTMAN","Republican",0.735689501731276,-140093,268275,-0.522199235858727
2000,"OHIO",4,67330,156510,232118,"DANIEL L DICKMAN","MICHAEL G OXLEY","Republican",0.674269121739805,-89180,223840,-0.398409578270193
2000,"OHIO",5,62138,169857,243340,"DANNIE EDMON","PAUL E GILLMOR","Republican",0.698023341826251,-107719,231995,-0.464316041293993
2000,"OHIO",6,138849,96966,240574,"TED STRICKLAND","MIKE AZINGER","Democrat",0.577157132524712,41883,235815,0.177609566821449
2000,"OHIO",7,60755,163646,242186,"DONALD E MINOR","DAVID L HOBSON","Republican",0.675703797907394,-102891,224401,-0.458513999491981
2000,"OHIO",8,66293,179756,253303,"JOHN G PARKS","JOHN A BOEHNER","Republican",0.7096481289207,-113463,246049,-0.461139854256672
2000,"OHIO",9,168547,49446,225328,"MARCY KAPTUR","DWIGHT E BRYAN","Democrat",0.748007349286374,119101,217993,0.546352405811196
2000,"OHIO",10,167063,48930,222755,"DENNIS J KUCINICH","BILL SMITH","Democrat",0.749985409979574,118133,215993,0.546929761612645
2000,"OHIO",11,164134,21630,193519,"STEPHANIE TUBBS JONES","JAMES J SYKORA","Democrat",0.8481544447832,142504,185764,0.767123877608148
2000,"OHIO",12,115432,139242,263386,"MARYELLEN O'SHAUGHNESSY","PAT TIBERI","Republican",0.528661356336328,-23810,254674,-0.0934920722178157
2000,"OHIO",13,170058,84295,263298,"SHERROD BROWN","RICK H JERIC","Democrat",0.645876535332589,85763,254353,0.337181004352219
2000,"OHIO",14,149184,71432,230088,"TOM SAWYER","RICK WOOD","Democrat",0.648378011891103,77752,220616,0.352431373971063
2000,"OHIO",15,64805,156792,232297,"BILL BUCKEL","DEBORAH PRYCE","Republican",0.674963516532715,-91987,221597,-0.415109410325952
2000,"OHIO",16,62709,162294,234400,"WILLIAM SMITH","RALPH REGULA","Republican",0.692380546075085,-99585,225003,-0.44259409874535
2000,"OHIO",17,120333,54751,240877,"JAMES A TRAFICANT JR","PAUL H ALBERTY","Democrat",0.499562017129074,65582,175084,0.374574489959105
2000,"OHIO",18,79232,152325,236505,"MARC D GUTHRIE","ROBERT W NEY","Republican",0.644066721633792,-73093,231557,-0.315658779479782
2000,"OHIO",19,101842,206639,318848,"DALE VIRGIL BLANCHARD","STEVEN C LATOURETTE","Republican",0.648079962866319,-104797,308481,-0.339719464083687
2000,"OKLAHOMA",1,58493,138528,200005,"DAN LOWE","STEVE LARGENT","Republican",0.692622684432889,-80035,197021,-0.406225732282346
2000,"OKLAHOMA",2,107273,81672,195412,"BRAD CARSON","ANDY EWING","Democrat",0.548958098786154,25601,188945,0.135494456058641
2000,"OKLAHOMA",4,54808,114000,175684,"LARRY WEATHERFORD","J C WATTS JR","Republican",0.648892329409622,-59192,168808,-0.350646888773044
2000,"OKLAHOMA",5,53275,134159,196022,"GARLAND MCWATTERS","ERNEST J ISTOOK JR","Republican",0.68440787258573,-80884,187434,-0.43153323303136
2000,"OKLAHOMA",6,63106,95635,161176,"RANDY BEUTLER","FRANK D LUCAS","Republican",0.593357571846925,-32529,158741,-0.204918704052513
2000,"OREGON",1,176902,115303,303521,"DAVID WU","CHARLES STARR","Democrat",0.58283281881649,61599,292205,0.210807481049263
2000,"OREGON",2,78101,220086,298907,"WALTER PONSFORD","GREG WALDEN","Republican",0.736302595790664,-141985,298187,-0.47616093256916
2000,"OREGON",3,181049,64128,271161,"EARL BLUMENAUER","JEFFERY L POLLOCK","Democrat",0.66768082430733,116921,245177,0.476884047035407
2000,"OREGON",4,197998,88950,291065,"PETER A DEFAZIO","JOHN LINDSEY","Democrat",0.680253551612183,109048,286948,0.380027043227344
2000,"OREGON",5,156315,118631,275348,"DARLENE HOOLEY","BRIAN J BOQUIST","Democrat",0.567699783546639,37684,274946,0.137059640802194
2000,"PENNSYLVANIA",1,149621,19920,169541,"ROBERT A BRADY","STEVEN N KUSH","Democrat",0.882506296412077,129701,169541,0.765012592824155
2000,"PENNSYLVANIA",3,130528,59343,189871,"ROBERT A BORSKI","CHARLES F DOUGHERTY","Democrat",0.687456220275871,71185,189871,0.374912440551743
2000,"PENNSYLVANIA",4,100995,145390,246385,"TERRY E VAN HORNE","MELISSA HART","Republican",0.590092741035371,-44395,246385,-0.180185482070743
2000,"PENNSYLVANIA",6,140084,71227,211311,"TIM HOLDEN","THOMAS G KOPEL","Democrat",0.662928101234673,68857,211311,0.325856202469346
2000,"PENNSYLVANIA",7,93687,172569,266256,"PETER A LENNON","CURT WELDON","Republican",0.64813187308455,-78882,266256,-0.2962637461691
2000,"PENNSYLVANIA",8,100617,154090,260101,"RONALD L STROUSE","JAMES C GREENWOOD","Republican",0.592423712327134,-53473,254707,-0.209939263545957
2000,"PENNSYLVANIA",10,112580,124830,237410,"PAT CASEY","DON SHERWOOD","Republican",0.525799250242197,-12250,237410,-0.0515985004843941
2000,"PENNSYLVANIA",11,131948,66699,198647,"PAUL E KANJORSKI","STEPHEN A URBAN","Democrat",0.664233539897406,65249,198647,0.328467079794812
2000,"PENNSYLVANIA",12,145538,56575,205437,"JOHN P MURTHA","BILL CHOBY","Democrat",0.70843129523893,88963,202113,0.440164660363262
2000,"PENNSYLVANIA",13,146026,126501,276751,"JOSEPH M HOEFFEL","STEWART J GREENLEAF","Democrat",0.527643983219573,19525,272527,0.0716442774477391
2000,"PENNSYLVANIA",15,103864,118307,222171,"ED O'BRIEN","PATRICK J TOOMEY","Republican",0.532504242227834,-14443,222171,-0.065008484455667
2000,"PENNSYLVANIA",16,80177,162403,242580,"BOB YORCZYK","JOSEPH R PITTS","Republican",0.669482232665512,-82226,242580,-0.338964465331025
2000,"PENNSYLVANIA",17,66190,166236,232426,"LESLYE HESS HERRMANN","GEORGE W GEKAS","Republican",0.715221188679408,-100046,232426,-0.430442377358815
2000,"PENNSYLVANIA",18,156131,68798,224929,"MICHAEL F DOYLE","CRAIG C STEPHENS","Democrat",0.694134593582864,87333,224929,0.388269187165728
2000,"PENNSYLVANIA",19,61538,168722,232494,"JEFF SANDERS","TODD PLATTS","Republican",0.725704749369876,-107184,230260,-0.465491183879093
2000,"PENNSYLVANIA",20,145131,80312,225443,"FRANK MASCARA","RONALD J DAVIS","Democrat",0.643759176377177,64819,225443,0.287518352754355
2000,"PENNSYLVANIA",21,87018,135164,222182,"MARC A FLITTER","PHIL ENGLISH","Republican",0.608348111008092,-48146,222182,-0.216696222016185
2000,"RHODE ISLAND",1,123442,61522,185251,"PATRICK J KENNEDY","STEPHEN CABRAL","Democrat",0.666349979217386,61920,184964,0.334767846716118
2000,"RHODE ISLAND",2,123805,27932,199021,"JAMES R LANGEVIN","ROBERT G TINGLE","Democrat",0.622070032810608,95873,151737,0.631836664755465
2000,"SOUTH CAROLINA",1,82622,139597,231446,"ANDY BRACK","HENRY BROWN","Republican",0.60315149106055,-56975,222219,-0.256391217672656
2000,"SOUTH CAROLINA",2,110672,154338,270976,"JANE FREDERICK","FLOYD SPENCE","Republican",0.569563356164384,-43666,265010,-0.164771140711671
2000,"SOUTH CAROLINA",3,64917,150180,221621,"GEORGE BRIGHTHARP","LINDSEY O GRAHAM","Republican",0.677643364121631,-85263,215097,-0.396393255136055
2000,"SOUTH CAROLINA",5,126877,85247,215838,"JOHN M SPRATT JR","CARL L GULLICK","Democrat",0.587834394314254,41630,212124,0.196253134958798
2000,"SOUTH CAROLINA",6,138053,50005,192380,"JAMES E CLYBURN","VINCE ELLISON","Democrat",0.717605780226635,88048,188058,0.468195982090632
2000,"SOUTH DAKOTA",0,78321,231083,314761,"CURT HOHN","JOHN R THUNE","Republican",0.734153850064017,-152762,309404,-0.493729880673812
2000,"TENNESSEE",3,75785,139840,218940,"WILLIAM L CALLAWAY","ZACH WAMP","Republican",0.638713802868366,-64055,215625,-0.297066666666667
2000,"TENNESSEE",4,67165,133622,203210,"DAVID H DUNAWAY","VAN HILLEARY","Republican",0.657556222626839,-66457,200787,-0.330982583533795
2000,"TENNESSEE",5,149277,50386,205933,"BOB CLEMENT","STAN SCOTT","Democrat",0.724881393462922,98891,199663,0.495289562913509
2000,"TENNESSEE",6,168861,97169,271899,"BART GORDON","DAVID CHARLES","Democrat",0.621043107918749,71692,266030,0.269488403563508
2000,"TENNESSEE",7,71587,171056,245649,"RICHARD P SIMS","ED BRYANT","Republican",0.696343156292108,-99469,242643,-0.409939705658107
2000,"TENNESSEE",8,143127,54929,198080,"JOHN S TANNER","BILLY YANCY","Democrat",0.722571688206785,88198,198056,0.445318495778972
2000,"TEXAS",1,118157,91912,211848,"MAX SANDLIN","NOBLE WILLINGHAM","Democrat",0.557744231713304,26245,210069,0.124935140358644
2000,"TEXAS",3,67233,187486,261897,"BILLY WAYNE ZACHARY","SAM JOHNSON","Republican",0.715876852350351,-120253,254719,-0.472100628535759
2000,"TEXAS",4,145887,91574,241878,"RALPH M HALL","JON NEWTON","Democrat",0.603142906754645,54313,237461,0.228723874657312
2000,"TEXAS",5,82629,100487,185958,"REGINA MONTOYA COGGINS","PETE SESSIONS","Republican",0.540374708267458,-17858,183116,-0.097522881670635
2000,"TEXAS",7,60694,183712,248593,"JEFF SELL","JOHN CULBERSON","Republican",0.739007132139682,-123018,244406,-0.503334615353142
2000,"TEXAS",9,130143,87165,219816,"NICK LAMPSON","PAUL WILLIAMS","Democrat",0.592054263565892,42978,217308,0.197774587221823
2000,"TEXAS",11,105782,85546,192918,"CHET EDWARDS","RAMSEY FARLEY","Democrat",0.548326231870536,20236,191328,0.105766014383676
2000,"TEXAS",12,67612,117739,187916,"MARK GREENE","KAY GRANGER","Republican",0.626551225015432,-50127,185351,-0.270443644760481
2000,"TEXAS",13,54343,117995,174475,"CURTIS CLINESMITH","MAC THORNBERRY","Republican",0.676286000859722,-63652,172338,-0.369343963606401
2000,"TEXAS",14,92689,137370,230059,"LOY SNEARY","RON PAUL","Republican",0.59710769845996,-44681,230059,-0.194215396919921
2000,"TEXAS",16,92649,40921,135650,"SILVESTRE REYES","DANIEL S POWER","Democrat",0.683000368595651,51728,133570,0.387272591150708
2000,"TEXAS",17,120670,72535,204430,"CHARLES W STENHOLM","DARRELL CLEMENTS","Democrat",0.590275399892384,48135,193205,0.249139515022903
2000,"TEXAS",18,131857,38191,172378,"SHEILA JACKSON-LEE","BOB LEVY","Democrat",0.764929399343304,93666,170048,0.550820944674445
2000,"TEXAS",21,73326,251049,330878,"JIM GREEN","LAMAR S SMITH","Republican",0.75873584825827,-177723,324375,-0.547893641618497
2000,"TEXAS",22,92645,154662,256267,"JO ANN MATRANGA","TOM DELAY","Republican",0.60351898605751,-62017,247307,-0.250769286756946
2000,"TEXAS",23,78274,119679,201754,"ISIDRO GARZA JR","HENRY BONILLA","Republican",0.593192700020817,-41405,197953,-0.209165812086707
2000,"TEXAS",24,103152,61235,166948,"MARTIN FROST","JAMES ""BRYNDAN"" WRIGHT","Democrat",0.617869037065434,41917,164387,0.254989749797733
2000,"TEXAS",25,106112,68010,176522,"KEN BENTSEN","PHIL SUDAN","Democrat",0.601126205232209,38102,174122,0.218823583464467
2000,"TEXAS",26,75601,214025,295272,"STEVE LOVE","RICHARD K ARMEY","Republican",0.724840147389526,-138424,289626,-0.477940516390103
2000,"TEXAS",27,102088,54660,161072,"SOLOMON P ORTIZ","PAT AHUMADA","Democrat",0.633803516439853,47428,156748,0.302574833490698
2000,"TEXAS",29,84665,29606,115475,"GENE GREEN","JOE VU","Democrat",0.733189001948474,55059,114271,0.481828285391744
2000,"UTAH",1,71229,180591,261805,"KATHLEEN MCCONKIE COLLINWOOD","JAMES V HANSEN","Republican",0.689792020778824,-109362,251820,-0.434286395044079
2000,"UTAH",2,145021,107114,259601,"JIM MATHESON","DEREK W SMITH","Democrat",0.558630359667336,37907,252135,0.150344061712971
2000,"UTAH",3,88547,138943,237348,"DONALD DUNN","CHRIS CANNON","Republican",0.585397812494733,-50396,227490,-0.221530616730406
2000,"VERMONT",0,14918,51977,283366,"PETE DIAMONDSTONE","KAREN ANN KERIN","Republican",0.183427087229943,-37059,66895,-0.553987592495702
2000,"VIRGINIA",1,97399,151344,263014,"LAWRENCE A DAVIES","JO ANN S DAVIS","Republican",0.575421840662474,-53945,248743,-0.216870424494358
2000,"VIRGINIA",2,90328,97856,188329,"JODY M WAGNER","EDWARD L ""ED"" SCHROCK","Republican",0.519601335959942,-7528,188184,-0.0400034009267525
2000,"VIRGINIA",7,94935,192652,287891,"WARREN A STEWART","ERIC I CANTOR","Republican",0.669183823044138,-97717,287587,-0.339782396283559
2000,"VIRGINIA",8,164178,88262,259199,"JAMES P MORAN","DEMARIS H MILLER","Democrat",0.633405221470762,75916,252440,0.300728886071938
2000,"VIRGINIA",9,137488,59335,196855,"RICK BOUCHER","MICHAEL D ""OZ"" OSBORNE","Democrat",0.698422696908892,78153,196823,0.397072496608628
2000,"VIRGINIA",11,83455,150395,242968,"M L ""MIKE"" CORRIGAN","THOMAS M DAVIS","Republican",0.618990978235817,-66940,233850,-0.286251870857387
2000,"WASHINGTON",1,155820,121823,285636,"JAY INSLEE","DAN MCDONALD","Democrat",0.54551947233542,33997,277643,0.122448612066575
2000,"WASHINGTON",2,146617,134660,293180,"RICK LARSEN","JOHN KOSTER","Democrat",0.500092093594379,11957,281277,0.0425096968468805
2000,"WASHINGTON",3,159428,114861,282664,"BRIAN BAIRD","TRENT R MATSON","Democrat",0.56401947188181,44567,274289,0.162481907768813
2000,"WASHINGTON",4,87585,143259,235104,"JIM DAVIS","DOC HASTINGS","Republican",0.609343099224173,-55674,230844,-0.241175859021677
2000,"WASHINGTON",5,97703,144038,251214,"TOM KEEFE","GEORGE R NETHERCUTT JR","Republican",0.573367726320985,-46335,241741,-0.191672078795074
2000,"WASHINGTON",6,164853,79215,254713,"NORMAN D DICKS","BOB LAWRENCE","Democrat",0.647210782331487,85638,244068,0.350877624268646
2000,"WASHINGTON",8,104944,183255,294468,"HEIDI BEHRENS-BENEDICT","JENNIFER DUNN","Republican",0.622325685643262,-78311,288199,-0.271725439713531
2000,"WASHINGTON",9,135452,76766,219623,"ADAM SMITH","CHRIS VANCE","Democrat",0.616747790531957,58686,212218,0.276536391823502
2000,"WEST VIRGINIA",2,103003,108769,224315,"JIM HUMPHREYS","SHELLEY MOORE CAPITO","Republican",0.48489401065466,-5766,211772,-0.0272273955008216
2000,"WISCONSIN",1,88885,177612,266791,"JEFFREY C THOMAS","PAUL RYAN","Republican",0.665734601242171,-88727,266497,-0.33293808185458
2000,"WISCONSIN",2,163534,154632,318380,"TAMMY BALDWIN","JOHN SHARPLESS","Democrat",0.513644073120171,8902,318166,0.0279791052469466
2000,"WISCONSIN",3,173505,97741,272212,"RON KIND","SUSAN TULLY","Democrat",0.637389240738836,75764,271246,0.279318404695369
2000,"WISCONSIN",4,163622,101811,269265,"GERALD D KLECZKA","TIM RIENER","Democrat",0.607661597311199,61811,265433,0.232868558167221
2000,"WISCONSIN",5,173893,49296,223852,"THOMAS M BARRETT","JONATHAN SMITH","Democrat",0.77682129263978,124597,223189,0.558257799443521
2000,"WISCONSIN",6,96125,179205,275605,"DAN FLAHERTY","THOMAS E PETRI","Republican",0.65022405253896,-83080,275330,-0.301746994515672
2000,"WISCONSIN",7,173007,100264,273460,"DAVID R OBEY","SEAN CRONIN","Democrat",0.632659255466979,72743,273271,0.266193631962411
2000,"WISCONSIN",8,71575,211388,283294,"DEAN REICH","MARK GREEN","Republican",0.746178881303522,-139813,282963,-0.494103469358185
2000,"WISCONSIN",9,83720,239498,323455,"MIKE CLAWSON","F JAMES SENSENBRENNER JR","Republican",0.740436845929109,-155778,323218,-0.481959544332308
2000,"WYOMING",0,60638,141848,212312,"MICHAEL ALLEN GREEN","BARBARA CUBIN","Republican",0.668111081804137,-81210,202486,-0.401064764971405
2002,"ALABAMA",1,67507,108102,178687,"JUDY MCCAIN BELK","JO BONNER","Republican",0.604979657165882,-40595,175609,-0.231166967524444
2002,"ALABAMA",2,55495,129233,187965,"CHARLES WOODS","TERRY EVERETT","Republican",0.687537573484425,-73738,184728,-0.399170672556407
2002,"ALABAMA",3,87351,91169,181223,"JOE TURNHAM","MIKE ROGERS","Republican",0.503076320334615,-3818,178520,-0.02138695944432
2002,"ALABAMA",5,143029,48226,195171,"ROBERT E ""BUD"" CRAMER JR","STEPHEN P ENGEL","Democrat",0.732839407493941,94803,191255,0.49568900159473
2002,"ALASKA",0,39357,169685,227725,"CLIFFORD GREENE","DON YOUNG","Republican",0.745131188934021,-130328,209042,-0.623453660030042
2002,"ARIZONA",1,79730,85967,174687,"GEORGE CORDOVA","RICK RENZI","Republican",0.49212019211504,-6237,165697,-0.0376409953107178
2002,"ARIZONA",2,61217,100359,167502,"RANDY COMACHO","TRENT FRANKS","Republican",0.599151054912777,-39142,161576,-0.242251324454127
2002,"ARIZONA",3,47173,104847,155751,"CHARLES HILL","JOHN B SHADEGG","Republican",0.673170637748714,-57674,152020,-0.379384291540587
2002,"ARIZONA",4,44517,18381,66065,"ED PASTOR","JONATHAN BARNERT","Democrat",0.67383637326875,26136,62898,0.415529905561385
2002,"ARIZONA",5,61559,103870,169812,"CRAIG COLUMBUS","J D HAYWORTH","Republican",0.61167644218312,-42311,165429,-0.255765313215942
2002,"ARIZONA",6,49355,103094,156337,"DEBORAH THOMAS","JEFF FLAKE","Republican",0.659434426911096,-53739,152449,-0.352504772087715
2002,"ARIZONA",7,61256,38474,103818,"RAUL M GRIJALVA","ROSS HIEB","Democrat",0.590032556974706,22782,99730,0.228436779304121
2002,"ARIZONA",8,67328,126930,200428,"MARY JUDGE RYAN","JIM KOLBE","Republican",0.633294749236634,-59602,194258,-0.306818766794675
2002,"ARKANSAS",1,129701,64357,194058,"MARION BERRY","TOMMY ROBINSON","Democrat",0.668362036092302,65344,194058,0.336724072184605
2002,"ARKANSAS",4,119633,77904,197537,"MIKE ROSS","JAY DICKEY","Democrat",0.605623250327787,41729,197537,0.211246500655573
2002,"CALIFORNIA",1,118669,60013,185216,"MIKE THOMPSON","LAWRENCE R WIESNER","Democrat",0.640705986523842,58656,178682,0.328270335008563
2002,"CALIFORNIA",2,52455,117747,178985,"MIKE JOHNSON","WALLY HERGER","Republican",0.657859597172948,-65292,170202,-0.3836147636338
2002,"CALIFORNIA",3,67136,121732,194918,"HOWARD BEEMAN","DOUG OSE","Republican",0.624529289239578,-54596,188868,-0.289069614757397
2002,"CALIFORNIA",4,72860,147997,228506,"MARK A NORBERG","JOHN T DOOLITTLE","Republican",0.647672271187627,-75137,220857,-0.340206558995187
2002,"CALIFORNIA",5,92726,34749,131578,"ROBERT T MATSUI","RICHARD FRANKHUIZEN","Democrat",0.704722674003253,57977,127475,0.454810747205334
2002,"CALIFORNIA",6,139750,62052,209563,"LYNN C WOOLSEY","PAUL L ERICKSON","Democrat",0.666863902501873,77698,201802,0.385020961140127
2002,"CALIFORNIA",7,97849,36584,138376,"GEORGE MILLER","CHARLES R HARGRAVE","Democrat",0.707124067757415,61265,134433,0.455728876094411
2002,"CALIFORNIA",8,127684,20063,160441,"NANCY PELOSI","G MICHAEL GERMAN","Democrat",0.795831489457184,107621,147747,0.72841411331533
2002,"CALIFORNIA",9,135893,25333,166917,"BARBARA LEE","JERALD UDINSKY","Democrat",0.814135168976198,110560,161226,0.685745475295548
2002,"CALIFORNIA",11,69035,104921,173956,"ELAINE SHAW","RICHARD W POMBO","Republican",0.603146772747131,-35886,173956,-0.206293545494263
2002,"CALIFORNIA",12,105597,38381,154984,"TOM LANTOS","MICHAEL MOLONEY","Democrat",0.681341299747071,67216,143978,0.466849101946131
2002,"CALIFORNIA",13,86495,26852,121723,"FORTNEY PETE STARK","SYED R MAHMOOD","Democrat",0.710588795872596,59643,113347,0.526198311380098
2002,"CALIFORNIA",14,117055,48346,171678,"ANNA G ESHOO","JOSEPH HENRY NIXON","Democrat",0.68182877246939,68709,165401,0.415408613007177
2002,"CALIFORNIA",15,87482,41251,133022,"MICHAEL M HONDA","LINDA RAE HERMANN","Democrat",0.65765061418412,46231,128733,0.359123146357189
2002,"CALIFORNIA",16,72370,32182,107986,"ZOE LOFGREN","DOUGLAS ADAMS MCNEA","Democrat",0.670179467708777,40188,104552,0.384382890810314
2002,"CALIFORNIA",17,101632,40334,149296,"SAM FARR","CLINT C ENGLER","Democrat",0.680741613974922,61298,141966,0.431779440147641
2002,"CALIFORNIA",18,56181,47528,109593,"DENNIS A CARDOZA","DICK MONTEITH","Democrat",0.512633106129041,8653,103709,0.0834353816930064
2002,"CALIFORNIA",19,47403,106209,157802,"JOHN VEEN","GEORGE RADANOVICH","Republican",0.673052306054423,-58806,153612,-0.382821654558238
2002,"CALIFORNIA",20,47627,25628,74770,"CALVIN M DOOLEY","ANDRE MINUTH","Democrat",0.636980072221479,21999,73255,0.300307146269879
2002,"CALIFORNIA",21,32584,87544,124198,"DAVID G LAPERE","DEVIN NUNES","Republican",0.704874474629221,-54960,120128,-0.457511987213639
2002,"CALIFORNIA",22,38988,120473,164285,"JAIME A CORVERA","WILLIAM M THOMAS","Republican",0.733317101378702,-81485,159461,-0.511002690312992
2002,"CALIFORNIA",23,95752,62604,162222,"LOIS CAPPS","BETH ROGERS","Democrat",0.590252863360087,33148,158356,0.209325822829574
2002,"CALIFORNIA",24,58755,120585,185006,"FERN RUDIN","ELTON GALLEGLY","Republican",0.651789671686324,-61830,179340,-0.344764135162262
2002,"CALIFORNIA",25,38674,80775,124336,"BOB CONAWAY","HOWARD P ""BUCK"" MCKEON","Republican",0.649650945824218,-42101,119449,-0.352460045709885
2002,"CALIFORNIA",26,50081,95360,149530,"MARJORIE MIKELS","DAVID DREIER","Republican",0.637731558884505,-45279,145441,-0.311322116872134
2002,"CALIFORNIA",27,79815,48996,128811,"BRAD SHERMAN","ROBERT M LEVY","Democrat",0.61962875841349,30819,128811,0.239257516826979
2002,"CALIFORNIA",28,73771,23926,103326,"HOWARD L BERMAN","DAVID R HERNANDEZ","Democrat",0.713963571608308,49845,97697,0.510199903784149
2002,"CALIFORNIA",29,76036,40616,121541,"ADAM B SCHIFF","JIM SCILEPPI","Democrat",0.625599591907258,35420,116652,0.303638171655865
2002,"CALIFORNIA",30,130604,54989,185593,"HENRY A WAXMAN","TONY D GOSS","Democrat",0.703711885685344,75615,185593,0.407423771370687
2002,"CALIFORNIA",31,54569,12674,67243,"XAVIER BECERRA","LUIS VEGA","Democrat",0.811519414660262,41895,67243,0.623038829320524
2002,"CALIFORNIA",32,58530,23366,85079,"HILDA L SOLIS","EMMA E FISCHBECK","Democrat",0.687948847541696,35164,81896,0.429373839992185
2002,"CALIFORNIA",33,97779,16699,118449,"DIANE E WATSON","ANDREW KIM","Democrat",0.825494516627409,81080,114478,0.708258355317179
2002,"CALIFORNIA",34,48734,17090,65824,"LUCILLE ROYBAL-ALLARD","WAYNE MILLER","Democrat",0.740368254739913,31644,65824,0.480736509479825
2002,"CALIFORNIA",35,72401,18094,93407,"MAXINE WATERS","ROSS MOEN","Democrat",0.775113214213068,54307,90495,0.600110503342726
2002,"CALIFORNIA",36,88198,50328,143751,"JANE HARMAN","STUART JOHNSON","Democrat",0.613547036194531,37870,138526,0.27337828277724
2002,"CALIFORNIA",37,63445,20154,87012,"JUANITA MILLENDER-MCDONALD","OSCAR A VELASCO","Democrat",0.729152300832069,43291,83599,0.517841122501465
2002,"CALIFORNIA",38,62600,23126,88027,"GRACE F NAPOLITANO","ALEX A BURROLA","Democrat",0.711145444011496,39474,85726,0.460467069500502
2002,"CALIFORNIA",39,52256,38925,95346,"LINDA T SANCHEZ","TIM ESCOBAR","Democrat",0.548067040043631,13331,91181,0.146203704719185
2002,"CALIFORNIA",40,40265,92422,136642,"CHRISTINA AVALOS","EDWARD R ROYCE","Republican",0.676380615037836,-52157,132687,-0.393082969695599
2002,"CALIFORNIA",41,40155,91326,135533,"KEITH ALAN JOHNSON","JERRY LEWIS","Republican",0.67382851408882,-51171,131481,-0.389189312524243
2002,"CALIFORNIA",42,42090,98476,145246,"RICHARD WALDRON","GARY G MILLER","Republican",0.677994574721507,-56386,140566,-0.401135409700781
2002,"CALIFORNIA",43,45374,20821,68340,"JOE BACA","WENDY C NEIGHBOR","Democrat",0.663944980977466,24553,66195,0.37091925372007
2002,"CALIFORNIA",44,38021,76686,120463,"LOUIS VANDENBERG","KEN CALVERT","Republican",0.636593808887376,-38665,114707,-0.337076202847254
2002,"CALIFORNIA",45,43692,87101,133533,"ELLE K KURPIEWSKI","MARY BONO","Republican",0.652280709637318,-43409,130793,-0.331890850427775
2002,"CALIFORNIA",46,60890,108807,176265,"GERRIE SCHIPSKE","DANA ROHRABACHER","Republican",0.617292145349332,-47917,169697,-0.282367985291431
2002,"CALIFORNIA",47,42501,24346,70178,"LORETTA SANCHEZ","JEFF CHAVEZ","Democrat",0.605617144974208,18155,66847,0.271590348108367
2002,"CALIFORNIA",48,51058,122884,179549,"JOHN L GRAHAM","CHRISTOPHER COX","Republican",0.684403700382625,-71826,173942,-0.412930747030619
2002,"CALIFORNIA",50,55855,111095,172701,"DEL G STEWART","RANDY ""DUKE"" CUNNINGHAM","Republican",0.643279425133612,-55240,166950,-0.330877508235999
2002,"CALIFORNIA",51,59541,40430,102787,"BOB FILNER","MARIA GUADALUPE GARCIA","Democrat",0.579265860468736,19111,99971,0.191165437977013
2002,"CALIFORNIA",52,43526,118561,169010,"PETER MOORE-KOCHLACS","DUNCAN HUNTER","Republican",0.701502869652683,-75035,162087,-0.462930401574463
2002,"CALIFORNIA",53,72252,43891,116180,"SUSAN A DAVIS","BILL VANDEWEGHE","Democrat",0.621897056291961,28361,116143,0.244190351549383
2002,"COLORADO",1,111718,49884,168582,"DIANA DEGETTE","KEN CHLOUBER","Democrat",0.662692339632938,61834,161602,0.382631403076695
2002,"COLORADO",2,123504,75564,205522,"MARK UDALL","SANDY HUME","Democrat",0.600928367765981,47940,199068,0.240822231599253
2002,"COLORADO",3,68160,143433,217972,"DENIS BERCKEFELDT","SCOTT MCINNIS","Republican",0.658034059420476,-75273,211593,-0.355744282655853
2002,"COLORADO",4,87499,115359,209955,"STAN MATSUNAKA","MARILYN N MUSGRAVE","Republican",0.549446309923555,-27860,202858,-0.137337447869939
2002,"COLORADO",5,45587,128118,184677,"CURTIS IMRIE","JOEL HEFLEY","Republican",0.693740963953281,-82531,173705,-0.475121614231024
2002,"COLORADO",6,71327,158851,237501,"LANCE WRIGHT","THOMAS G TANCREDO","Republican",0.668843499606317,-87524,230178,-0.38024485398257
2002,"COLORADO",7,81668,81789,172879,"MIKE FEELEY","BOB BEAUPREZ","Republican",0.473099682436849,-121,163457,-0.00074025584710352
2002,"CONNECTICUT",1,134698,66968,201688,"JOHN B LARSON","PHIL STEELE","Democrat",0.667853317996113,67730,201666,0.335852349925124
2002,"CONNECTICUT",2,99674,117434,217108,"JOE COURTNEY","ROB SIMMONS","Republican",0.540901302577519,-17760,217108,-0.0818026051550381
2002,"CONNECTICUT",3,121557,54757,185364,"ROSA L DELAURO","RICHTER ELSER","Democrat",0.65577458406163,66800,176314,0.378869516884649
2002,"CONNECTICUT",4,62491,113197,175695,"STEPHANIE H SANCHEZ","CHRISTOPHER SHAYS","Republican",0.644281282905034,-50706,175688,-0.288613906470561
2002,"CONNECTICUT",5,90616,113626,209454,"JIM MALONEY","NANCY JOHNSON","Republican",0.542486655781222,-23010,204242,-0.112660471401573
2002,"DELAWARE",0,61011,164605,228405,"MICHEAL C MILLER","MICHAEL N CASTLE","Republican",0.720671614018958,-103594,225616,-0.459160697822849
2002,"FLORIDA",1,51972,152635,204626,"BERT ORAM","JEFF MILLER","Republican",0.745921828115684,-100663,204607,-0.491982190247646
2002,"FLORIDA",2,152164,75275,227439,"ALLEN BOYD","TOM MCGURK","Democrat",0.669032136089237,76889,227439,0.338064272178474
2002,"FLORIDA",3,88462,60747,149213,"CORRINE BROWN","JENNIFER CARROLL","Democrat",0.59285719072735,27715,149209,0.185746168126588
2002,"FLORIDA",5,117758,121998,254671,"KAREN L THURMAN","GINNY BROWN-WAITE","Republican",0.479041586988703,-4240,239756,-0.0176846460568244
2002,"FLORIDA",6,75046,141570,216616,"DAVID E BRUDERLY","CLIFF STEARNS","Republican",0.653552830815821,-66524,216616,-0.307105661631643
2002,"FLORIDA",7,96444,142147,238591,"WAYNE HOGAN","JOHN L MICA","Republican",0.595776873394219,-45703,238591,-0.191553746788437
2002,"FLORIDA",8,66099,123497,189596,"EDDIE DIAZ","RIC KELLER","Republican",0.651369227198886,-57398,189596,-0.302738454397772
2002,"FLORIDA",9,67623,169369,237008,"CHUCK KALOGIANIS","MICHAEL BILIRAKIS","Republican",0.714613008843583,-101746,236992,-0.429322508776668
2002,"FLORIDA",13,114739,139048,253809,"JAN SCHNEIDER","KATHERINE HARRIS","Republican",0.547845033076053,-24309,253787,-0.0957850480915098
2002,"FLORIDA",15,85433,146414,231857,"JIM TSO","DAVE WELDON","Republican",0.631484061296403,-60981,231847,-0.263022596798751
2002,"FLORIDA",18,42852,103512,149787,"RAY CHOTE","ILEANA ROS-LEHTINEN","Republican",0.69106130705602,-60660,146364,-0.414446175289006
2002,"FLORIDA",19,156747,60477,217224,"ROBERT WEXLER","JACK MERKL","Democrat",0.721591536846757,96270,217224,0.443183073693515
2002,"FLORIDA",22,83265,131930,217115,"CAROL A ROBERTS","E CLAY SHAW JR","Republican",0.607650323561246,-48665,215195,-0.226143730105253
2002,"FLORIDA",23,96347,27986,124338,"ALCEE L HASTINGS","CHARLES LAURIE","Democrat",0.774879763226045,68361,124333,0.549821849388336
2002,"FLORIDA",24,83667,135576,219243,"HARRY JACOBS","TOM FEENEY","Republican",0.618382342879818,-51909,219243,-0.236764685759637
2002,"FLORIDA",25,44757,81845,126602,"ANNIE BETANCOURT","MARIO DIAZ-BALART","Republican",0.646474779229396,-37088,126602,-0.292949558458792
2002,"GEORGIA",1,40026,103661,143687,"DON SMART","JACK KINGSTON","Republican",0.721436177246376,-63635,143687,-0.442872354492752
2002,"GEORGIA",3,75394,73866,149260,"JIM MARSHALL","CALDER CLAY","Democrat",0.505118585019429,1528,149260,0.0102371700388584
2002,"GEORGIA",4,118045,35202,153247,"DENISE L MAJETTE","CYNTHIA VAN AUKEN","Democrat",0.770292403766468,82843,153247,0.540584807532937
2002,"GEORGIA",6,41204,163525,204729,"JEFF WEISBERGER","JOHNNY ISAKSON","Republican",0.798738820587215,-122321,204729,-0.597477641174431
2002,"GEORGIA",7,37124,138997,176121,"MIKE BERLON","JOHN LINDER","Republican",0.789213097813435,-101873,176121,-0.57842619562687
2002,"GEORGIA",8,39422,142505,181927,"A PETRAKOPOULOS","MAC COLLINS","Republican",0.783308689749185,-103083,181927,-0.56661737949837
2002,"GEORGIA",9,45974,123313,169287,"BARRY IRWIN","CHARLIE NORWOOD","Republican",0.72842569128167,-77339,169287,-0.456851382563339
2002,"GEORGIA",11,65007,69427,134434,"ROGER KAHN","PHIL GINGREY","Republican",0.516439293631075,-4420,134434,-0.0328785872621509
2002,"GEORGIA",12,62904,77479,140383,"CHAMP WALKER","MAX BURNS","Republican",0.551911556242565,-14575,140383,-0.10382311248513
2002,"GEORGIA",13,70011,47405,117416,"DAVID SCOTT","CLAY COX","Democrat",0.596264563602916,22606,117416,0.192529127205832
2002,"HAWAII",1,131673,45032,180733,"NEIL ABERCROMBIE","MARK TERRY","Democrat",0.728549849778402,86641,176705,0.490314365750828
2002,"HAWAII",2,100671,71661,179251,"PATSY T MINK","BOB MCDERMOTT","Democrat",0.561620297794712,29010,172332,0.168337859480538
2002,"IDAHO",1,80269,120743,206141,"BETTY RICHARDSON","C L ""BUTCH"" OTTER","Republican",0.585730155573127,-40474,201012,-0.20135116311464
2002,"IDAHO",2,57769,135605,198882,"EDWARD KINGHORN","MICHAEL K SIMPSON","Republican",0.681836465844068,-77836,193374,-0.402515332981683
2002,"ILLINOIS",1,149068,29776,183656,"BOBBY L RUSH","RAYMOND G WARDINGLEY","Democrat",0.811669643246069,119292,178844,0.667017065151752
2002,"ILLINOIS",2,151443,32567,184010,"JESSE L JACKSON JR","DOUG NELSON","Democrat",0.8230150535297,118876,184010,0.646030107059399
2002,"ILLINOIS",4,67339,12778,84513,"LUIS V GUTIERREZ","ANTHONY J ""TONY"" LOPEZ-CISNEROS","Democrat",0.796788659732822,54561,80117,0.681016513349227
2002,"ILLINOIS",5,106514,46008,159435,"RAHM EMANUEL","MARK A AUGUSTI","Democrat",0.668071627936149,60506,152522,0.396703426390947
2002,"ILLINOIS",6,60698,113174,173872,"TOM BERRY","HENRY J HYDE","Republican",0.650904113370755,-52476,173872,-0.301808226741511
2002,"ILLINOIS",7,137933,25280,165756,"DANNY K DAVIS","MARK TUNNEY","Democrat",0.832144839402495,112653,163213,0.690220754474215
2002,"ILLINOIS",8,70626,95275,165926,"MELISSA L BEAN","PHILIP M CRANE","Republican",0.574201752588503,-24649,165901,-0.148576560719947
2002,"ILLINOIS",9,118642,45307,168836,"JANICE D SCHAKOWSKY","NICHOLAS M DURIC","Democrat",0.702705584117131,73335,163949,0.447303734697985
2002,"ILLINOIS",10,58300,128611,186911,"HENRY H ""HANK"" PERRITT JR","MARK STEVEN KIRK","Republican",0.688086843470957,-70311,186911,-0.376173686941914
2002,"ILLINOIS",11,68893,124192,193085,"KEITH S VAN DUYNE","JERRY WELLER","Republican",0.64319859129399,-55299,193085,-0.286397182587979
2002,"ILLINOIS",12,131580,58440,190020,"JERRY F COSTELLO","DAVID SADLER","Democrat",0.692453425955163,73140,190020,0.384906851910325
2002,"ILLINOIS",13,59069,139546,198615,"TOM MASON","JUDY BIGGERT","Republican",0.702595473655061,-80477,198615,-0.405190947310123
2002,"ILLINOIS",14,47165,135198,182363,"LAURENCE J QUICK","J DENNIS HASTERT","Republican",0.741367492309295,-88033,182363,-0.48273498461859
2002,"ILLINOIS",15,64131,134650,206617,"JOSHUA T HARTKE","TIMOTHY V JOHNSON","Republican",0.651688873616401,-70519,198781,-0.354757245410779
2002,"ILLINOIS",16,55488,133339,188827,"JOHN KUTSCH","DONALD A MANZULLO","Republican",0.706143718853766,-77851,188827,-0.412287437707531
2002,"ILLINOIS",17,127093,76519,203612,"LANE EVANS","PETER CALDERONE","Democrat",0.62419209083944,50574,203612,0.248384181678879
2002,"ILLINOIS",19,110517,133956,244473,"DAVID D PHELPS","JOHN SHIMKUS","Republican",0.547937809083212,-23439,244473,-0.0958756181664233
2002,"INDIANA",1,90443,41909,135111,"PETER J VISCLOSKY","MARK J LEYVA","Democrat",0.669397754438943,48534,132352,0.366703941005803
2002,"INDIANA",2,86253,95081,188458,"JILL LONG THOMPSON","CHRIS CHOCOLA","Republican",0.504520901208757,-8828,181334,-0.0486836445454245
2002,"INDIANA",3,50509,92566,146606,"JAY RIGDON","MARK E SOUDER","Republican",0.631392985280275,-42057,143075,-0.293950725144155
2002,"INDIANA",4,41314,112760,158008,"BILL ABBOTT","STEVE BUYER","Republican",0.713634752670751,-71446,154074,-0.463712242169347
2002,"INDIANA",5,45283,129442,179855,"KATHERINE FOX CARR","DAN BURTON","Republican",0.719701982152289,-84159,174725,-0.481665474316784
2002,"INDIANA",6,63871,118436,185653,"MELINA ANN FOX","MIKE PENCE","Republican",0.63794282882582,-54565,182307,-0.299302824356717
2002,"INDIANA",7,77478,64379,145840,"JULIA M CARSON","BROSE A MCVEY","Democrat",0.531253428414701,13099,141857,0.0923394686198073
2002,"INDIANA",8,88763,98952,192865,"BRYAN L HARTKE","JOHN N HOSTETTLER","Republican",0.513063541855702,-10189,187715,-0.0542790933063421
2002,"INDIANA",9,96654,87169,188957,"BARON P HILL","MIKE SODREL","Democrat",0.511513201416195,9485,183823,0.05159854860382
2002,"IOWA",1,83779,112280,196455,"ANN HUTCHINSON","JIM NUSSLE","Republican",0.571530375913059,-28501,196059,-0.145369506118056
2002,"IOWA",2,94767,108130,207171,"JULIE THOMAS","JAMES A LEACH","Republican",0.521935985248901,-13363,202897,-0.06586100336624
2002,"IOWA",3,115367,97285,215985,"LEONARD L BOSWELL","STAN THOMPSON","Democrat",0.534143574785286,18082,212652,0.085030942572842
2002,"IOWA",4,90784,115430,210774,"JOHN NORRIS","TOM LATHAM","Republican",0.547648191902227,-24646,206214,-0.119516618658287
2002,"IOWA",5,68853,113257,182237,"PAUL SHOMSHOR","STEVE KING","Republican",0.62148191640556,-44404,182110,-0.243830651803855
2002,"KANSAS",2,79160,127477,210977,"DAN LYKINS","JIM RYUN","Republican",0.604222261194348,-48317,206637,-0.233825500757367
2002,"KANSAS",3,110095,102882,219389,"DENNIS MOORE","ADAM TAFF","Democrat",0.501825524524931,7213,212977,0.0338675068199853
2002,"KANSAS",4,70656,115691,190963,"CARLOS NOLLA","TODD TIAHRT","Republican",0.605829401507098,-45035,186347,-0.241672793229835
2002,"KENTUCKY",1,62617,117600,180217,"KLINT ALEXANDER","ED WHITFIELD","Republican",0.652546652091645,-54983,180217,-0.30509330418329
2002,"KENTUCKY",2,51431,122773,176288,"DAVID L WILLIAMS","RON LEWIS","Republican",0.696434243964422,-71342,174204,-0.409531354044683
2002,"KENTUCKY",3,110846,118228,229074,"JACK CONWAY","ANNE M NORTHUP","Republican",0.516112697207016,-7382,229074,-0.0322253944140321
2002,"KENTUCKY",4,87776,81651,171735,"KEN LUCAS","GEOFF DAVIS","Democrat",0.511113052086063,6125,169427,0.0361512627857425
2002,"KENTUCKY",5,38254,137986,176240,"SIDNEY JANE BAILEY","HAROLD ""HAL"" ROGERS","Republican",0.782943713118475,-99732,176240,-0.56588742623695
2002,"LOUISIANA",2,122927,15440,142156,"CLARENCE ""BUDDY"" HUNT","""SILKY"" SULLIVAN","Democrat",0.864733110104392,107487,138367,0.776825399119732
2002,"LOUISIANA",4,42340,114649,160093,"JOHN MILKOVICH","JIM MCCRERY","Republican",0.716139993628703,-72309,156989,-0.460599150258935
2002,"LOUISIANA",5,144265,211709,184657,"RODNEY ALEXANDER","CLYDE C HOLLOWAY","Republican",1.14649864343079,-67444,355974,-0.189463275407755
2002,"LOUISIANA",5,144265,211709,172462,"RODNEY ALEXANDER","CLYDE C HOLLOWAY","Republican",1.22756897171551,-67444,355974,-0.189463275407755
2002,"MAINE",1,172646,97931,270577,"THOMAS H ALLEN","STEVEN JOYCE","Democrat",0.638066058829834,74715,270577,0.276132117659668
2002,"MAINE",2,116868,107849,224717,"MICHAEL H MICHAUD","KEVIN L RAYE","Democrat",0.520067462630776,9019,224717,0.0401349252615512
2002,"MARYLAND",1,57986,192004,249990,"AMY D TAMLYN","WAYNE T GILCHREST","Republican",0.768046721868875,-134018,249990,-0.536093443737749
2002,"MARYLAND",2,105718,88954,194672,"C A DUTCH RUPPERSBERGER","HELEN DELICH BENTLEY","Democrat",0.543057039533163,16764,194672,0.086114079066327
2002,"MARYLAND",3,145589,75721,221310,"BENJAMIN L CARDIN","SCOTT CONWELL","Democrat",0.657850978265781,69868,221310,0.315701956531562
2002,"MARYLAND",4,131644,34890,166729,"ALBERT RUSSELL WYNN","JOHN B KIMBLE","Democrat",0.789568701305712,96754,166534,0.58098646522632
2002,"MARYLAND",5,137903,60758,198819,"STENY H HOYER","JOSEPH T CRAWFORD","Democrat",0.693610771606335,77145,198661,0.388324834768777
2002,"MARYLAND",6,75575,147825,223400,"DONALD M DEARMON","ROSCOE G BARTLETT","Republican",0.661705461056401,-72250,223400,-0.323410922112802
2002,"MARYLAND",7,137047,49172,186219,"ELIJAH E CUMMINGS","JOSEPH E WARD","Democrat",0.735945311702887,87875,186219,0.471890623405775
2002,"MARYLAND",8,112788,103587,217974,"CHRIS VAN HOLLEN","CONSTANCE A MORELLA","Democrat",0.517437859561232,9201,216375,0.0425233968804159
2002,"MASSACHUSETTS",1,137841,66061,212216,"JOHN W OLVER","MATTHEW W KINNAMAN","Democrat",0.649531609303728,71780,203902,0.3520318584418
2002,"MASSACHUSETTS",5,122562,69337,214022,"MARTIN T MEEHAN","CHARLES MCCARTHY","Democrat",0.572660754501874,53225,191899,0.277359444291007
2002,"MASSACHUSETTS",6,162900,75462,252867,"JOHN F TIERNEY","MARK C SMITH","Democrat",0.644212174779627,87438,238362,0.3668286052307
2002,"MASSACHUSETTS",10,179238,79624,272027,"WILLIAM D DELAHUNT","LUIS GONZAGA","Democrat",0.658897829994817,99614,258862,0.38481507521382
2002,"MICHIGAN",1,150701,69254,222687,"BART STUPAK","DON HOOPER","Democrat",0.67673910017199,81447,219955,0.370289377372644
2002,"MICHIGAN",2,61749,156937,222907,"JEFFREY WRISLEY","PETER HOEKSTRA","Republican",0.704046979233492,-95188,218686,-0.435272491151697
2002,"MICHIGAN",3,61987,153131,218855,"KATHRYN LYNNES","VERNON J EHLERS","Republican",0.699691576614654,-91144,215118,-0.423693042888089
2002,"MICHIGAN",4,65950,149090,218573,"LAWRENCE HOLLENBECK","DAVE CAMP","Republican",0.682106207079557,-83140,215040,-0.386625744047619
2002,"MICHIGAN",6,53793,126936,183517,"GARY GIGUERE JR","FRED UPTON","Republican",0.691685238969687,-73143,180729,-0.404710920770878
2002,"MICHIGAN",7,78412,121142,203069,"MIKE SIMPSON","NICK SMITH","Republican",0.596555850474469,-42730,199554,-0.214127504334666
2002,"MICHIGAN",8,70920,156525,230597,"FRANK MCALPINE","MIKE ROGERS","Republican",0.678781597332142,-85605,227445,-0.376376706456506
2002,"MICHIGAN",9,96856,141102,242880,"DAVID FINK","JOE KNOLLENBERG","Republican",0.580953557312253,-44246,237958,-0.185940376032745
2002,"MICHIGAN",10,77053,137339,216928,"CARL MARLINGA","CANDICE S MILLER","Republican",0.633108681221419,-60286,214392,-0.281195193850517
2002,"MICHIGAN",11,87402,126050,220405,"KEVIN KELLEY","THADDEUS G MCCOTTER","Republican",0.571901726367369,-38648,213452,-0.181061784382437
2002,"MICHIGAN",12,140970,61502,206528,"SANDER M LEVIN","HARVEY DEAN","Democrat",0.682570886272079,79468,202472,0.39248883796278
2002,"MICHIGAN",14,145285,26544,174608,"JOHN CONYERS JR","DAVE STONE","Democrat",0.832063822963438,118741,171829,0.691041675153787
2002,"MICHIGAN",15,136518,48626,189063,"JOHN D DINGELL","MARTIN KALTENBACH","Democrat",0.72207676806144,87892,185144,0.474722378256924
2002,"MISSISSIPPI",1,32318,95404,133567,"REX N WEATHERS","ROGER F WICKER","Republican",0.71427822740647,-63086,127722,-0.493932133853212
2002,"MISSISSIPPI",2,89913,69711,163050,"BENNIE G THOMPSON","CLINTON B LESUEUR","Democrat",0.551444342226311,20202,159624,0.126559915802135
2002,"MISSISSIPPI",3,76184,139329,219151,"RONNIE SHOWS","CHARLES W ""CHIP"" PICKERING","Republican",0.6357671194747,-63145,215513,-0.292998566211783
2002,"MISSISSIPPI",4,121742,34373,161868,"GENE TAYLOR","KARL CLEVELAND MERTZ","Democrat",0.75210665480515,87369,156115,0.559645133395253
2002,"MISSOURI",1,133946,51755,191055,"WM LACY CLAY","RICHARD SCHWADRON","Democrat",0.701086074690534,82191,185701,0.442598585898837
2002,"MISSOURI",2,77223,167057,248828,"JOHN HOGAN","W TODD AKIN","Republican",0.671375407912293,-89834,244280,-0.36775012280989
2002,"MISSOURI",3,122181,80551,206878,"RICHARD A GEPHARDT","CATHERINE S ENZ","Democrat",0.590594456636278,41630,202732,0.205344987471144
2002,"MISSOURI",4,142204,64451,210238,"IKE SKELTON","JAMES A ""JIM"" NOLAND","Democrat",0.67639532339539,77753,206655,0.376245433209939
2002,"MISSOURI",5,122645,60245,186167,"KAREN MCCARTHY","STEVE GORDON","Democrat",0.6587902259799,62400,182890,0.341188692656788
2002,"MISSOURI",6,73202,131151,208088,"CATHY RINEHART","SAM GRAVES","Republican",0.630267002422052,-57949,204353,-0.283573032938102
2002,"MISSOURI",7,45964,149519,199863,"RON LAPHAM","ROY BLUNT","Republican",0.74810745360572,-103555,195483,-0.529739158903843
2002,"MISSOURI",8,50686,135144,188321,"GENE CURTIS","JO ANN EMERSON","Republican",0.717625756022961,-84458,185830,-0.454490663509659
2002,"MISSOURI",9,61126,146032,214125,"DONALD M ""DON"" DEICHMAN","KENNY C HULSHOF","Republican",0.681994162288383,-84906,207158,-0.409861072225065
2002,"MONTANA",0,108233,214100,331321,"STEVE KELLY","DENNIS R REHBERG","Republican",0.646201116138126,-105867,322333,-0.328439843267677
2002,"NEBRASKA",2,46843,89917,142014,"JIM SIMON","LEE TERRY","Republican",0.633155886039405,-43074,136760,-0.314960514770401
2002,"NEVADA",1,64312,51148,121516,"SHELLEY BERKLEY","LYNETTE MARIA BOGGS-MCDONALD","Democrat",0.529247177326443,13164,115460,0.114013511172701
2002,"NEVADA",2,40189,149574,201343,"TRAVIS O SOUZA","JIM GIBBONS","Republican",0.742881550389137,-109385,189763,-0.576429546328842
2002,"NEVADA",3,66659,100378,178994,"DARIO HERRERA","JON C PORTER","Republican",0.560789747142362,-33719,167037,-0.201865454959081
2002,"NEW HAMPSHIRE",1,85426,128993,221987,"MARTHA FULLER","JEB BRADLEY","Republican",0.581083576966219,-43567,214419,-0.203186284797523
2002,"NEW HAMPSHIRE",2,90479,125804,221456,"KATRINA SWETT","CHARLES BASS","Republican",0.568076728560075,-35325,216283,-0.163327677163716
2002,"NEW JERSEY",2,47735,116834,168799,"STEVEN A FARKAS","FRANK A LOBIONDO","Republican",0.692148650169728,-69099,164569,-0.419878591958388
2002,"NEW JERSEY",3,64364,123375,189739,"RICHARD STRADA","JIM SAXTON","Republican",0.650235323259846,-59011,187739,-0.314324674148685
2002,"NEW JERSEY",4,55967,115293,174301,"MARY BRENNAN","CHRISTOPHER H SMITH","Republican",0.661459199889846,-59326,171260,-0.346408968819339
2002,"NEW JERSEY",5,76504,118881,199851,"ANNE SUMERS","SCOTT GARRETT","Republican",0.594848161880601,-42377,195385,-0.216889730532027
2002,"NEW JERSEY",6,91379,42479,137495,"FRANK PALLONE JR","RIC MEDROW","Democrat",0.664598712680461,48900,133858,0.365312495330873
2002,"NEW JERSEY",7,74879,106055,183002,"TIM CARDEN","MIKE FERGUSON","Republican",0.579529185473383,-31176,180934,-0.172305923706987
2002,"NEW JERSEY",8,88101,40318,131819,"BILL PASCRELL JR","JARED SILVERMAN","Democrat",0.668348265424559,47783,128419,0.372086684992096
2002,"NEW JERSEY",9,97108,42088,139196,"STEVEN R ROTHMAN","JOSEPH GLASS","Democrat",0.697634989511193,55020,139196,0.395269979022386
2002,"NEW JERSEY",10,86433,15913,102346,"DONALD M PAYNE","ANDREW WIRTZ","Democrat",0.844517616711938,70520,102346,0.689035233423876
2002,"NEW JERSEY",11,48477,132938,183678,"VIJ PAWAR","RODNEY P FRELINGHUYSEN","Republican",0.723755702914884,-84461,181415,-0.465567896811179
2002,"NEW JERSEY",12,104806,62938,171713,"RUSH D HOLT","DEFOREST ""BUSTER"" SOARIES","Democrat",0.610355651581418,41868,167744,0.249594620373903
2002,"NEW JERSEY",13,72605,16852,92731,"ROBERT MENENDEZ","JAMES GERON","Democrat",0.782963625971897,55753,89457,0.623237980258672
2002,"NEW MEXICO",1,77234,95711,172945,"RICHARD M ROMERO","HEATHER WILSON","Republican",0.553418716933129,-18477,172945,-0.106837433866258
2002,"NEW MEXICO",2,61916,79631,141629,"JOHN ARTHUR SMITH","STEVE PEARCE","Republican",0.562250669001405,-17715,141547,-0.125152776109702
2002,"NEW YORK",1,81325,64999,178530,"TIMOTHY H BISHOP","FELIX J GRUCCI JR","Democrat",0.455525681958214,16326,146324,0.111574314534868
2002,"NEW YORK",2,75845,48239,160213,"STEVE J ISRAEL","JOSEPH P FINLEY","Democrat",0.473401034872326,27606,124084,0.222478321137294
2002,"NEW YORK",3,46022,98874,186622,"STUART L FINZ","PETER T KING","Republican",0.529808918562656,-52852,144896,-0.364758171378092
2002,"NEW YORK",4,85496,61473,180253,"CAROLYN MCCARTHY","MARILYN F O'GRADY","Democrat",0.474311107166039,24023,146969,0.163456239070824
2002,"NEW YORK",7,48983,16460,104272,"JOSEPH CROWLEY","KEVIN BRAWLEY","Democrat",0.469761776891208,32523,65443,0.496966826092936
2002,"NEW YORK",8,71996,18623,141576,"JERROLD L NADLER","JIM FARRIN","Democrat",0.508532519636096,53373,90619,0.588982442975535
2002,"NEW YORK",9,57104,27882,119935,"ANTHONY D WEINER","ALFRED F DONOHUE","Democrat",0.476124567474048,29222,84986,0.343844868566587
2002,"NEW YORK",11,67967,9250,119174,"MAJOR R OWENS","SUSAN CLEARY","Democrat",0.570317351100072,58717,77217,0.760415452555784
2002,"NEW YORK",13,27304,62520,123606,"ARNE M MATTSSON","VITO FOSSELLA","Republican",0.505800689286928,-35216,89824,-0.392055575347346
2002,"NEW YORK",14,85029,30053,151606,"CAROLYN B MALONEY","ANTON SRDANOVIC","Democrat",0.560855111275279,54976,115082,0.477711544811526
2002,"NEW YORK",15,77036,8790,127400,"CHARLES B RANGEL","JESSIE A FIELDS","Democrat",0.604678178963893,68246,85826,0.795166965721343
2002,"NEW YORK",16,48411,3916,78454,"JOSE E SERRANO","FRANK DELLAVALLE","Democrat",0.617062227547353,44495,52327,0.850325835610679
2002,"NEW YORK",17,73569,35389,144582,"ELIOT L ENGEL","C SCOTT VANDERHOEF","Democrat",0.508839274598498,38180,108958,0.350410249821032
2002,"NEW YORK",19,44967,102848,190318,"JANINE M H SELENDY","SUE W KELLY","Republican",0.540400802866781,-57881,147815,-0.391577309474681
2002,"NEW YORK",20,45878,125335,222534,"FRANK STOPPENBACH","JOHN E SWEENEY","Republican",0.563217306119514,-79457,171213,-0.464082750725704
2002,"NEW YORK",21,128584,53525,236967,"MICHAEL R MCNULTY","CHARLES B ROSENSTEIN","Democrat",0.542624078458182,75059,182109,0.412165241695907
2002,"NEW YORK",22,92336,52499,192271,"MAURICE D HINCHEY","ERIC HALL","Democrat",0.480238829568682,39837,144835,0.275050920012428
2002,"NEW YORK",25,53290,113914,217160,"STEPHANIE ALDERSLEY","JAMES T WALSH","Republican",0.524562534536747,-60624,167204,-0.362575058012966
2002,"NEW YORK",26,41140,105807,213994,"AYESHA F NARIMAN","THOMAS M REYNOLDS","Republican",0.494439096423264,-64667,146947,-0.440070229402438
2002,"NEW YORK",27,45060,105946,199883,"PETER CROTTY","JACK QUINN","Republican",0.530040073442964,-60886,151006,-0.403202521754102
2002,"NEW YORK",28,94209,45125,179708,"LOUISE MCINTOSH SLAUGHTER","HENRY F WOJTASZEK","Democrat",0.524233756983551,49084,139334,0.352275826431452
2002,"NEW YORK",29,37128,116245,207793,"KISUN J PETERS","AMO HOUGHTON","Republican",0.559426929684831,-79117,153373,-0.515846987409779
2002,"NORTH CAROLINA",1,93157,50907,146157,"FRANK W BALLANCE JR","GREG DORITY","Democrat",0.637376246091532,42250,144064,0.293272434473567
2002,"NORTH CAROLINA",2,100121,50965,153184,"BOB ETHERIDGE","JOSEPH L ELLEN","Democrat",0.653599592646752,49156,151086,0.325351124525105
2002,"NORTH CAROLINA",4,132185,78095,216046,"DAVID E PRICE","TUAN A NGUYEN","Democrat",0.61183729390963,54090,210280,0.257228457295035
2002,"NORTH CAROLINA",5,58558,137879,196437,"DAVID CRAWFORD","RICHARD BURR","Republican",0.701899336683008,-79321,196437,-0.403798673366016
2002,"NORTH CAROLINA",7,118543,45537,166654,"MIKE MCINTYRE","JAMES R ADAMS","Democrat",0.711312059716538,73006,164080,0.444941491955144
2002,"NORTH CAROLINA",8,66819,80298,149736,"CHRIS KOURI","ROBIN HAYES","Republican",0.536263824330822,-13479,147117,-0.0916209547503008
2002,"NORTH CAROLINA",9,49974,140095,193443,"ED MCGUIRE","SUE WILKINS MYRICK","Republican",0.7242185036419,-90121,190069,-0.474148861729162
2002,"NORTH CAROLINA",10,65587,102768,173292,"RON DAUGHERTY","CASS BALLENGER","Republican",0.593033723426356,-37181,168355,-0.220848801639393
2002,"NORTH CAROLINA",11,86664,112335,202260,"SAM NEILL","CHARLES H TAYLOR","Republican",0.555398991397211,-25671,198999,-0.129000648244464
2002,"NORTH CAROLINA",12,98821,49588,151239,"MELVIN L WATT","JEFF KISH","Democrat",0.653409504162286,49233,148409,0.331738641187529
2002,"NORTH CAROLINA",13,100287,77688,183270,"BRAD MILLER","CAROLYN W GRANT","Democrat",0.547209035848748,22599,177975,0.126978508217446
2002,"NORTH DAKOTA",0,121073,109957,231030,"EARL POMEROY","RICK CLAYBURGH","Democrat",0.524057481712332,11116,231030,0.0481149634246635
2002,"OHIO",1,60168,110760,170928,"GREG HARRIS","STEVE CHABOT","Republican",0.647992137040157,-50592,170928,-0.295984274080315
2002,"OHIO",2,48785,139218,188016,"CHARLES SANDERS","ROB PORTMAN","Republican",0.740458258871585,-90433,188003,-0.481018919910852
2002,"OHIO",3,78307,111630,189951,"RICK CARNE","MICHAEL R TURNER","Republican",0.587677874820348,-33323,189937,-0.17544238352717
2002,"OHIO",4,57726,120001,177727,"JIM CLARK","MICHAEL OXLEY","Republican",0.67519847856544,-62275,177727,-0.35039695713088
2002,"OHIO",5,51872,126286,188254,"ROGER ANDERSON","PAUL E GILLMOR","Republican",0.67082771149617,-74414,178158,-0.417685425296647
2002,"OHIO",6,113972,77643,191615,"TED STRICKLAND","MIKE HALLECK","Democrat",0.594796858283537,36329,191615,0.189593716567075
2002,"OHIO",7,45568,113252,167632,"KARA ANASTASIO","DAVID L HOBSON","Republican",0.675598930991696,-67684,158820,-0.426167988918272
2002,"OHIO",8,49444,119947,169391,"JEFF HARDENBROOK","JOHN A BOEHNER","Republican",0.708107278426835,-70503,169391,-0.41621455685367
2002,"OHIO",9,132236,46481,178717,"MARCY KAPTUR","ED EMERY","Democrat",0.739918418505235,85755,178717,0.479836837010469
2002,"OHIO",10,129997,41778,175536,"DENNIS J KUCINICH","JON A HEBEN","Democrat",0.740571734572965,88219,171775,0.513572987920245
2002,"OHIO",11,116590,36146,152736,"STEPHANIE TUBBS JONES","PATRICK A PAPPANO","Democrat",0.763343285145611,80444,152736,0.526686570291221
2002,"OHIO",12,64707,116982,181689,"EDWARD BROWN","PATRICK J TIBERI","Republican",0.643858461436851,-52275,181689,-0.287716922873702
2002,"OHIO",13,123025,55357,178382,"SHERROD BROWN","ED OLIVEROS","Democrat",0.689671603637138,67668,178382,0.379343207274277
2002,"OHIO",14,51846,134413,186372,"DALE BLANCHARD","STEVEN C LATOURETTE","Republican",0.721208121391625,-82567,186259,-0.443291330888709
2002,"OHIO",15,54286,108193,162479,"MARK BROWN","DEBORAH PRYCE","Republican",0.665889130287606,-53907,162479,-0.331778260575213
2002,"OHIO",16,58644,129734,188378,"JIM RICE","RALPH REGULA","Republican",0.688689762074128,-71090,188378,-0.377379524148255
2002,"OHIO",17,94441,62188,184674,"TIMOTHY J RYAN","ANN WOMER BENJAMIN","Democrat",0.511393049373491,32253,156629,0.205919721124441
2002,"OKLAHOMA",1,90649,119566,214955,"DOUG DODD","JOHN SULLIVAN","Republican",0.556237352003908,-28917,210215,-0.137559165616155
2002,"OKLAHOMA",2,146748,51234,197982,"BRAD CARSON","KENT PHARAOH","Democrat",0.741218898687759,95514,197982,0.482437797375519
2002,"OKLAHOMA",4,91322,106452,197774,"DARRYL ROBERTS","TOM COLE","Republican",0.538250730631933,-15130,197774,-0.0765014612638668
2002,"OKLAHOMA",5,63208,121374,195051,"LOU BARLOW","ERNEST J ISTOOK JR","Republican",0.622268022209576,-58166,184582,-0.315122818042929
2002,"OREGON",1,149215,80917,238036,"DAVID WU","JIM GREENFIELD","Democrat",0.626858962509872,68298,230132,0.296777501607773
2002,"OREGON",2,64991,181295,252284,"PETER BUCKLEY","GREG WALDEN","Republican",0.718614735773969,-116304,246286,-0.472231470729152
2002,"OREGON",3,156851,62821,234977,"EARL BLUMENAUER","SARAH SEALE","Democrat",0.66751639522166,94030,219672,0.428047270475982
2002,"OREGON",4,168150,90523,263481,"PETER A DEFAZIO","LIZ VANLEEUWEN","Democrat",0.638186434695481,77627,258673,0.300097033706649
2002,"OREGON",5,137713,113441,251537,"DARLENE HOOLEY","BRIAN J BOQUIST","Democrat",0.547486055729376,24272,251154,0.096641900985053
2002,"PENNSYLVANIA",1,121076,17444,140090,"ROBERT A BRADY","MARIE G DELANY","Democrat",0.864272967378114,103632,138520,0.748137453075368
2002,"PENNSYLVANIA",2,150623,20988,171611,"CHAKA FATTAH","THOMAS G DOUGHERTY","Democrat",0.877700147426447,129635,171611,0.755400294852894
2002,"PENNSYLVANIA",4,71674,130534,202218,"STEVEN DROBAC JR","MELISSA A HART","Republican",0.645511279905844,-58860,202208,-0.291086406076911
2002,"PENNSYLVANIA",6,98128,103648,201791,"DAN WOFFORD","JIM GERLACH","Republican",0.513640350659841,-5520,201776,-0.0273570692252795
2002,"PENNSYLVANIA",7,75055,146296,221351,"PETER A LENNON","CURT WELDON","Republican",0.660923149206464,-71241,221351,-0.321846298412928
2002,"PENNSYLVANIA",8,76178,127475,203687,"TIMOTHY T REECE","JAMES C GREENWOOD","Republican",0.625837682326314,-51297,203653,-0.251884332663894
2002,"PENNSYLVANIA",9,50558,124184,174849,"JOHN R HENRY","BILL SHUSTER","Republican",0.710235689080292,-73626,174742,-0.421341177278502
2002,"PENNSYLVANIA",11,93758,71543,168615,"PAUL E KANJORSKI","LOUIS J BARLETTA","Democrat",0.556047801203926,22215,165301,0.134391201505133
2002,"PENNSYLVANIA",12,124201,44818,169028,"JOHN P MURTHA","BILL CHOBY","Democrat",0.734795418510543,79383,169019,0.469669090457286
2002,"PENNSYLVANIA",13,107945,100295,211867,"JOSEPH M HOEFFEL","MELISSA BROWN","Democrat",0.509494163791435,7650,208240,0.0367364579331541
2002,"PENNSYLVANIA",15,73212,98493,171713,"EDWARD J O'BRIEN","PATRICK J TOOMEY","Republican",0.573590817235736,-25281,171705,-0.147235083427972
2002,"PENNSYLVANIA",17,103483,97802,201291,"TIM HOLDEN","GEORGE W GEKAS","Democrat",0.514096507047011,5681,201285,0.028223662965447
2002,"PENNSYLVANIA",18,79451,119885,199349,"JACK MACHEK","TIM MURPHY","Republican",0.601382500037623,-40434,199336,-0.202843440221535
2002,"RHODE ISLAND",1,95286,59370,159133,"PATRICK J KENNEDY","DAVID W ROGERS","Democrat",0.598782150779537,35916,154656,0.232231533209187
2002,"RHODE ISLAND",2,129390,37767,169610,"JAMES R LANGEVIN","JOHN O MATSON","Democrat",0.762867755438948,91623,167157,0.548125415028985
2002,"SOUTH CAROLINA",3,55743,119644,178195,"GEORGE L BRIGHTHARP","J GRESHAM BARRETT","Republican",0.671421757063891,-63901,175387,-0.364342853233136
2002,"SOUTH CAROLINA",4,51462,122422,177417,"PETER J ASHY","JIM DEMINT","Republican",0.69002406759217,-70960,173884,-0.40808815072117
2002,"SOUTH CAROLINA",6,115855,55490,173047,"JAMES E CLYBURN","GARY MCLEOD","Democrat",0.669500193589025,60365,171345,0.352300913361931
2002,"SOUTH DAKOTA",0,153551,180023,336691,"STEPHANIE HERSETH","WILLIAM J JANKLOW","Republican",0.534683136763382,-26472,333574,-0.0793587030164221
2002,"TENNESSEE",2,37035,146887,185981,"JOHN GREENE","JOHN J DUNCAN JR","Republican",0.789795731822068,-109852,183922,-0.597274931764552
2002,"TENNESSEE",3,58824,112254,173921,"JOHN WOLFE","ZACH WAMP","Republican",0.645430971533052,-53430,171078,-0.312313681478624
2002,"TENNESSEE",4,95989,85680,184300,"LINCOLN DAVIS","JANICE BOWLING","Democrat",0.520830168204015,10309,181669,0.0567460601423468
2002,"TENNESSEE",5,108903,56825,170886,"JIM COOPER","ROBERT DUVALL","Democrat",0.63728450545978,52078,165728,0.31423778721761
2002,"TENNESSEE",6,117119,57397,177628,"BART GORDON","ROBERT L GARRISON","Democrat",0.659349877271601,59722,174516,0.342215040454743
2002,"TENNESSEE",7,51790,138314,195558,"TIM BARRON","MARSHA BLACKBURN","Republican",0.707278659016762,-86524,190104,-0.455140344232631
2002,"TENNESSEE",8,117811,45853,167970,"JOHN S TANNER","MAT MCCLAIN","Democrat",0.701381199023635,71958,163664,0.439669078111252
2002,"TEXAS",1,86384,66654,153038,"MAX SANDLIN","JOHN LAWRENCE","Democrat",0.564461114233066,19730,153038,0.128922228466133
2002,"TEXAS",2,85492,53656,140501,"JIM TURNER","VAN BROOKSHIRE","Democrat",0.608479654949075,31836,139148,0.228792364963923
2002,"TEXAS",3,37503,113974,154133,"MANNY MOLERA","SAM JOHNSON","Republican",0.739452291203052,-76471,151477,-0.5048357176337
2002,"TEXAS",4,97304,67939,168285,"RALPH M HALL","JOHN GRAVES","Democrat",0.578209584930326,29365,165243,0.177707981578645
2002,"TEXAS",5,56330,81439,139908,"RON CHAPMAN","JEB HENSARLING","Republican",0.582089658918718,-25109,137769,-0.182254353301541
2002,"TEXAS",6,45404,115396,164037,"FELIX ALVARADO","JOE BARTON","Republican",0.703475435420058,-69992,160800,-0.435273631840796
2002,"TEXAS",9,86710,59635,147958,"NICK LAMPSON","PAUL WILLIAMS","Democrat",0.586044688357507,27075,146345,0.185008028972633
2002,"TEXAS",11,74678,68236,144857,"CHET EDWARDS","RAMSEY FARLEY","Democrat",0.515529108016872,6442,142914,0.0450760597282282
2002,"TEXAS",13,31218,119401,150619,"ZANE REESE","MAC THORNBERRY","Republican",0.792735312277999,-88183,150619,-0.585470624555999
2002,"TEXAS",14,48224,102905,151129,"CORBY WINDHAM","RON PAUL","Republican",0.68090836305408,-54681,151129,-0.361816726108159
2002,"TEXAS",17,84136,77622,163804,"CHARLES W STENHOLM","ROB BECKHAM","Democrat",0.513638250592171,6514,161758,0.0402700330122776
2002,"TEXAS",18,99161,27980,128926,"SHEILA JACKSON-LEE","PHILLIP J ABBOTT","Democrat",0.769131129485131,71181,127141,0.559858739509678
2002,"TEXAS",21,56206,161836,222093,"JOHN COURAGE","LAMAR S SMITH","Republican",0.728685730752433,-105630,218042,-0.484447950394878
2002,"TEXAS",22,55716,100499,159084,"TIM RILEY","TOM DELAY","Republican",0.631735435367479,-44783,156215,-0.286675415293026
2002,"TEXAS",23,71067,77573,150552,"HENRY CUELLAR","HENRY BONILLA","Republican",0.515257186885594,-6506,148640,-0.043770182992465
2002,"TEXAS",24,73002,38332,112894,"MARTIN FROST","MIKE RIVERA ORTEGA","Democrat",0.646641982744876,34670,111334,0.311405320926222
2002,"TEXAS",25,63590,50041,116126,"CHRIS BELL","TOM REISER","Democrat",0.547594853865629,13549,113631,0.119236827978281
2002,"TEXAS",26,37485,123195,164678,"PAUL WILLIAM LEBON","MICHAEL C BURGESS","Republican",0.748096284871082,-85710,160680,-0.533420463032114
2002,"TEXAS",27,68559,41004,112209,"SOLOMON P ORTIZ","PAT AHUMADA","Democrat",0.610993770553164,27555,109563,0.251499137482544
2002,"TEXAS",28,71393,26973,100420,"CIRO D RODRIGUEZ","GABRIEL PERALES JR","Democrat",0.710944035052778,44420,98366,0.451578797552
2002,"TEXAS",30,88980,28981,119817,"EDDIE BERNICE JOHNSON","RON BUSH","Democrat",0.742632514584742,59999,117961,0.508634209611651
2002,"TEXAS",31,44183,111556,161484,"DAVID BAGLEY","JOHN R CARTER","Republican",0.690817666146491,-67373,155739,-0.432601981520364
2002,"TEXAS",32,44886,100226,147902,"PAULINE K DIXON","PETE SESSIONS","Republican",0.677651417830726,-55340,145112,-0.381360604222945
2002,"UTAH",1,66104,109265,179412,"DAVE THOMAS","ROB BISHOP","Republican",0.609017234075759,-43161,175369,-0.246115333952979
2002,"UTAH",2,110764,109123,224098,"JIM MATHESON","JOHN SWALLOW","Democrat",0.494265901525226,1641,219887,0.0074629241383074
2002,"UTAH",3,44533,103598,153643,"NANCY JANE WOODSIDE","CHRIS CANNON","Republican",0.674277383284627,-59065,148131,-0.398734903565088
2002,"VIRGINIA",5,54805,95360,150233,"MEREDITH M RICHARDS","VIRGIL H GOODE JR","Republican",0.634747359102195,-40555,150165,-0.270069590117537
2002,"VIRGINIA",7,49854,113658,163665,"BEN L ""COOTER"" JONES","ERIC CANTOR","Republican",0.694455137017689,-63804,163512,-0.390209892851901
2002,"VIRGINIA",8,102759,64121,171799,"JAMES P MORAN","SCOTT C TATE","Democrat",0.59813502988958,38638,166880,0.231531639501438
2002,"VIRGINIA",10,45464,115917,161615,"JOHN B STEVENS JR","FRANK R WOLF","Republican",0.717241592673947,-70453,161381,-0.436563164189093
2002,"WASHINGTON",1,114087,84696,205034,"JAY INSLEE","JOE MARINE","Democrat",0.5564296653238,29391,198783,0.14785469582409
2002,"WASHINGTON",2,101219,92528,202150,"RICK LARSEN","NORMA SMITH","Democrat",0.500712342320059,8691,193747,0.0448574687608066
2002,"WASHINGTON",3,119264,74065,193329,"BRIAN BAIRD","JOSEPH ZARELLI","Democrat",0.616896585613126,45199,193329,0.233793171226252
2002,"WASHINGTON",4,53572,108257,161829,"CRAIG MASON","DOC HASTINGS","Republican",0.668959210030341,-54685,161829,-0.337918420060681
2002,"WASHINGTON",5,65146,126757,202282,"BART HAGGIN","GEORGE R NETHERCUTT JR","Republican",0.626635093582227,-61611,191903,-0.321052823561904
2002,"WASHINGTON",6,126116,61584,196444,"NORMAN D DICKS","BOB LAWRENCE","Democrat",0.641994665146301,64532,187700,0.343803942461375
2002,"WASHINGTON",7,156300,46256,211003,"JIM MCDERMOTT","CAROL THORNE CASSADY","Democrat",0.740747761880163,110044,202556,0.543276920950256
2002,"WASHINGTON",8,75931,121633,203335,"HEIDI BEHRENS-BENEDICT","JENNIFER DUNN","Republican",0.598190178769026,-45702,197564,-0.231327569800166
2002,"WASHINGTON",9,95805,63146,163710,"ADAM SMITH","SARAH CASADA","Democrat",0.58521165475536,32659,158951,0.205465835383231
2002,"WEST VIRGINIA",2,65400,98276,163676,"JIM HUMPHREYS","SHELLEY MOORE CAPITO","Republican",0.600430118038075,-32876,163676,-0.20086023607615
2002,"WEST VIRGINIA",3,87783,37229,125012,"NICK J RAHALL II","PAUL E CHAPMAN","Democrat",0.702196589127444,50554,125012,0.404393178254888
2002,"WISCONSIN",1,63895,140176,208613,"JEFFREY C THOMAS","PAUL RYAN","Republican",0.671942784006749,-76281,204071,-0.373796374791127
2002,"WISCONSIN",2,163313,83694,247410,"TAMMY BALDWIN","RON GREER","Democrat",0.660090537973404,79619,247007,0.32233499455481
2002,"WISCONSIN",3,131038,69955,208581,"RON KIND","BILL ARNDT","Democrat",0.628235553573911,61083,200993,0.303906106182802
2002,"WISCONSIN",7,146364,81518,227955,"DAVID R OBEY","JOE ROTHBAUER","Democrat",0.6420740935711,64846,227882,0.284559552750985
2002,"WISCONSIN",8,50284,152745,210447,"ANDREW M BECKER","MARK GREEN","Republican",0.725812199746254,-102461,203029,-0.50466189559127
2002,"WYOMING",0,65961,110229,182152,"RON AKIN","BARBARA CUBIN","Republican",0.605148447450481,-44268,176190,-0.251251489868892
2004,"ALABAMA",1,93938,161067,255164,"JUDY BELK","JO BONNER","Republican",0.631229327021053,-67129,255005,-0.263245818709437
2004,"ALABAMA",2,70562,177086,247947,"CHARLES D ""CHUCK"" JAMES","TERRY EVERETT","Republican",0.71420908500607,-106524,247648,-0.430142783305337
2004,"ALABAMA",3,95240,150411,245784,"BILL FULLER","MIKE ROGERS","Republican",0.611964163655893,-55171,245651,-0.224590984771078
2004,"ALABAMA",4,64278,191110,255724,"CARL COLE","ROBERT B ADERHOLT","Republican",0.747329151741722,-126832,255388,-0.496624743527495
2004,"ALABAMA",5,200999,74145,275459,"ROBERT E ""BUD"" CRAMER JR","GERALD ""GERRY"" WALLACE","Democrat",0.729687539706454,126854,275144,0.461045852353677
2004,"ALABAMA",7,183408,61019,244638,"ARTUR DAVIS","STEVE F CAMERON","Democrat",0.74971181909597,122389,244427,0.500718005784958
2004,"ALASKA",0,67074,213216,299996,"THOMAS M HIGGINS","DON YOUNG","Republican",0.710729476393019,-146142,280290,-0.521395697313497
2004,"ARIZONA",1,91776,148315,253351,"PAUL BABBITT","RICK RENZI","Republican",0.58541312250593,-56539,240091,-0.235489876755064
2004,"ARIZONA",2,107406,165260,279303,"RANDY CAMACHO","TRENT FRANKS","Republican",0.591687164119254,-57854,272666,-0.212179002882648
2004,"ARIZONA",4,77150,28238,110027,"ED PASTOR","DON KARG","Democrat",0.701191525716415,48912,105388,0.464113561316279
2004,"ARIZONA",5,102363,159455,268007,"ELIZABETH ROGERS","J D HAYWORTH","Republican",0.594965803132008,-57092,261818,-0.21805987365269
2004,"ARIZONA",7,108868,59066,175437,"RAUL M GRIJALVA","JOSEPH SWEENEY","Democrat",0.620553247034548,49802,167934,0.296556980718616
2004,"ARIZONA",8,109963,183363,303769,"EVA BACAL","JIM KOLBE","Republican",0.603626439827632,-73400,293326,-0.250233528565487
2004,"ARKANSAS",1,162388,81556,243944,"MARION BERRY","VERNON HUMPHREY","Democrat",0.665677368576395,80832,243944,0.331354737152789
2004,"ARKANSAS",2,160834,115655,276493,"VIC SNYDER","MARVIN PARKS","Democrat",0.581692845750164,45179,276489,0.163402522342661
2004,"ARKANSAS",3,103158,160629,270803,"JAN JUDY","JOHN BOOZMAN","Republican",0.593158126017806,-57471,263787,-0.217868962458347
2004,"CALIFORNIA",1,189366,79970,282971,"MIKE THOMPSON","LAWRENCE R WIESNER","Democrat",0.669206385106601,109396,269336,0.406169245849051
2004,"CALIFORNIA",2,90310,182119,272429,"MIKE JOHNSON","WALLY HERGER","Republican",0.668500783690429,-91809,272429,-0.337001567380859
2004,"CALIFORNIA",3,100025,177738,287073,"GABE CASTILLO","DAN LUNGREN","Republican",0.619138685978828,-77713,277763,-0.279781684385609
2004,"CALIFORNIA",4,117443,221926,339369,"DAVID I WINTERS","JOHN T DOOLITTLE","Republican",0.653937159846657,-104483,339369,-0.307874319693313
2004,"CALIFORNIA",5,138004,45120,193387,"ROBERT T MATSUI","MIKE DUGAS","Democrat",0.713615703227208,92884,183124,0.507219152049977
2004,"CALIFORNIA",6,226423,85244,311667,"LYNN C WOOLSEY","PAUL L ERICKSON","Democrat",0.726490132096115,141179,311667,0.452980264192231
2004,"CALIFORNIA",7,166831,52446,219277,"GEORGE MILLER","CHARLES HARGRAVE","Democrat",0.76082306853888,114385,219277,0.52164613707776
2004,"CALIFORNIA",8,224017,31074,270064,"NANCY PELOSI","JENNIFER DEPALMA","Democrat",0.829495971325315,192943,255091,0.756369295663116
2004,"CALIFORNIA",9,215630,31278,255039,"BARBARA LEE","CLAUDIA BERMUDEZ","Democrat",0.845478534655484,184352,246908,0.746642474119915
2004,"CALIFORNIA",10,182750,95349,278099,"ELLEN O TAUSCHER","JEFF KETELSON","Democrat",0.657140083207779,87401,278099,0.314280166415557
2004,"CALIFORNIA",11,103587,163582,267169,"GERALD ""JERRY"" M MCNERNEY","RICHARD W POMBO","Republican",0.61227911920919,-59995,267169,-0.224558238418379
2004,"CALIFORNIA",12,171852,52593,252599,"TOM LANTOS","MIKE GARZA","Democrat",0.680335234898,119259,224445,0.531350664973602
2004,"CALIFORNIA",13,144605,48439,201921,"FORTNEY PETE STARK","GEORGE I BRUNO","Democrat",0.716146413696446,96166,193044,0.498155860840016
2004,"CALIFORNIA",14,182712,69564,261888,"ANNA G ESHOO","CHRIS HAUGEN","Democrat",0.697672287390029,113148,252276,0.448508776102364
2004,"CALIFORNIA",15,154385,59953,214338,"MICHAEL M HONDA","RAYMOND L CHUKWU","Democrat",0.720287583163042,94432,214338,0.440575166326083
2004,"CALIFORNIA",16,129222,47992,182281,"ZOE LOFGREN","DOUGLAS ADAMS MCNEA","Democrat",0.70891645316846,81230,177214,0.458372363357297
2004,"CALIFORNIA",17,148958,65117,223225,"SAM FARR","MARK RISLEY","Democrat",0.667299809609139,83841,214075,0.391643115730468
2004,"CALIFORNIA",18,103732,49973,153705,"DENNIS A CARDOZA","CHARLES F PRINGLE SR","Democrat",0.674877199830845,53759,153705,0.34975439966169
2004,"CALIFORNIA",19,64047,155354,235264,"JAMES LEX BUFFORD","GEORGE RADANOVICH","Republican",0.660339023394995,-91307,219401,-0.416164921764258
2004,"CALIFORNIA",20,61005,53231,114236,"JIM COSTA","ROY ASHBURN","Democrat",0.53402605133233,7774,114236,0.0680521026646591
2004,"CALIFORNIA",21,51594,140721,192315,"FRED B DAVIS","DEVIN NUNES","Republican",0.731721394587006,-89127,192315,-0.463442789174011
2004,"CALIFORNIA",23,153980,83926,244297,"LOIS CAPPS","DON REGAN","Democrat",0.630298366332783,70054,237906,0.294460837473624
2004,"CALIFORNIA",24,96397,178660,284378,"BRETT WAGNER","ELTON GALLEGLY","Republican",0.628248317380388,-82263,275057,-0.299076191480311
2004,"CALIFORNIA",25,80395,145575,225970,"FRED ""TIM"" WILLOUGHBY","HOWARD P ""BUCK"" MCKEON","Republican",0.644222684427136,-65180,225970,-0.288445368854273
2004,"CALIFORNIA",26,107522,134596,251207,"CYNTHIA M MATTHEWS","DAVID DREIER","Republican",0.53579717125717,-27074,242118,-0.111821508520639
2004,"CALIFORNIA",27,125296,66946,201198,"BRAD SHERMAN","ROBERT M LEVY","Democrat",0.622749729122556,58350,192242,0.303523683690349
2004,"CALIFORNIA",28,115303,37868,162510,"HOWARD L BERMAN","DAVID HERNANDEZ","Democrat",0.709513260722417,77435,153171,0.505546089011628
2004,"CALIFORNIA",29,133670,62871,206832,"ADAM B SCHIFF","HARRY FRANK SCOLINOS","Democrat",0.646273303937495,70799,196541,0.360225092983143
2004,"CALIFORNIA",30,216682,87465,304147,"HENRY A WAXMAN","VICTOR ELIZALDE","Democrat",0.712425241741658,129217,304147,0.424850483483316
2004,"CALIFORNIA",31,89363,22048,111411,"XAVIER BECERRA","LUIS VEGA","Democrat",0.802102126360952,67315,111411,0.604204252721904
2004,"CALIFORNIA",34,82282,28175,110457,"LUCILLE ROYBAL-ALLARD","WAYNE MILLER","Democrat",0.744923363842943,54107,110457,0.489846727685887
2004,"CALIFORNIA",35,125949,23591,156407,"MAXINE WATERS","ROSS MOEN","Democrat",0.805264470260282,102358,149540,0.684485756319379
2004,"CALIFORNIA",36,151208,81666,244044,"JANE HARMAN","PAUL WHITEHEAD","Democrat",0.619593188113619,69542,232874,0.298625007514793
2004,"CALIFORNIA",37,118823,31960,158318,"JUANITA MILLENDER-MCDONALD","VERNON VAN","Democrat",0.750533735898634,86863,150783,0.576079531512173
2004,"CALIFORNIA",39,100132,64832,164964,"LINDA T SANCHEZ","TIM ESCOBAR","Democrat",0.606993040905895,35300,164964,0.213986081811789
2004,"CALIFORNIA",40,69684,147617,217301,"J TILMAN WILLIAMS","EDWARD R ROYCE","Republican",0.679320389689877,-77933,217301,-0.358640779379754
2004,"CALIFORNIA",42,78393,167632,246025,"LEWIS MYERS","GARY G MILLER","Republican",0.681361650238797,-89239,246025,-0.362723300477594
2004,"CALIFORNIA",43,86830,44004,130834,"JOE BACA","ED LANING","Democrat",0.663665408074354,42826,130834,0.327330816148708
2004,"CALIFORNIA",44,78796,138768,225123,"LOUIS VANDENBERG","KEN CALVERT","Republican",0.616409696032835,-59972,217564,-0.275652221874943
2004,"CALIFORNIA",45,76967,153523,230490,"RICHARD J MEYER","MARY BONO","Republican",0.666072280793093,-76556,230490,-0.332144561586186
2004,"CALIFORNIA",46,90129,171318,276690,"JIM BRANDT","DANA ROHRABACHER","Republican",0.61916946763526,-81189,261447,-0.310537126071441
2004,"CALIFORNIA",47,65684,43099,108783,"LORETTA SANCHEZ","ALEXANDRIA A ""ALEX"" CORONADO","Democrat",0.603807580228528,22585,108783,0.207615160457057
2004,"CALIFORNIA",48,93525,189004,290872,"JOHN GRAHAM","CHRISTOPHER COX","Republican",0.649784097472428,-95479,282529,-0.337944069458356
2004,"CALIFORNIA",49,79057,141658,226466,"MIKE BYRON","DARRELL E ISSA","Republican",0.625515529925022,-62601,220715,-0.28362820832295
2004,"CALIFORNIA",50,105590,169025,289328,"FRANCINE P BUSBY","RANDY ""DUKE"" CUNNINGHAM","Republican",0.584198556655422,-63435,274615,-0.230996121843308
2004,"CALIFORNIA",51,111441,63526,180879,"BOB FILNER","MICHAEL GIORGINO","Democrat",0.6161080059045,47915,174967,0.273851640595084
2004,"CALIFORNIA",52,74857,187799,271438,"BRIAN S KELIHER","DUNCAN HUNTER","Republican",0.69186701935617,-112942,262656,-0.429999695419103
2004,"CALIFORNIA",53,146449,63897,221436,"SUSAN A DAVIS","DARIN HUNZEKER","Democrat",0.661360393070684,82552,210346,0.39245814039725
2004,"COLORADO",1,177077,58659,240929,"DIANA DEGETTE","ROLAND CHICAS","Democrat",0.734975864258765,118418,235736,0.502333118403638
2004,"COLORADO",2,207900,94160,309364,"MARK UDALL","STEPHEN M HACKMAN","Democrat",0.672023894182904,113740,302060,0.376547705753824
2004,"COLORADO",3,153500,141376,303646,"JOHN SALAZAR","GREG WALCHER","Democrat",0.50552287861523,12124,294876,0.0411155875690121
2004,"COLORADO",4,136812,155958,305509,"STAN MATSUNAKA","MARILYN N MUSGRAVE","Republican",0.510485779469672,-19146,292770,-0.0653960446767087
2004,"COLORADO",5,74098,193333,274058,"FRED HARDEE","JOEL HEFLEY","Republican",0.705445562618132,-119235,267431,-0.4458533229132
2004,"COLORADO",6,139870,212778,357741,"JOANNA L CONTI","THOMAS G TANCREDO","Republican",0.594782258673174,-72908,352648,-0.206744402350219
2004,"COLORADO",7,106026,135571,247764,"DAVE THOMAS","BOB BEAUPREZ","Republican",0.5471779596713,-29545,241597,-0.122290425791711
2004,"CONNECTICUT",1,198802,73601,272403,"JOHN B LARSON","JOHN M HALSTEAD","Democrat",0.729808408864807,125201,272403,0.459616817729614
2004,"CONNECTICUT",2,140536,166412,307078,"JIM SULLIVAN","ROB SIMMONS","Republican",0.541920945167026,-25876,306948,-0.0843009239349988
2004,"CONNECTICUT",3,200638,69160,276980,"ROSA L DELAURO","RICHTER ELSER","Democrat",0.724377211351,131478,269798,0.48732014321826
2004,"CONNECTICUT",4,138333,152493,290830,"DIANE FARRELL","CHRISTOPHER SHAYS","Republican",0.524337241687584,-14160,290826,-0.0486889067689959
2004,"CONNECTICUT",5,107438,168268,281447,"THERESA B GERRATANA","NANCY L JOHNSON","Republican",0.597867449288854,-60830,275706,-0.220633573444176
2004,"DELAWARE",0,105716,245978,356045,"PAUL DONNELLY","MICHAEL N CASTLE","Republican",0.690862110126529,-140262,351694,-0.398818290900612
2004,"FLORIDA",1,72506,236604,309110,"MARK S COUTU","JEFF MILLER","Republican",0.765436252466759,-164098,309110,-0.530872504933519
2004,"FLORIDA",2,201577,125399,326987,"ALLEN BOYD","BEV KILMER","Democrat",0.616467932975929,76178,326976,0.232977343902916
2004,"FLORIDA",5,124140,240315,364488,"ROBERT G WHITTEL","GINNY BROWN-WAITE","Republican",0.659322117600579,-116175,364455,-0.318763633370375
2004,"FLORIDA",6,116680,211137,327853,"DAVID E BRUDERLY","CLIFF STEARNS","Republican",0.643998987351038,-94457,327817,-0.288139419249154
2004,"FLORIDA",8,112343,172232,284575,"STEPHEN MURRAY","RIC KELLER","Republican",0.605225336027409,-59889,284575,-0.210450672054819
2004,"FLORIDA",10,91658,207175,298833,"ROBERT D ""BOB"" DERRY","C W BILL YOUNG","Republican",0.693280193285213,-115517,298833,-0.386560386570426
2004,"FLORIDA",12,96965,179204,276169,"BOB HAGENMAIER","ADAM H PUTNAM","Republican",0.648892525953311,-82239,276169,-0.297785051906622
2004,"FLORIDA",13,153961,190477,344438,"JAN SCHNEIDER","KATHERINE HARRIS","Republican",0.553008088538431,-36516,344438,-0.106016177076861
2004,"FLORIDA",14,108672,226662,335334,"ROBERT M NEELD","CONNIE MACK","Republican",0.675929073699655,-117990,335334,-0.351858147399309
2004,"FLORIDA",15,111538,210388,321926,"SIMON PRISTOOP","DAVE WELDON","Republican",0.653529071898511,-98850,321926,-0.307058143797022
2004,"FLORIDA",16,101247,215563,316810,"JEFF FISHER","MARK FOLEY","Republican",0.680417284807929,-114316,316810,-0.360834569615858
2004,"FLORIDA",18,78281,143647,221928,"SAM SHELDON","ILEANA ROS-LEHTINEN","Republican",0.647268483472117,-65366,221928,-0.294536966944234
2004,"FLORIDA",20,191195,81213,272408,"DEBBIE WASSERMAN SCHULTZ","MARGARET HOSTETTER","Democrat",0.701869989133946,109982,272408,0.403739978267892
2004,"FLORIDA",22,108258,192581,306726,"ROBIN RORAPAUGH","E CLAY SHAW JR","Republican",0.627860044469657,-84323,300839,-0.280292781188609
2004,"GEORGIA",2,129984,64645,194629,"SANFORD D BISHOP JR","DAVE EVERSMAN","Democrat",0.667855252814329,65339,194629,0.335710505628658
2004,"GEORGIA",3,136273,80435,216708,"JIM MARSHALL","CALDER CLAY","Democrat",0.628832345829411,55838,216708,0.257664691658822
2004,"GEORGIA",4,157461,89509,246970,"CYNTHIA MCKINNEY","CATHERINE DAVIS","Democrat",0.637571364943111,67952,246970,0.275142729886221
2004,"GEORGIA",8,73632,227524,301156,"SILVIA DELAMAR","LYNN WESTMORELAND","Republican",0.75550213178552,-153892,301156,-0.51100426357104
2004,"GEORGIA",9,68462,197869,266331,"BOB ELLIS","CHARLIE NORWOOD","Republican",0.742943930672734,-129407,266331,-0.485887861345469
2004,"GEORGIA",11,89591,120696,210287,"RICK CRAWFORD","PHIL GINGREY","Republican",0.573958447264928,-31105,210287,-0.147916894529857
2004,"GEORGIA",12,113036,105132,218168,"JOHN BARROW","MAX BURNS","Democrat",0.51811448058377,7904,218168,0.0362289611675406
2004,"HAWAII",1,128567,69371,204181,"NEIL ABERCROMBIE","DALTON TANONAKA","Democrat",0.629671712843017,59196,197938,0.299063343067021
2004,"HAWAII",2,133317,79072,212389,"ED CASE","MIKE GABBARD","Democrat",0.627701999632749,54245,212389,0.255403999265499
2004,"IDAHO",1,90927,207662,298589,"NAOMI PRESTON","C L ""BUTCH"" OTTER","Republican",0.69547773025798,-116735,298589,-0.39095546051596
2004,"IDAHO",2,80133,193704,273837,"LIN WHITWORTH","MICHAEL K SIMPSON","Republican",0.707369712639271,-113571,273837,-0.414739425278542
2004,"ILLINOIS",1,212109,37840,249949,"BOBBY L RUSH","RAYMOND G WARDINGLEY","Democrat",0.848609116259717,174269,249949,0.697218232519434
2004,"ILLINOIS",3,167034,57845,229956,"DANIEL WILLIAM LIPINSKI","RYAN CHLADA","Democrat",0.726373741063508,109189,224879,0.485545560056742
2004,"ILLINOIS",4,104761,15536,125142,"LUIS V GUTIERREZ","TONY CISNEROS","Democrat",0.837137012353966,89225,120297,0.741705944454143
2004,"ILLINOIS",5,158400,49530,207930,"RAHM EMANUEL","BRUCE BEST","Democrat",0.761794834800173,108870,207930,0.523589669600346
2004,"ILLINOIS",6,110470,139627,250097,"CHRISTINE CEGELIS","HENRY J HYDE","Republican",0.558291382943418,-29157,250097,-0.116582765886836
2004,"ILLINOIS",7,221133,35603,256736,"DANNY K DAVIS","ANTONIO DAVIS-FAIRMAN","Democrat",0.861324473389007,185530,256736,0.722648946778013
2004,"ILLINOIS",8,139792,130601,270393,"MELISSA BEAN","PHILIP M CRANE","Democrat",0.51699563228338,9191,270393,0.0339912645667602
2004,"ILLINOIS",9,175282,56135,231417,"JANICE D SCHAKOWSKY","KURT J ECKHARDT","Democrat",0.757429229486166,119147,231417,0.514858458972331
2004,"ILLINOIS",10,99218,177493,276711,"LEE GOODMAN","MARK STEVEN KIRK","Republican",0.641438179183336,-78275,276711,-0.282876358366671
2004,"ILLINOIS",11,121903,173057,294960,"TARI RENNER","JERRY WELLER","Republican",0.586713452671549,-51154,294960,-0.173426905343097
2004,"ILLINOIS",12,198962,82677,286435,"JERRY F COSTELLO","ERIN R ZWEIGART","Democrat",0.694614834081031,116285,281639,0.412886709582125
2004,"ILLINOIS",13,107836,200472,308312,"GLORIA SCHOR ANDERSEN","JUDY BIGGERT","Republican",0.650224447961805,-92636,308308,-0.300465767998236
2004,"ILLINOIS",14,87590,191618,279208,"RUBEN ZAMORA","J DENNIS HASTERT","Republican",0.686291223747171,-104028,279208,-0.372582447494341
2004,"ILLINOIS",15,113625,178114,291739,"DAVID GILL","TIMOTHY V JOHNSON","Republican",0.610525161188597,-64489,291739,-0.221050322377193
2004,"ILLINOIS",16,91452,204350,295806,"JOHN H KUTSCH","DONALD A MANZULLO","Republican",0.690824391662103,-112898,295802,-0.381667466751408
2004,"ILLINOIS",17,172320,111680,284000,"LANE EVANS","ANDREA LANE ZINGA","Democrat",0.606760563380282,60640,284000,0.213521126760563
2004,"ILLINOIS",18,91548,216047,307595,"STEVE WATERWORTH","RAY LAHOOD","Republican",0.702374876054552,-124499,307595,-0.404749752109105
2004,"ILLINOIS",19,94303,213451,307754,"TIM BAGWELL","JOHN SHIMKUS","Republican",0.693576687874081,-119148,307754,-0.387153375748162
2004,"INDIANA",1,178406,82858,261264,"PETER J VISCLOSKY","MARK J LEYVA","Democrat",0.682857186600527,95548,261264,0.365714373201053
2004,"INDIANA",2,115513,140496,259355,"JOE DONNELLY","CHRIS CHOCOLA","Republican",0.541713095949567,-24983,256009,-0.0975864129776687
2004,"INDIANA",3,76232,171389,247621,"MARIA M PASSA","MARK E SOUDER","Republican",0.692142427338554,-95157,247621,-0.384284854677107
2004,"INDIANA",4,77574,190445,274136,"DAVID SANDERS","STEVE BUYER","Republican",0.69470992500073,-112871,268019,-0.421130591487917
2004,"INDIANA",5,82637,228718,318363,"KATHERINE FOX CARR","DAN BURTON","Republican",0.718418911745398,-146081,311355,-0.469178269178269
2004,"INDIANA",6,85123,182529,272049,"MEL FOX","MIKE PENCE","Republican",0.670941631838382,-97406,267652,-0.363927786827672
2004,"INDIANA",7,121303,97491,223175,"JULIA CARSON","ANDREW ""ANDY"" HORNING","Democrat",0.543533101825921,23812,218794,0.108832966169091
2004,"INDIANA",8,121522,145576,272778,"JON P JENNINGS","JOHN N HOSTETTLER","Republican",0.533679402297839,-24054,267098,-0.0900568330725052
2004,"INDIANA",9,140772,142197,287510,"BARON P HILL","MIKE SODREL","Republican",0.494581058050155,-1425,282969,-0.00503588732334637
2004,"IOWA",1,125490,159993,290054,"BILL GLUBA","JIM NUSSLE","Republican",0.55159728878071,-34503,285483,-0.120858334822038
2004,"IOWA",2,117405,176684,299881,"DAVE FRANKER","JAMES A LEACH","Republican",0.589180374882037,-59279,294089,-0.201568232745869
2004,"IOWA",3,168007,136099,304319,"LEONARD L BOSWELL","STAN THOMPSON","Democrat",0.552075289416698,31908,304106,0.104923940994259
2004,"IOWA",4,116121,181294,297566,"PAUL W JOHNSON","TOM LATHAM","Republican",0.609256433866772,-65173,297415,-0.219131516567759
2004,"IOWA",5,97597,168583,266341,"E JOYCE SCHULTE","STEVE KING","Republican",0.632959251485877,-70986,266180,-0.266684198662559
2004,"KANSAS",2,121532,165325,294436,"NANCY BOYDA","JIM RYUN","Republican",0.561497235392411,-43793,286857,-0.152664916665795
2004,"KANSAS",3,184050,145542,335739,"DENNIS MOORE","KRIS KOBACH","Democrat",0.548193686166933,38508,329592,0.116835360081555
2004,"KANSAS",4,81388,173151,261915,"MICHAEL KINARD","TODD KINARD","Republican",0.661096157150221,-91763,254539,-0.360506641418407
2004,"KENTUCKY",1,85229,175972,261387,"BILLY R CARTWRIGHT","ED WHITFIELD","Republican",0.673223993542142,-90743,261201,-0.347406786344616
2004,"KENTUCKY",2,87585,185394,272979,"ADAM SMITH","RON LEWIS","Republican",0.679151143494555,-97809,272979,-0.358302286989109
2004,"KENTUCKY",3,124040,197736,328154,"TONY MILLER","ANNE M NORTHUP","Republican",0.602570744223749,-73696,321776,-0.229028889662374
2004,"KENTUCKY",4,129876,160982,295927,"NICK CLOONEY","GEOFF DAVIS","Republican",0.543992268363482,-31106,290858,-0.106945657331069
2004,"KENTUCKY",6,175355,119716,299217,"BEN CHANDLER","TOM BUFORD","Democrat",0.586046247372308,55639,295071,0.188561397087481
2004,"LOUISIANA",1,54214,233683,287897,"""JERRY"" WATTS","""BOBBY"" JINDAL","Republican",0.811689597321264,-179469,287897,-0.623379194642528
2004,"LOUISIANA",2,173510,46097,219607,"WILLIAM J JEFFERSON","ARTHUR L ""ART"" SCHWERTZ","Democrat",0.79009321196501,127413,219607,0.58018642393002
2004,"LOUISIANA",3,57611,57042,114653,"""CHARLIE"" MELANCON","W J ""BILLY"" TAUZIN III","Democrat",0.502481400399466,569,114653,0.00496280079893243
2004,"LOUISIANA",5,58591,179466,238057,"ZELMA ""TISA"" BLAKES","JOHN W ""JOCK"" SCOTT","Republican",0.75387827285062,-120875,238057,-0.50775654570124
2004,"LOUISIANA",6,72763,189106,261869,"EDWARD ANTHONY ""SCOTT"" GALMON","RICHARD H BAKER","Republican",0.722139695802099,-116343,261869,-0.444279391604199
2004,"LOUISIANA",7,61493,75039,136532,"WILLIE LAUNDRY MOUNT","CHARLES BOUSTANY JR","Republican",0.549607418041192,-13546,136532,-0.0992148360823836
2004,"MAINE",1,219077,147663,366740,"THOMAS H ALLEN","CHARLES E SUMMERS JR","Democrat",0.597363254621803,71414,366740,0.194726509243606
2004,"MAINE",2,199303,135547,343436,"MICHAEL H MICHAUD","BRIAN N HAMEL","Democrat",0.580320641982786,63756,334850,0.190401672390623
2004,"MARYLAND",1,77872,245149,323021,"KOSTAS ALEXAKIS","WAYNE T GILCHREST","Republican",0.758925890267196,-167277,323021,-0.517851780534393
2004,"MARYLAND",2,164751,75812,247071,"C A DUTCH RUPPERSBERGER","JANE BROOKS","Democrat",0.66681642119067,88939,240563,0.369711884204969
2004,"MARYLAND",3,182066,97008,286969,"BENJAMIN L CARDIN","ROBERT P DUCKWORTH","Democrat",0.63444483550488,85058,279074,0.304786544070748
2004,"MARYLAND",4,196809,52907,261607,"ALBERT RUSSELL WYNN","JOHN MCKINNIS","Democrat",0.752307851089612,143902,249716,0.576262634352625
2004,"MARYLAND",5,204867,87189,298129,"STENY H HOYER","BRAD JEWITT","Democrat",0.687175685693106,117678,292056,0.402929575149971
2004,"MARYLAND",6,90108,206076,305508,"KENNETH T BOSLEY","ROSCOE G BARTLETT","Republican",0.674535527711222,-115968,296184,-0.391540393809254
2004,"MARYLAND",7,179189,60102,244018,"ELIJAH E CUMMINGS","TONY SALAZAR","Democrat",0.734326975878829,119087,239291,0.497666021705789
2004,"MARYLAND",8,215208,71989,287197,"CHRIS VAN HOLLEN","CHUCK FLOYD","Democrat",0.749339303683534,143219,287197,0.498678607367069
2004,"MASSACHUSETTS",3,192036,80197,285996,"JAMES P MCGOVERN","RONALD A CREWS","Democrat",0.671463936558553,111839,272233,0.410820877704026
2004,"MASSACHUSETTS",5,179652,88232,280310,"MARTIN T MEEHAN","THOMAS P TIERNEY","Democrat",0.640904712639578,91420,267884,0.341267115617207
2004,"MASSACHUSETTS",6,213458,91597,321736,"JOHN F TIERNEY","STEPHEN P O'MALLEY JR","Democrat",0.663456995797797,121861,305055,0.399472226319844
2004,"MASSACHUSETTS",7,202399,60334,292187,"EDWARD J MARKEY","KENNETH G CHASE","Democrat",0.69270364526827,142065,262733,0.54072004658722
2004,"MASSACHUSETTS",10,222013,114879,350738,"WILLIAM D DELAHUNT","MICHAEL J JONES","Democrat",0.632988156401645,107134,336892,0.318006957719388
2004,"MICHIGAN",1,211571,105706,322674,"BART STUPAK","DON HOOPER","Democrat",0.655680346107836,105865,317277,0.333667426255291
2004,"MICHIGAN",2,94040,225343,325005,"KIMON KOTOS","PETER HOEKSTRA","Republican",0.693352409962924,-131303,319383,-0.411114555251845
2004,"MICHIGAN",3,101395,214465,322103,"PETER H HICKEY","VERNON J EHLERS","Republican",0.665827390617287,-113070,315860,-0.357975052238333
2004,"MICHIGAN",4,110885,205274,318924,"MIKE HUCKLEBERRY","DAVE CAMP","Republican",0.64364550802072,-94389,316159,-0.298549147738954
2004,"MICHIGAN",5,208163,96934,309915,"DALE E KILDEE","MYRAH KIRKWOOD","Democrat",0.671677718083991,111229,305097,0.364569300910858
2004,"MICHIGAN",6,97978,197425,302158,"SCOTT ELLIOTT","FRED UPTON","Republican",0.653383329251584,-99447,295403,-0.336648578382752
2004,"MICHIGAN",7,109527,176053,301642,"SHARON MARIE RENIER","JOE SCHWARZ","Republican",0.583648828744008,-66526,285580,-0.232950486728763
2004,"MICHIGAN",8,125619,207925,340694,"ROBERT D ALEXANDER","MIKE ROGERS","Republican",0.610298390931452,-82306,333544,-0.246762046386684
2004,"MICHIGAN",9,134764,199210,340799,"STEVEN W REIFMAN","JOE KNOLLENBERG","Republican",0.584538100170482,-64446,333974,-0.19296711720074
2004,"MICHIGAN",10,98029,227720,331868,"ROB CASEY","CANDICE S MILLER","Republican",0.686176431593284,-129691,325749,-0.398131690350546
2004,"MICHIGAN",11,134301,186431,327216,"PHILIP S TRUTAN","THADDEUS G MCCOTTER","Republican",0.569749034277052,-52130,320732,-0.162534452440043
2004,"MICHIGAN",12,210827,88256,304134,"SANDER M LEVIN","RANDELL J SHAFER","Democrat",0.693204311257538,122571,299083,0.409822691359923
2004,"MICHIGAN",13,173246,40935,221654,"CAROLYN C KILPATRICK","CYNTHIA CASSELL","Democrat",0.781605565430807,132311,214181,0.617753208734668
2004,"MICHIGAN",14,213681,35089,254580,"JOHN CONYERS JR","VERONICA PEDRAZA","Democrat",0.839347160028282,178592,248770,0.717900068336214
2004,"MICHIGAN",15,218409,81828,307963,"JOHN D DINGELL","DAWN ANNE REAMER","Democrat",0.709205326613911,136581,300237,0.454910620609718
2004,"MISSISSIPPI",2,154626,107647,264869,"BENNIE G THOMPSON","CLINTON B LESUEUR","Democrat",0.583782926654308,46979,262273,0.179122517376932
2004,"MISSISSIPPI",4,179979,96740,280382,"GENE TAYLOR","MICHAEL LOTT","Democrat",0.641906399126905,83239,276719,0.300806955792699
2004,"MISSOURI",1,213658,64791,283771,"WM LACY CLAY","LESLIE L FAR II","Democrat",0.75292401267219,148867,278449,0.534629321707027
2004,"MISSOURI",2,115366,228725,349867,"GEORGE D WEBER","W TODD AKIN","Republican",0.653748424401272,-113359,344091,-0.329444827095158
2004,"MISSOURI",3,146894,125422,277916,"RUSS CARNAHAN","BILL FEDERER","Democrat",0.528555390837519,21472,272316,0.0788495718209727
2004,"MISSOURI",4,190800,93334,288226,"IKE SKELTON","JAMES A ""JIM"" NOLAND","Democrat",0.661980529168083,97466,284134,0.343028289469053
2004,"MISSOURI",5,161727,123431,293025,"EMANUEL CLEAVER II","JEANNE PATTERSON","Democrat",0.55192219093934,38296,285158,0.134297477188085
2004,"MISSOURI",6,106987,196516,307855,"CHARLES S BROOMFIELD","SAM GRAVES","Republican",0.638339478001007,-89529,303503,-0.294985552037377
2004,"MISSOURI",7,84356,210080,298205,"JIM NEWBERRY","ROY BLUNT","Republican",0.704481816200265,-125724,294436,-0.426999415832303
2004,"MISSOURI",8,71543,194039,268711,"DEAN HENDERSON","JO ANN EMERSON","Republican",0.722110371365519,-122496,265582,-0.461236077746233
2004,"MISSOURI",9,101343,193429,299447,"LINDA JACOBSEN","KENNY C HULSHOF","Republican",0.645954041950662,-92086,294772,-0.31239737831273
2004,"MONTANA",0,145606,286076,444230,"TRACY VELAZQUEZ","DENNIS R REHBERG","Republican",0.64398172118047,-140470,431682,-0.325401568747365
2004,"NEBRASKA",1,113971,143756,265072,"MATT CONNEALY","JEFF FORTENBERRY","Republican",0.54232812217058,-29785,257727,-0.115568023528773
2004,"NEBRASKA",2,90292,152608,249764,"NANCY THOMPSON","LEE TERRY","Republican",0.611008792299931,-62316,242900,-0.256550020584603
2004,"NEBRASKA",3,26434,218751,250136,"DONNA J ANDERSON","TOM OSBORNE","Republican",0.874528256628394,-192317,245185,-0.78437506372739
2004,"NEVADA",1,133569,63005,202436,"SHELLEY BERKLEY","RUSS MICKELSON","Democrat",0.659808532079274,70564,196574,0.358969141392046
2004,"NEVADA",2,79978,195466,291079,"ANGIE G COCHRAN","JIM GIBBONS","Republican",0.671522164086038,-115488,275444,-0.419279417957915
2004,"NEVADA",3,120365,162240,297918,"TOM GALLAGHER","JON PORTER","Republican",0.54457938090347,-41875,282605,-0.148175014596345
2004,"NEW HAMPSHIRE",1,118226,204836,323372,"JUSTIN NADEAU","JEB BRADLEY","Republican",0.633437650755167,-86610,323062,-0.26809095467743
2004,"NEW HAMPSHIRE",2,125280,191188,328194,"PAUL W HODES","CHARLES F BASS","Republican",0.582545689439783,-65908,316468,-0.208261182805213
2004,"NEW JERSEY",1,201163,66109,268203,"ROBERT E ANDREWS","S DANIEL HUTCHISON","Democrat",0.750040081579997,135054,267272,0.505305456613487
2004,"NEW JERSEY",2,86792,172779,265442,"TIMOTHY J ROBB","FRANK A LOBIONDO","Republican",0.650910556731791,-85987,259571,-0.331265819371193
2004,"NEW JERSEY",3,107034,195938,308862,"HERB CONAWAY","JIM SAXTON","Republican",0.63438687828221,-88904,302972,-0.293439657790159
2004,"NEW JERSEY",4,92826,192671,287553,"AMY VAZQUEZ","CHRISTOPHER H SMITH","Republican",0.67003648023147,-99845,285497,-0.3497234646949
2004,"NEW JERSEY",5,122259,171220,297425,"DOROTHEA ANNE WOLFE","SCOTT GARRETT","Republican",0.57567453979995,-48961,293479,-0.166829653910501
2004,"NEW JERSEY",6,153981,70942,230151,"FRANK PALLONE JR","SYLVESTER FERNANDEZ","Democrat",0.669043367180677,83039,224923,0.369188566753956
2004,"NEW JERSEY",7,119081,162597,285847,"STEVE BROZAK","MIKE FERGUSON","Republican",0.568825280657135,-43516,281678,-0.154488458452559
2004,"NEW JERSEY",8,152001,62747,218820,"BILL PASCRELL JR","GEORGE AJJAN","Democrat",0.69463942966822,89254,214748,0.415622031404251
2004,"NEW JERSEY",9,146038,68564,216251,"STEVEN R ROTHMAN","EDWARD TRAWINSKI","Democrat",0.675317108360193,77474,214602,0.361012478914456
2004,"NEW JERSEY",11,91811,200915,296002,"JAMES W BUELL","RODNEY P FRELINGHUYSEN","Republican",0.678762305660097,-109104,292726,-0.372717148459652
2004,"NEW JERSEY",12,171691,115014,289785,"RUSH D HOLT","BILL SPADEA","Democrat",0.592477181358593,56677,286705,0.197684030623812
2004,"NEW JERSEY",13,121018,35288,159541,"ROBERT MENENDEZ","RICHARD W PIATKOWSKI","Democrat",0.75853855748679,85730,156306,0.548475426407176
2004,"NEW MEXICO",1,123339,147372,270905,"RICHARD M ROMERO","HEATHER WILSON","Republican",0.543998818774109,-24033,270711,-0.0887773308066536
2004,"NEW MEXICO",2,86292,130498,216790,"GARY K KING","STEVAN PEARCE","Republican",0.601955809769823,-44206,216790,-0.203911619539647
2004,"NEW MEXICO",3,175269,79935,255204,"TOM UDALL","GREGORY M TUCKER","Democrat",0.686779987774486,95334,255204,0.373559975548973
2004,"NEW YORK",1,140878,110786,313966,"TIMOTHY H BISHOP","WILLIAM M MANGER JR","Democrat",0.448704636807807,30092,251664,0.119572127916587
2004,"NEW YORK",2,147197,72953,283480,"STEVE ISRAEL","RICHARD HOFFMAN","Democrat",0.519250035275857,74244,220150,0.337242789007495
2004,"NEW YORK",3,100737,151323,316125,"BLAIR H MATHIES","PETER T KING","Republican",0.478680901542112,-50586,252060,-0.200690311830517
2004,"NEW YORK",4,148615,85505,284530,"CAROLYN MCCARTHY","JAMES A GARNER","Democrat",0.52231750606263,63110,234120,0.269562617461131
2004,"NEW YORK",5,114132,43002,206533,"GARY L ACKERMAN","STEPHEN GRAVES","Democrat",0.552609026160468,71130,157134,0.452670968727328
2004,"NEW YORK",7,100382,21843,177452,"JOSEPH CROWLEY","JOSEPH CINQUEMAIN","Democrat",0.565685368437662,78539,122225,0.642577214154224
2004,"NEW YORK",8,154098,35177,251650,"JERROLD NADLER","PETER HORT","Democrat",0.612350486787204,118921,189275,0.628297450799102
2004,"NEW YORK",9,108577,39648,202558,"ANTHONY D WEINER","GERARD J CRONIN","Democrat",0.53602918670208,68929,148225,0.465029515938607
2004,"NEW YORK",10,130265,11099,195241,"EDOLPHUS TOWNS","HARVEY R CLARKE","Democrat",0.667201048960003,119166,141364,0.842972751195495
2004,"NEW YORK",12,100402,15697,163344,"NYDIA M VELAZQUEZ","PAUL A RODRIGUEZ","Democrat",0.614665980997159,84705,116099,0.729592847483613
2004,"NEW YORK",13,72180,102713,217895,"FRANK J BARBARO","VITO FOSSELLA","Republican",0.471387594942518,-30533,174893,-0.174581029543778
2004,"NEW YORK",14,175886,41936,274043,"CAROLYN B MALONEY","ANTON SRDANOVIC","Democrat",0.641818984611904,133950,217822,0.614951657775615
2004,"NEW YORK",15,153099,12355,218608,"CHARLES B RANGEL","KENNETH P JEFFERSON JR","Democrat",0.700335760813877,140744,165454,0.850653353802265
2004,"NEW YORK",16,106739,4917,148123,"JOSE E SERRANO","ALI MOHAMED","Democrat",0.720610573644876,101822,111656,0.911925915311313
2004,"NEW YORK",17,135344,40524,230261,"ELIOT L ENGEL","MATT I BRENNAN","Democrat",0.587785165529551,94820,175868,0.539154365774331
2004,"NEW YORK",18,159072,73975,290215,"NITA M LOWEY","RICHARD A HOFFMAN","Democrat",0.5481177747532,85097,233047,0.365149519195699
2004,"NEW YORK",19,87429,152051,306733,"MICHAEL JALIMAN","SUE W KELLY","Republican",0.495711253761415,-64622,239480,-0.269842993151829
2004,"NEW YORK",20,96630,163343,324160,"DORIS F KELLY","JOHN E SWEENEY","Republican",0.503896224086871,-66713,259973,-0.256615110030657
2004,"NEW YORK",21,167247,80121,311854,"MICHAEL R MCNULTY","WARREN REDLICH","Democrat",0.536299037370051,87126,247368,0.352212088871641
2004,"NEW YORK",22,148588,81881,287401,"MAURICE D HINCHEY","WILLIAM A BRENNER","Democrat",0.51700585592952,66707,230469,0.28944022840382
2004,"NEW YORK",23,66448,136222,265012,"ROBERT J JOHNSON","JOHN M MCHUGH","Republican",0.514022006550647,-69774,202670,-0.344273942862782
2004,"NEW YORK",24,85140,128493,286686,"JEFFREY A MILLER","SHERWOOD BOEHLERT","Republican",0.448201167828216,-43353,213633,-0.202932131271854
2004,"NEW YORK",26,116484,137425,321080,"JACK DAVIS","THOMAS M REYNOLDS","Republican",0.428008595988539,-20941,253909,-0.0824744298154063
2004,"NEW YORK",27,127267,125275,299699,"BRIAN M HIGGINS","NANCY A NAPLES","Democrat",0.424649398229557,1992,252542,0.00788779688131083
2004,"NEW YORK",28,150431,48981,262220,"LOUISE MCINTOSH SLAUGHTER","MICHAEL D LABA","Democrat",0.57368240408817,101450,199412,0.50874571239444
2004,"NEW YORK",29,104555,136883,306070,"SAMARA BAREND","JOHN RANDY KUHL","Republican",0.447227758355932,-32328,241438,-0.133897729437785
2004,"NORTH CAROLINA",1,137667,77508,215175,"G K BUTTERFIELD","GREG DORITY","Democrat",0.639790867898222,60159,215175,0.279581735796445
2004,"NORTH CAROLINA",2,145079,87811,232890,"BOB ETHERIDGE","BILLY J CREECH","Democrat",0.622950749280776,57268,232890,0.245901498561553
2004,"NORTH CAROLINA",3,71227,171863,243090,"ROGER A EATON","WALTER B JONES","Republican",0.706993294664528,-100636,243090,-0.413986589329055
2004,"NORTH CAROLINA",4,217441,121717,339234,"DAVID E PRICE","TODD A BATCHELOR","Democrat",0.640976435145062,95724,339158,0.28224013586588
2004,"NORTH CAROLINA",5,117271,167546,284817,"JIM A HARRELL JR","VIRGINIA FOXX","Republican",0.588258425585551,-50275,284817,-0.176516851171103
2004,"NORTH CAROLINA",6,76153,207470,283623,"WILLIAM W JORDAN","HOWARD COBLE","Republican",0.731499208456296,-131317,283623,-0.462998416912592
2004,"NORTH CAROLINA",7,180382,66084,246466,"MIKE MCINTYRE","KEN PLONK","Democrat",0.73187376757849,114298,246466,0.463747535156979
2004,"NORTH CAROLINA",8,100101,125070,225171,"BETH TROUTMAN","ROBERT C ""ROBIN"" HAYES","Republican",0.55544452882476,-24969,225171,-0.11088905764952
2004,"NORTH CAROLINA",9,89318,210783,300101,"JACK FLYNN","SUE WILKINS MYRICK","Republican",0.702373534243471,-121465,300101,-0.404747068486943
2004,"NORTH CAROLINA",10,88233,157884,246117,"ANNE N FISCHER","PATRICK MCHENRY","Republican",0.641499774497495,-69651,246117,-0.28299954899499
2004,"NORTH CAROLINA",11,131188,159709,290897,"PATSY KEEVER","CHARLES H TAYLOR","Republican",0.549022506247916,-28521,290897,-0.0980450124958319
2004,"NORTH CAROLINA",12,154908,76898,231806,"MELVIN L WATT","ADA M FISHER","Democrat",0.668265704942926,78010,231806,0.336531409885853
2004,"NORTH CAROLINA",13,160896,112788,273684,"BRAD MILLER","VIRGINIA JOHNSON","Democrat",0.587889682992064,48108,273684,0.175779365984128
2004,"NORTH DAKOTA",0,185130,125684,310814,"EARL POMEROY","DUANE SAND","Democrat",0.595629540496889,59446,310814,0.191259080993778
2004,"OHIO",1,116235,173430,289863,"GREG HARRIS","STEVE CHABOT","Republican",0.59831713602633,-57195,289665,-0.197452229299363
2004,"OHIO",2,89598,227102,316760,"CHARLES W SANDERS","ROB PORTMAN","Republican",0.716952898093194,-137504,316700,-0.434177455004736
2004,"OHIO",3,119448,197290,316738,"JANE MITAKIDES","MICHAEL R TURNER","Republican",0.622880740548971,-77842,316738,-0.245761481097942
2004,"OHIO",4,118538,167807,286345,"BEN KONOP","MICHAEL G OXLEY","Republican",0.586030836927483,-49269,286345,-0.172061673854965
2004,"OHIO",5,96656,196649,293305,"ROBIN WEIRAUCH","PAUL E GILLMOR","Republican",0.670459078433712,-99993,293305,-0.340918156867425
2004,"OHIO",7,100617,186534,287151,"KARA ANASTASIO","DAVID L HOBSON","Republican",0.649602473959694,-85917,287151,-0.299204947919387
2004,"OHIO",8,90574,201675,292249,"JEFF HARDENBROOK","JOHN A BOEHNER","Republican",0.6900793501432,-111101,292249,-0.3801587002864
2004,"OHIO",9,205149,95983,301132,"MARCY KAPTUR","LARRY A KACZALA","Democrat",0.681259381268015,109166,301132,0.362518762536031
2004,"OHIO",10,172406,96463,287212,"DENNIS J KUCINICH","EDWARD FITZPATRICK HERMAN","Democrat",0.600274361795468,75943,268869,0.282453536852519
2004,"OHIO",12,122109,198912,321046,"EDWARD S BROWN","PATRICK J TIBERI","Republican",0.619574764986949,-76803,321021,-0.23924603063351
2004,"OHIO",13,201004,97090,298094,"SHERROD BROWN","ROBERT LUCAS","Democrat",0.674297369286198,103914,298094,0.348594738572397
2004,"OHIO",14,119714,201652,321366,"CAPRI S CAFARO","STEVEN C LATOURETTE","Republican",0.627483927982425,-81938,321366,-0.25496785596485
2004,"OHIO",15,110915,166520,277435,"MARK P BROWN","DEBORAH PRYCE","Republican",0.600212662425433,-55605,277435,-0.200425324850866
2004,"OHIO",16,101817,202544,304361,"JEFF SEEMANN","RALPH REGULA","Republican",0.665472908815518,-100727,304361,-0.330945817631037
2004,"OHIO",17,212800,62871,275671,"TIM RYAN","FRANK V CUSIMANO","Democrat",0.771934661244745,149929,275671,0.543869322489489
2004,"OHIO",18,90820,177600,268420,"BRIAN R THOMAS","ROBERT W NEY","Republican",0.661649653528053,-86780,268420,-0.323299307056106
2004,"OKLAHOMA",1,116731,187145,310934,"DOUG DODD","JOHN SULLIVAN","Republican",0.60188014176642,-70414,303876,-0.231719517171478
2004,"OKLAHOMA",2,179579,92963,272542,"DAN BOREN","WAYLAND SMALLEY","Democrat",0.658903948749184,86616,272542,0.317807897498367
2004,"OKLAHOMA",5,92719,180430,273149,"BERT SMITH","ERNEST J ISTOOK","Republican",0.66055522809895,-87711,273149,-0.321110456197899
2004,"OREGON",1,203771,135164,354338,"DAVID WU","GOLI AMERI","Democrat",0.575075210674554,68607,338935,0.202419342941862
2004,"OREGON",2,88914,248461,346865,"JOGN C MCCOLGAN","GREG WALDEN","Republican",0.716304614187076,-159547,337375,-0.472907002593553
2004,"OREGON",3,245559,82045,346560,"EARL BLUMENAUER","TAMI MARS","Democrat",0.708561288088643,163514,327604,0.499120889854825
2004,"OREGON",4,228611,140882,374909,"PETER A DEFAZIO","JIM FELDKAMP","Democrat",0.60977730595958,87729,369493,0.237430749702971
2004,"OREGON",5,184833,154993,349634,"DARLENE HOOLEY","JIM ZUPANCIC","Democrat",0.528647099538374,29840,339826,0.0878096437588648
2004,"PENNSYLVANIA",1,214462,33266,248585,"ROBERT A BRADY","DEBORAH L WILLIAMS","Democrat",0.862731057787075,181196,247728,0.73143124717432
2004,"PENNSYLVANIA",2,253226,34411,287637,"CHAKA FATTAH","STEWART BOLNO","Democrat",0.880366573146014,218815,287637,0.760733146292028
2004,"PENNSYLVANIA",3,110684,166580,277264,"STEVEN PORTER","PHIL ENGLISH","Republican",0.600799238271106,-55896,277264,-0.201598476542212
2004,"PENNSYLVANIA",4,116303,204329,323917,"STEVAN DROBAC JR","MELISSA A HART","Republican",0.630806657260965,-88026,320632,-0.274539035405075
2004,"PENNSYLVANIA",6,153977,160348,314325,"LOIS MURPHY","JIM GERLACH","Republican",0.510134415016305,-6371,314325,-0.0202688300326096
2004,"PENNSYLVANIA",7,134932,196556,334527,"PAUL SCOLES","CURT WELDON","Republican",0.587563933553943,-61624,331488,-0.185901148759533
2004,"PENNSYLVANIA",8,143427,183229,331264,"VIRGINIA WATERS SCHRADER","MICHAEL G FITZPATRICK","Republican",0.553120773763524,-39802,326656,-0.121846835815047
2004,"PENNSYLVANIA",9,80787,184320,265107,"PAUL I POLITIS","BILL SHUSTER","Republican",0.695266439588544,-103533,265107,-0.390532879177087
2004,"PENNSYLVANIA",13,171763,127205,308124,"ALLYSON SCHWARTZ","MELISSA BROWN","Democrat",0.557447650945723,44558,298968,0.149039362072195
2004,"PENNSYLVANIA",15,114646,170634,291134,"JOE DRISCOLL","CHARLES W DENT","Republican",0.586101245474592,-55988,285280,-0.196256309590578
2004,"PENNSYLVANIA",16,98410,183620,285299,"LOIS K HERR","JOSEPH R PITTS","Republican",0.643605480566003,-85210,282030,-0.302130978973868
2004,"PENNSYLVANIA",17,172412,113592,291786,"TIM HOLDEN","SCOTT PATERNO","Democrat",0.590885100724504,58820,286004,0.20566145928029
2004,"PENNSYLVANIA",18,117420,197894,315314,"MARK G BOLES","TIM MURPHY","Republican",0.627609303741667,-80474,315314,-0.255218607483334
2004,"RHODE ISLAND",1,124923,69819,195010,"PATRICK J KENNEDY","DAVID W ROGERS","Democrat",0.640597918055484,55104,194742,0.282958991896971
2004,"RHODE ISLAND",2,154392,43139,207165,"JAMES R LANGEVIN","ARTHUR CHUCK BARTON III","Democrat",0.745261023821592,111253,197531,0.563217925287676
2004,"SOUTH CAROLINA",2,93249,181862,279870,"MICHAEL RAY ELLISOR","JOE WILSON","Republican",0.649808839818487,-88613,275111,-0.322099080007706
2004,"SOUTH CAROLINA",4,78376,188795,270594,"BRANDON P BROWN","BOB INGLIS","Republican",0.697705788007125,-110419,267171,-0.413289616013714
2004,"SOUTH CAROLINA",5,152867,89568,242518,"JOHN M SPRATT JR","ALBERT F SPENCER","Democrat",0.630332593869321,63299,242435,0.261096788829996
2004,"SOUTH CAROLINA",6,161987,75443,241829,"JAMES E CLYBURN","GARY MCLEOD","Democrat",0.669841086056676,86544,237430,0.364503222002274
2004,"SOUTH DAKOTA",0,207837,178823,389468,"STEPHANIE HERSETH","LARRY DIEDRICH","Democrat",0.533643328848583,29014,386660,0.0750375006465629
2004,"TENNESSEE",1,56361,172543,233560,"GRAHAM LEONARD","WILLIAM L JENKINS","Republican",0.738752354855283,-116182,228904,-0.507557753468703
2004,"TENNESSEE",2,52155,215795,272928,"JOHN GREENE","JOHN J DUNCAN","Republican",0.790666402860828,-163640,267950,-0.610710953536107
2004,"TENNESSEE",3,84295,166154,256636,"JOHN WOLFE","ZACH WAMP","Republican",0.647430602097913,-81859,250449,-0.326848979233297
2004,"TENNESSEE",4,138459,109993,252646,"LINCOLN DAVIS","JANICE BOWLING","Democrat",0.548035591301663,28466,248452,0.114573438732632
2004,"TENNESSEE",5,168970,74978,243963,"JIM COOPER","SCOTT KNAPP","Democrat",0.692605026172001,93992,243948,0.385295226851624
2004,"TENNESSEE",6,167448,87523,260642,"BART GORDON","NICK DEMAS","Democrat",0.642444425687341,79925,254971,0.313467021739727
2004,"TENNESSEE",8,173623,59853,233567,"JOHN S TANNER","JAMES L HART","Democrat",0.743354155338725,113770,233476,0.487287772619027
2004,"TENNESSEE",9,190648,41578,232392,"HAROLD E FORD JR","RUBEN E FORT","Democrat",0.820372474095494,149070,232226,0.64191778698337
2004,"TEXAS",1,96281,157068,255507,"MAX SANDLIN","LOUIE GOHMERT","Republican",0.614730711878735,-60787,253349,-0.239933846196354
2004,"TEXAS",2,108156,139951,252038,"NICK LAMPSON","TED POE","Republican",0.555277378807958,-31795,248107,-0.128150354484154
2004,"TEXAS",4,81585,182866,267942,"JIM NICKERSON","RALPH M HALL","Republican",0.682483522553388,-101281,264451,-0.382985883963381
2004,"TEXAS",5,75911,148816,230845,"BILL BERNSTEIN","JEB HENSARLING","Republican",0.644657670731443,-72905,224727,-0.324415846782986
2004,"TEXAS",6,83609,168767,255627,"MORRIS MEYER","JOE BARTON","Republican",0.660208037492127,-85158,252376,-0.337425111738042
2004,"TEXAS",7,91126,175440,273651,"JOHN MARTINEZ","JOHN ABNEY CULBERSON","Republican",0.641108565289365,-84314,266566,-0.316296902080535
2004,"TEXAS",8,77324,179599,260628,"JAMES ""JIM"" WRIGHT","KEVIN BRADY","Republican",0.689100940804518,-102275,256923,-0.39807646648996
2004,"TEXAS",9,114462,42132,158566,"AL GREEN","ARLETTE MOLINA","Democrat",0.721857144659006,72330,156594,0.461895091765968
2004,"TEXAS",11,50339,177291,230977,"WAYNE RAASCH","MIKE CONAWAY","Republican",0.767569931205272,-126952,227630,-0.55771207661556
2004,"TEXAS",12,66316,173222,239538,"FELIX ALVARADO","KAY GRANGER","Republican",0.723150397849193,-106906,239538,-0.446300795698386
2004,"TEXAS",15,96089,67917,166358,"RUBEN HINOJOSA","MICHAEL D THAMM","Democrat",0.577603722093317,28172,164006,0.171774203382803
2004,"TEXAS",16,108577,49972,160773,"SILVESTRE REYES","DAVID BRIGHAM","Democrat",0.675343496731416,58605,158549,0.369633362556686
2004,"TEXAS",17,125309,116049,244748,"CHET EDWARDS","ARLENE WOHLGEMUTH","Democrat",0.511991926389593,9260,241358,0.0383662443341426
2004,"TEXAS",18,136018,9787,152988,"SHEILA JACKSON-LEE","TOM BAZAN","Democrat",0.889076267419667,126231,145805,0.86575220328521
2004,"TEXAS",19,93531,136459,233514,"CHARLES W STENHOLM","RANDY NEUGEBAUER","Republican",0.584371814966126,-42928,229990,-0.186651593547546
2004,"TEXAS",20,112480,54976,171804,"CHARLES A GONZALEZ","ROGER SCOTT","Democrat",0.654699541337804,57504,167456,0.343397668641315
2004,"TEXAS",21,121129,209774,341119,"RHETT R SMITH","LAMAR S SMITH","Republican",0.614958416271155,-88645,330903,-0.267888172666914
2004,"TEXAS",22,112034,150386,272620,"RICHARD R MORRISON","TOM DELAY","Republican",0.551632308708092,-38352,262420,-0.146147397302035
2004,"TEXAS",23,72480,170716,246503,"JOE SULLIVAN","HENRY BONILLA","Republican",0.69255140911064,-98236,243196,-0.403937564762578
2004,"TEXAS",24,82599,154435,241374,"GARY R PAGE","KENNY MARCHANT","Republican",0.639816218813957,-71836,237034,-0.303062007981977
2004,"TEXAS",25,108309,49252,160217,"LLOYD DOGETT","REBECCA ARMENDARIZ KLEIN","Democrat",0.676014405462591,59057,157561,0.37481991101859
2004,"TEXAS",26,89809,180519,274539,"LICO REYES","MICHAEL C BURGESS","Republican",0.657534995028029,-90710,270328,-0.335555325382498
2004,"TEXAS",27,112081,61955,177536,"SOLOMON P ORTIZ","WILLIAM ""WILLIE"" VADEN","Democrat",0.631314212328767,50126,174036,0.288020869245443
2004,"TEXAS",28,106323,69538,180166,"HENRY CUELLAR","JAMES ""JIM"" F HOPSON","Democrat",0.590139093946694,36785,175861,0.209170879273972
2004,"TEXAS",31,80292,160247,247427,"JON PORTER","JOHN R CARTER","Republican",0.647653651380003,-79955,240539,-0.332399319860813
2004,"TEXAS",32,89030,109859,202236,"MARTIN FROST","PETE SESSIONS","Republican",0.543221780494076,-20829,198889,-0.10472675713589
2004,"UTAH",1,85630,199615,293961,"STEVEN THOMPSON","ROB BISHOP","Republican",0.679052663448553,-113985,285245,-0.399603849322512
2004,"UTAH",2,187250,147778,341968,"JIM MATHESON","JOHN SWALLOW","Democrat",0.547565854115005,39472,335028,0.117817018279069
2004,"UTAH",3,88748,173010,272928,"BEAU BABKA","CHRIS CANNON","Republican",0.633903447062962,-84262,261758,-0.32190802191337
2004,"VERMONT",0,21684,74271,305008,"LARRY DROWN","GREG PARKE","Republican",0.243505088391124,-52587,95955,-0.548038142879475
2004,"VIRGINIA",2,108180,132946,241380,"DAVID B ASHE","THELMA D DRAKE","Republican",0.550774712072251,-24766,241126,-0.102709786584607
2004,"VIRGINIA",3,159373,70194,229892,"ROBERT C SCOTT","WINSOME E SEARS","Democrat",0.693251613801263,89179,229567,0.388466112289658
2004,"VIRGINIA",4,100413,182444,283027,"JONATHAN R MENEFEE","J RANDY FORBES","Republican",0.644616944673123,-82031,282857,-0.290008732327643
2004,"VIRGINIA",5,98237,172431,270758,"AL C WEED II","VIRGIL H GOODE JR","Republican",0.63684544870327,-74194,270668,-0.274114413229491
2004,"VIRGINIA",8,171986,106231,287919,"JAMES P MORAN","LISA MARIE CHENEY","Democrat",0.597341613439891,65755,278217,0.236344292404849
2004,"VIRGINIA",9,150039,98499,252947,"RICK BOUCHER","KEVIN R TRIPLETT","Democrat",0.593163785298897,51540,248538,0.207372715641069
2004,"VIRGINIA",10,116654,205982,323011,"JAMES R SOCAS","FRANK R WOLF","Republican",0.637693453164134,-89328,322636,-0.276869289229968
2004,"VIRGINIA",11,118305,186299,309233,"KEN LONGMYER","TOM DAVIS","Republican",0.602455106667141,-67994,304604,-0.223220968864493
2004,"WASHINGTON",1,204121,117850,327769,"JAY INSLEE","RANDY EASTWOOD","Democrat",0.622758711165485,86271,321971,0.267946492075373
2004,"WASHINGTON",2,202383,106333,316682,"RICK LARSEN","SUZANNE SINCLAIR","Democrat",0.639073265926071,96050,308716,0.31112737920937
2004,"WASHINGTON",3,193626,119027,312653,"BRIAN BAIRD","THOMAS A CROWSON","Democrat",0.619299990724541,74599,312653,0.238599981449083
2004,"WASHINGTON",4,92486,154627,247113,"SANDY MATHESON","DOC HASTINGS","Republican",0.62573397595432,-62141,247113,-0.251467951908641
2004,"WASHINGTON",5,121333,179600,300933,"DON BARBIERI","CATHY MCMORRIS","Republican",0.596810585745,-58267,300933,-0.193621171489999
2004,"WASHINGTON",6,202919,91228,294147,"NORMAN D DICKS","DOUG CLOUD","Democrat",0.689855752395911,111691,294147,0.379711504791822
2004,"WASHINGTON",7,272302,65226,337528,"JIM MCDERMOTT","CAROL CASSADY","Democrat",0.806753810054277,207076,337528,0.613507620108554
2004,"WASHINGTON",8,157148,173298,336499,"DAVE ROSS","DAVE REICHERT","Republican",0.515003016353689,-16150,330446,-0.0488733408786912
2004,"WASHINGTON",9,162433,88304,256671,"ADAM SMITH","PAUL J LORD","Democrat",0.632845159757043,74129,250737,0.295644440190319
2004,"WEST VIRGINIA",1,166583,79196,245779,"ALAN B MOLLOHAN","ALAN LEE PARKS","Democrat",0.67777556259892,87387,245779,0.35555112519784
2004,"WEST VIRGINIA",2,106131,147676,257025,"ERIK WELLS","SHELLEY MOORE CAPITO","Republican",0.57455889504912,-41545,253807,-0.163687368748695
2004,"WEST VIRGINIA",3,142682,76170,218852,"NICK J RAHALL II","RICK SNUFFER","Democrat",0.651956573392064,66512,218852,0.303913146784128
2004,"WISCONSIN",1,116250,233372,355976,"JEFFREY CHAPMAN THOMAS","PAUL RYAN","Republican",0.655583522484662,-117122,349622,-0.334996081482287
2004,"WISCONSIN",2,251637,145810,397724,"TAMMY BALDWIN","DAVE MAGNUM","Democrat",0.632692520441311,105827,397447,0.266266948800721
2004,"WISCONSIN",3,204856,157866,363008,"RON KIND","DALE W SCHULTZ","Democrat",0.564329160789845,46990,362722,0.129548249072292
2004,"WISCONSIN",4,212382,85928,305142,"GWEN MOORE","GERALD H BOYLE","Democrat",0.696010382051635,126454,298310,0.423901310717039
2004,"WISCONSIN",5,129384,271153,407291,"BRYAN KENNEDY","F JAMES SENSENBRENNER","Republican",0.665747585878401,-141769,400537,-0.353947325715227
2004,"WISCONSIN",6,107209,238620,355995,"JEF HALL","THOMAS E PETRI","Republican",0.670290313066195,-131411,345829,-0.379988375757961
2004,"WISCONSIN",8,105513,248070,353725,"DOTTIE LE CLAIR","MARK GREEN","Republican",0.701307512898438,-142557,353583,-0.403178320224671
2004,"WYOMING",0,99989,132107,239163,"TED LADD","BARBARA CUBIN","Republican",0.552372231490657,-32118,232096,-0.138382393492348
2006,"ALABAMA",1,52770,112944,165841,"VIVIAN SHEFFIELD BECKERLE","JO BONNER","Republican",0.681037861566199,-60174,165714,-0.363119591585503
2006,"ALABAMA",2,54450,124302,178919,"CHARLES ""CHUCK"" DEAN JAMES","TERRY EVERETT","Republican",0.694738960088085,-69852,178752,-0.39077604726101
2006,"ALABAMA",3,63559,98257,165301,"GREG A PIERCE","MIKE ROGERS","Republican",0.594412616983563,-34698,161816,-0.214428733870569
2006,"ALABAMA",4,54382,128484,183072,"BARBARA BOBO","ROBERT B ADERHOLT","Republican",0.701822233875197,-74102,182866,-0.405225684380913
2006,"ALASKA",0,93879,132743,234645,"DIANE E BENSON","DON YOUNG","Republican",0.565718425706919,-38864,226622,-0.171492617662892
2006,"ARIZONA",1,88691,105646,204139,"ELLEN SIMON","RICK RENZI","Republican",0.517519925149041,-16955,194337,-0.0872453521460144
2006,"ARIZONA",2,89671,135150,230560,"JOHN THRASHER","TRENT FRANKS","Republican",0.586181471200555,-45479,224821,-0.202289821680359
2006,"ARIZONA",3,72586,112519,189849,"HERB PAINE","JOHN B SHADEGG","Republican",0.592676284836897,-39933,185105,-0.215731611787904
2006,"ARIZONA",4,56464,18627,77861,"ED PASTOR","DON KARG","Democrat",0.725189761241186,37837,75091,0.503881956559375
2006,"ARIZONA",5,101838,93815,202010,"HARRY MITCHELL","J D HAYWORTH","Democrat",0.504123558239691,8023,195653,0.0410062713068545
2006,"ARIZONA",7,80354,46498,131525,"RAUL M GRIJALVA","RON DRAKE","Democrat",0.610940885763163,33856,126852,0.266893702897865
2006,"ARIZONA",8,137655,106790,253720,"GABRIELLE GIFFORDS","RANDY GRAF","Democrat",0.5425469020968,30865,244445,0.126265622123586
2006,"ARKANSAS",1,127577,56611,184188,"MARION BERRY","MICKEY ""STUBBY"" STUMBAUGH","Democrat",0.69264555779964,70966,184188,0.385291115599279
2006,"ARKANSAS",2,124871,81432,206303,"VIC SNYDER","ANDY MAYBERRY","Democrat",0.605279612996418,43439,206303,0.210559225992836
2006,"ARKANSAS",3,75885,125039,200924,"WOODROW ANDERSON","JOHN BOOZMAN","Republican",0.622319882144492,-49154,200924,-0.244639764288985
2006,"ARKANSAS",4,128236,43360,171596,"MIKE ROSS","JOE ROSS","Democrat",0.747313457190144,84876,171596,0.494626914380289
2006,"CALIFORNIA",1,144409,63194,218044,"MIKE THOMPSON","JOHN W JONES","Democrat",0.662292931701858,81215,207603,0.391203402648324
2006,"CALIFORNIA",2,68234,134911,210202,"A J SEKHON","WALLY HERGER","Republican",0.641815967497931,-66677,203145,-0.328223682591253
2006,"CALIFORNIA",3,86318,135709,228169,"BILL DURSTON","DANIEL E LUNGREN","Republican",0.594774049060126,-49391,222027,-0.222454926653065
2006,"CALIFORNIA",4,126999,135818,276893,"CHARLIE BROWN","JOHN T DOOLITTLE","Republican",0.490507163416916,-8819,262817,-0.0335556680123432
2006,"CALIFORNIA",5,105676,35106,149266,"DORIS O MATSUI","CLAIRE YAN","Democrat",0.707971004783407,70570,140782,0.501271469363981
2006,"CALIFORNIA",6,173190,64405,246628,"LYNN C WOOLSEY","TODD HOOPER","Democrat",0.702231701185591,108785,237595,0.457858961678486
2006,"CALIFORNIA",8,148435,19800,184639,"NANCY PELOSI","MIKE DENUNZIO","Democrat",0.803920081889525,128635,168235,0.7646149731031
2006,"CALIFORNIA",9,167245,20786,193686,"BARBARA LEE","JOHN ""JD"" DENDULK","Democrat",0.863485228669083,146459,188031,0.778908796953694
2006,"CALIFORNIA",10,130859,66069,196978,"ELLEN O TAUSCHER","DARCY LINN","Democrat",0.664333072728934,64790,196928,0.329003493662658
2006,"CALIFORNIA",11,109868,96396,206264,"JERRY MCNERNEY","RICHARD W POMBO","Democrat",0.532657177209789,13472,206264,0.0653143544195788
2006,"CALIFORNIA",12,138650,43674,182324,"TOM LANTOS","MIKE MOLONEY","Democrat",0.760459401943792,94976,182324,0.520918803887585
2006,"CALIFORNIA",13,110756,37141,147897,"FORTNEY PETE STARK","GEORGE I BRUNO","Democrat",0.748872526149956,73615,147897,0.497745052299911
2006,"CALIFORNIA",14,141153,48097,198575,"ANNA G ESHOO","ROB SMITH","Democrat",0.710829661337026,93056,189250,0.491709379128137
2006,"CALIFORNIA",15,115532,44186,159718,"MICHAEL M HONDA","RAYMOND L CHUKWU","Democrat",0.723349904206163,71346,159718,0.446699808412327
2006,"CALIFORNIA",16,98929,37130,136059,"ZOE LOFGREN","CHAREL WINSTON","Democrat",0.727103682961068,61799,136059,0.454207365922137
2006,"CALIFORNIA",17,120750,35932,159293,"SAM FARR","ANTHONY R DE MAIO","Democrat",0.758037076331038,84818,156682,0.541338507295031
2006,"CALIFORNIA",18,71182,37531,108713,"DENNIS A CARDOZA","JOHN A KANNO","Democrat",0.654769898724164,33651,108713,0.309539797448327
2006,"CALIFORNIA",19,71748,110246,181994,"TJ COX","GEORGE RADANOVICH","Republican",0.605767223095267,-38498,181994,-0.211534446190534
2006,"CALIFORNIA",21,42718,95214,142661,"STEVEN HAZE","DEVIN NUNES","Republican",0.667414359916165,-52496,137932,-0.380593335846649
2006,"CALIFORNIA",22,55226,133278,188504,"SHARON M BEERY","KEVIN MCCARTHY","Republican",0.707030089547171,-78052,188504,-0.414060179094343
2006,"CALIFORNIA",23,114661,61272,175933,"LOIS CAPPS","VICTOR D TOGNAZZINI","Democrat",0.651731056709088,53389,175933,0.303462113418176
2006,"CALIFORNIA",24,79461,129812,209292,"JILL M MARTINEZ","ELTON GALLEGLY","Republican",0.620243487567609,-50351,209273,-0.240599599566117
2006,"CALIFORNIA",25,55913,93987,156773,"ROBERT RODRIGUEZ","HOWARD P ""BUCK"" MCKEON","Republican",0.599510119727249,-38074,149900,-0.253995997331554
2006,"CALIFORNIA",26,67878,102028,179144,"CYNTHIA RODRIGUEZ MATTHEWS","DAVID DREIER","Republican",0.56953065690171,-34150,169906,-0.200993490518287
2006,"CALIFORNIA",27,92650,42074,134724,"BRAD SHERMAN","PETER HANKWITZ","Democrat",0.687702265372168,50576,134724,0.375404530744337
2006,"CALIFORNIA",28,79866,20629,108042,"HOWARD L BERMAN","STANLEY KIMMEL KESSELMAN","Democrat",0.739212528461154,59237,100495,0.589452211552814
2006,"CALIFORNIA",29,91014,39321,143389,"ADAM B SCHIFF","WILLIAM J BODELL","Democrat",0.634734882034187,51693,130335,0.396616411554839
2006,"CALIFORNIA",30,151284,55904,211734,"HENRY A WAXMAN","DAVID NELSON JONES","Democrat",0.714500269205702,95380,207188,0.4603548468058
2006,"CALIFORNIA",34,57459,17359,74819,"LUCILLE ROYBAL-ALLARD","WAYNE MILLER","Democrat",0.767973375746802,40100,74818,0.535967280600925
2006,"CALIFORNIA",36,105323,53068,166153,"JANE HARMAN","BRIAN GIBSON","Democrat",0.633891654077868,52255,158391,0.329911421734821
2006,"CALIFORNIA",38,75181,24620,99801,"GRACE F NAPOLITANO","SIDNEY W STREET","Democrat",0.753309085079308,50561,99801,0.506618170158616
2006,"CALIFORNIA",39,72149,37384,109533,"LINDA T SANCHEZ","JAMES L ANDION","Democrat",0.658696465905252,34765,109533,0.317392931810505
2006,"CALIFORNIA",40,46418,100995,151289,"FLORICE OREA HOFFMAN","EDWARD R ROYCE","Republican",0.66756340513851,-54577,147413,-0.370231933411572
2006,"CALIFORNIA",41,54235,109761,164044,"LOUIE A CONTRERAS","JERRY LEWIS","Republican",0.669094876984224,-55526,163996,-0.338581428815337
2006,"CALIFORNIA",43,52791,29069,81860,"JOE BACA","SCOTT FOLKENS","Democrat",0.644893720987051,23722,81860,0.289787441974102
2006,"CALIFORNIA",44,55275,89555,149316,"LOUIS VANDENBERG","KEN CALVERT","Republican",0.599768276674971,-34280,144830,-0.236691293240351
2006,"CALIFORNIA",45,64613,99638,164251,"DAVID ROTH","MARY BONO","Republican",0.606620355431626,-35025,164251,-0.213240710863252
2006,"CALIFORNIA",46,71573,116176,195052,"JIM BRANDT","DANA ROHRABACHER","Republican",0.595615528166848,-44603,187749,-0.237567177455006
2006,"CALIFORNIA",47,47134,28485,75619,"LORETTA SANCHEZ","TAN NGUYEN","Democrat",0.623308956743675,18649,75619,0.246617913487351
2006,"CALIFORNIA",48,74647,120130,200527,"STEVE YOUNG","JOHN CAMPBELL","Republican",0.599071446737846,-45483,194777,-0.2335131971434
2006,"CALIFORNIA",49,52227,98831,156137,"JEENI CRISCENZO","DARRELL E ISSA","Republican",0.632976168364962,-46604,151058,-0.308517258271657
2006,"CALIFORNIA",50,96612,118018,222102,"FRANCINE BUSBY","BRIAN P BILBRAY","Republican",0.531368470342455,-21406,214630,-0.0997344266877883
2006,"CALIFORNIA",51,78114,34931,115839,"BOB FILNER","BLAKE L MILES","Democrat",0.674332478698884,43183,113045,0.381998319253395
2006,"CALIFORNIA",52,61208,123696,191369,"JOHN RINALDI","DUNCAN HUNTER","Republican",0.646374282146011,-62488,184904,-0.337948340760611
2006,"CALIFORNIA",53,97541,43312,144387,"SUSAN A DAVIS","JOHN ""WOODY"" WOODRUM","Democrat",0.675552508189796,54229,140853,0.385004224262174
2006,"COLORADO",2,157850,65481,231307,"MARK UDALL","RICH MANCUSO","Democrat",0.682426385712495,92369,223331,0.413596858474641
2006,"COLORADO",3,146488,86930,237858,"JOHN T SALAZAR","SCOTT TIPTON","Democrat",0.615863246138452,59558,233418,0.255155986256416
2006,"COLORADO",4,103748,109732,240613,"ANGIE PACCIONE","MARILYN N MUSGRAVE","Republican",0.456051834273294,-5984,213480,-0.0280307288738992
2006,"COLORADO",5,83431,123272,206756,"JAY FAWCETT","DOUG LAMBORN","Republican",0.596219698581903,-39841,206703,-0.192745146417807
2006,"COLORADO",6,108007,158806,270931,"BILL WINTER","THOMAS G TANCREDO","Republican",0.586149240950648,-50799,266813,-0.190391772514832
2006,"COLORADO",7,103918,79571,189170,"ED PERLMUTTER","RICK O'DONNELL","Democrat",0.54933657556695,24347,183489,0.132689153028247
2006,"CONNECTICUT",1,154539,53010,207592,"JOHN B LARSON","SCOTT MACLEAN","Democrat",0.744436201780415,101529,207549,0.489180868132345
2006,"CONNECTICUT",2,121248,121165,242413,"JOE COURTNEY","ROB SIMMONS","Democrat",0.500171195439189,83,242413,0.000342390878376985
2006,"CONNECTICUT",3,150436,44386,197911,"ROSA L DELAURO","JOSEPH VOLLANO","Democrat",0.760119447630501,106050,194822,0.5443430413403
2006,"CONNECTICUT",4,99450,106510,209019,"DIANE FARRELL","CHRISTOPHER SHAYS","Republican",0.509570900253087,-7060,205960,-0.0342785006797436
2006,"CONNECTICUT",5,122980,94824,217804,"CHRIS MURPHY","NANCY L JOHNSON","Democrat",0.56463609483756,28156,217804,0.129272189675121
2006,"DELAWARE",0,97565,143897,251694,"DENNIS SPIVACK","MICHAEL N CASTLE","Republican",0.571714065492225,-46332,241462,-0.19188112415204
2006,"FLORIDA",1,62340,135786,198126,"JOE ROBERTS","JEFF MILLER","Republican",0.685351745858696,-73446,198126,-0.370703491717392
2006,"FLORIDA",4,61704,141759,203479,"ROBERT J HARMS","ANDER CRENSHAW","Republican",0.696676315492016,-80055,203463,-0.39346220197284
2006,"FLORIDA",5,108959,162421,271380,"JOHN RUSSELL","GINNY BROWN-WAITE","Republican",0.598500257940895,-53462,271380,-0.197000515881789
2006,"FLORIDA",6,91528,136601,228129,"DAVID E BRUDERLY","CLIFF STEARNS","Republican",0.598788404806053,-45073,228129,-0.197576809612105
2006,"FLORIDA",7,87584,149656,237240,"JOHN F CHAGNON","JOHN L MICA","Republican",0.630821109425055,-62072,237240,-0.26164221885011
2006,"FLORIDA",8,82526,95258,180444,"CHARLIE STUART","RIC KELLER","Republican",0.527908935736295,-12732,177784,-0.0716149934752284
2006,"FLORIDA",9,96978,123016,220013,"PHYLLIS BUSANSKY","GUS MICHAEL BILIRAKIS","Republican",0.559130596828369,-26038,219994,-0.11835777339382
2006,"FLORIDA",10,67950,131488,199445,"SAMM SIMPSON","C W BILL YOUNG","Republican",0.659269472786984,-63538,199438,-0.318585224480791
2006,"FLORIDA",11,97470,42454,139942,"KATHY CASTOR","EDDIE ADAMS JR","Democrat",0.696502836889568,55016,139924,0.393184871787542
2006,"FLORIDA",13,118940,119309,238249,"CHRISTINE JENNINGS","VERN BUCHANAN","Republican",0.500774399892549,-369,238249,-0.00154879978509878
2006,"FLORIDA",14,83920,151615,235539,"ROBERT M NEELD","CONNIE MACK","Republican",0.643693825650954,-67695,235535,-0.287409514509521
2006,"FLORIDA",15,97834,125965,223799,"BOB BOWMAN","DAVE WELDON","Republican",0.562848806294934,-28131,223799,-0.125697612589869
2006,"FLORIDA",16,115832,111415,233773,"TIM MAHONEY","JOE NEGRON","Democrat",0.495489213895531,4417,227247,0.0194370002684304
2006,"FLORIDA",18,48499,79631,128132,"DAVID ""BIG DAVE"" PATLAK","ILEANA ROS-LEHTINEN","Republican",0.621476290075859,-31132,128130,-0.242971981581207
2006,"FLORIDA",21,45522,66784,112306,"FRANK J GONZALEZ","LINCOLN DIAZ-BALART","Republican",0.594661015439959,-21262,112306,-0.189322030879917
2006,"FLORIDA",22,108688,100663,213605,"RON KLEIN","E CLAY SHAW JR","Democrat",0.50882704056553,8025,209351,0.0383327521721893
2006,"FLORIDA",24,89863,123795,213658,"CLINT CURTIS","TOM FEENEY","Republican",0.579407277050239,-33932,213658,-0.158814554100478
2006,"FLORIDA",25,43168,60765,103933,"MICHAEL CALDERIN","MARIO DIAZ-BALART","Republican",0.584655499215841,-17597,103933,-0.169310998431682
2006,"GEORGIA",1,43668,94961,138629,"JIM NELSON","JACK KINGSTON","Republican",0.685000973822216,-51293,138629,-0.370001947644432
2006,"GEORGIA",2,88662,41967,130629,"SANFORD D BISHOP JR","BRADLEY C HUGHES","Democrat",0.678731368991572,46695,130629,0.357462737983143
2006,"GEORGIA",3,62371,130428,192799,"MIKE MCGRAW","LYNN WESTMORELAND","Republican",0.676497284736954,-68057,192799,-0.352994569473908
2006,"GEORGIA",4,106352,34778,141130,"HENRY C ""HANK"" JOHNSON JR","CATHERINE DAVIS","Democrat",0.753574718344789,71574,141130,0.507149436689577
2006,"GEORGIA",6,55294,144958,200252,"STEVE SINTON","TOM PRICE","Republican",0.723877913828576,-89664,200252,-0.447755827657152
2006,"GEORGIA",7,53553,130561,184114,"ALLAN BURNS","JOHN LINDER","Republican",0.709131299086436,-77008,184114,-0.418262598172871
2006,"GEORGIA",8,80660,78908,159568,"JIM MARSHALL","MAC COLLINS","Democrat",0.505489822520806,1752,159568,0.0109796450416124
2006,"GEORGIA",9,39240,128685,167925,"JOHN D BRADBURY","NATHAN DEAL","Republican",0.766324251898169,-89445,167925,-0.532648503796338
2006,"GEORGIA",10,57032,117721,174753,"TERRY HOLLEY","CHARLIE NORWOOD","Republican",0.67364222645677,-60689,174753,-0.347284452913541
2006,"GEORGIA",11,48261,118524,166785,"PATRICK SAMUEL PILLION","PHIL GINGREY","Republican",0.710639445993345,-70263,166785,-0.421278891986689
2006,"GEORGIA",12,71651,70787,142438,"JOHN BARROW","MAX BURNS","Democrat",0.50303289852427,864,142438,0.00606579704854042
2006,"GEORGIA",13,103019,45770,148789,"DAVID SCOTT","DEBORAH TRAVIS HONEYCUTT","Democrat",0.692383173487287,57249,148789,0.384766346974575
2006,"HAWAII",1,112904,49890,162794,"NEIL ABERCROMBIE","RICHARD ""NOAH"" HOUGH","Democrat",0.693539073921643,63014,162794,0.387078147843287
2006,"HAWAII",2,106906,68244,175150,"MAZIE K HIRONO","BOB HOGUE","Democrat",0.610368255780759,38662,175150,0.220736511561519
2006,"IDAHO",1,103935,115843,231974,"LARRY GRANT","BILL SALI","Republican",0.499379240776984,-11908,219778,-0.0541819472376671
2006,"IDAHO",2,73441,132262,213332,"JIM HANSEN","MICHAEL K SIMPSON","Republican",0.619981999887499,-58821,205703,-0.28595110426197
2006,"ILLINOIS",1,146623,27804,174427,"BOBBY L RUSH","JASON E TABOUR","Democrat",0.840598072546108,118819,174427,0.681196145092216
2006,"ILLINOIS",2,146347,20395,172490,"JESSE L JACKSON JR","ROBERT BELIN","Democrat",0.848437590584961,125952,166742,0.755370572501229
2006,"ILLINOIS",3,127768,37954,165722,"DANIEL LIPINSKI","RAYMOND G WARDINGLEY","Democrat",0.770977902752803,89814,165722,0.541955805505606
2006,"ILLINOIS",4,69910,11532,81442,"LUIS V GUTIERREZ","ANN MELICHAR","Democrat",0.858402298568306,58378,81442,0.716804597136613
2006,"ILLINOIS",5,114319,32250,146581,"RAHM EMANUEL","KEVIN EDWARD WHITE","Democrat",0.779903261677844,82069,146569,0.559934228929719
2006,"ILLINOIS",6,86572,91382,177957,"L TAMMY DUCKWORTH","PETER J ROSKAM","Republican",0.513506071691476,-4810,177954,-0.0270294570506985
2006,"ILLINOIS",7,143071,21939,165011,"DANNY K DAVIS","CHARLES HUTCHINSON","Democrat",0.867039167085831,121132,165010,0.734088843100418
2006,"ILLINOIS",8,93355,80720,183394,"MELISSA L BEAN","DAVID MCSWEENEY","Democrat",0.509040644732107,12635,174075,0.0725836564699124
2006,"ILLINOIS",9,122852,41858,164713,"JANICE D SCHAKOWSKY","MICHAEL P SHANNON","Democrat",0.745854911269906,80994,164710,0.491736992289478
2006,"ILLINOIS",10,94278,107929,202208,"DANIEL J SEALS","MARK STEVEN KIRK","Republican",0.533752373793322,-13651,202207,-0.0675100268536698
2006,"ILLINOIS",11,88846,109009,197855,"JOHN PAVICH","JERRY WELLER","Republican",0.550953981451063,-20163,197855,-0.101907962902125
2006,"ILLINOIS",13,85507,119720,205234,"JOSEPH SHANNON","JUDY BIGGERT","Republican",0.583334145414502,-34213,205227,-0.166708084218938
2006,"ILLINOIS",14,79274,117870,197144,"JONATHAN ""JOHN"" LAESCH","J DENNIS HASTERT","Republican",0.597887838331372,-38596,197144,-0.195775676662744
2006,"ILLINOIS",15,86025,116810,202835,"DAVID GILL","TIMOTHY V JOHNSON","Republican",0.575886804545567,-30785,202835,-0.151773609091133
2006,"ILLINOIS",16,63462,125508,197493,"RICHARD D AUMAN","DONALD A MANZULLO","Republican",0.635506068569519,-62046,188970,-0.32833783140181
2006,"ILLINOIS",17,115025,86161,201186,"PHIL HARE","ANDREA ZINGA","Democrat",0.571734613740519,28864,201186,0.143469227481037
2006,"ILLINOIS",18,73052,150194,223246,"STEVE WATERWORTH","RAY LAHOOD","Republican",0.672773532336526,-77142,223246,-0.345547064673051
2006,"ILLINOIS",19,92861,143491,236352,"DANNY L STOVER","JOHN SHIMKUS","Republican",0.607107196046575,-50630,236352,-0.214214392093149
2006,"INDIANA",1,104195,40146,149607,"PETER J VISCLOSKY","MARK J LEYVA","Democrat",0.696458053433329,64049,144341,0.443733935610811
2006,"INDIANA",2,103561,88300,191861,"JOE DONNELLY","CHRIS CHOCOLA","Democrat",0.539770980032419,15261,191861,0.0795419600648386
2006,"INDIANA",3,80357,95421,175778,"THOMAS HAYHURST","MARK E SOUDER","Republican",0.542849503350817,-15064,175778,-0.085699006701635
2006,"INDIANA",4,66986,111057,178043,"DAVID SANDERS","STEVE BUYER","Republican",0.623765045522711,-44071,178043,-0.247530091045422
2006,"INDIANA",5,64362,133118,204929,"KATHERINE FOX CARR","DAN BURTON","Republican",0.649581074420897,-68756,197480,-0.348166902977517
2006,"INDIANA",6,76812,115266,192078,"BARRY A WELSH","MIKE PENCE","Republican",0.600099959391497,-38454,192078,-0.200199918782994
2006,"INDIANA",7,74750,64304,139054,"JULIA CARSON","ERIC DICKERSON","Democrat",0.537560947545558,10446,139054,0.0751218950911157
2006,"INDIANA",8,131019,83704,214723,"BRAD ELLSWORTH","JOHN N HOSTETTLER","Democrat",0.610176832477192,47315,214723,0.220353664954383
2006,"INDIANA",9,110454,100469,220849,"BARON P HILL","MICHAEL E SODREL","Democrat",0.500133575429366,9985,210923,0.0473395504520607
2006,"IOWA",1,114322,89729,207478,"BRUCE BRALEY","MIKE WHALEN","Democrat",0.551007817696334,24593,204051,0.120523790620972
2006,"IOWA",2,107683,101707,209390,"DAVE LOEBSACK","JAMES A LEACH","Democrat",0.514270022446153,5976,209390,0.0285400448923062
2006,"IOWA",3,115769,103722,223082,"LEONARD L BOSWELL","JEFF LAMBERTI","Democrat",0.5189526721116,12047,219491,0.054886077333467
2006,"IOWA",4,90982,121650,212632,"SELDEN E SPENCER","TOM LATHAM","Republican",0.57211520373227,-30668,212632,-0.14423040746454
2006,"IOWA",5,64181,105580,180399,"JOYCE SCHULTE","STEVE KING","Republican",0.585258233138765,-41399,169761,-0.24386637684745
2006,"KANSAS",1,39781,156728,199378,"JOHN DOLL","JERRY MORAN","Republican",0.786084723490054,-116947,196509,-0.595122869690447
2006,"KANSAS",2,114139,106329,225562,"NANCY BOYDA","JIM RYUN","Democrat",0.506020517640383,7810,220468,0.0354246421249342
2006,"KANSAS",3,153105,79824,236980,"DENNIS MOORE","CHUCK AHNER","Democrat",0.646067178664866,73281,232929,0.314606596859987
2006,"KANSAS",4,62166,116386,183207,"GARTH J MCGINN","TODD TIAHRT","Republican",0.635270486389712,-54220,178552,-0.303665038756217
2006,"KENTUCKY",1,83865,123618,207483,"TOM BARLOW","ED WHITFIELD","Republican",0.595798209973829,-39753,207483,-0.191596419947658
2006,"KENTUCKY",2,95415,118548,213963,"MIKE WEAVER","RON LEWIS","Republican",0.554058411968424,-23133,213963,-0.108116823936849
2006,"KENTUCKY",3,122489,116568,241965,"JOHN YARMUTH","ANNE M NORTHUP","Democrat",0.506226107081603,5921,239057,0.0247681515287149
2006,"KENTUCKY",4,88822,105845,204767,"KEN LUCAS","GEOFF DAVIS","Republican",0.516904579351165,-17023,194667,-0.0874467680706026
2006,"KENTUCKY",5,52367,147201,199568,"KENNETH STEPP","HAROLD ROGERS","Republican",0.737598212138219,-94834,199568,-0.475196424276437
2006,"LOUISIANA",1,15944,130508,148128,"DAVID GEREIGHTY","BOBBY JINDAL","Republican",0.881048822639879,-114564,146452,-0.782263130582034
2006,"LOUISIANA",2,93211,13928,107543,"DERRICK SHEPHERD","ERIC T BRADLEY","Democrat",0.866732376816715,79283,107139,0.740001306713708
2006,"LOUISIANA",3,79213,54950,136331,"CHARLIE MELANCON","CRAIG ROMERO","Democrat",0.581034394231686,24263,134163,0.180847178432206
2006,"LOUISIANA",4,40545,93727,134272,"ARTIS R CASH SR","CHESTER T KELLEY","Republican",0.69803831029552,-53182,134272,-0.396076620591039
2006,"LOUISIANA",5,33233,78211,114582,"GLORIA WILLIAMS HEARN","RODNEY ALEXANDER","Republican",0.682576669983069,-44978,111444,-0.403592835863752
2006,"LOUISIANA",7,47133,113720,160853,"MIKE STAGG","CHARLES W BOUSTANY JR","Republican",0.706980908034043,-66587,160853,-0.413961816068087
2006,"MAINE",1,170949,88009,280987,"THOMAS H ALLEN","DARLENE J CURLEY","Democrat",0.608387576649454,82940,258958,0.320283598112435
2006,"MAINE",2,179772,75156,254928,"MICHAEL H MICHAUD","LAURENCE S D'AMBOISE","Democrat",0.705187347015628,104616,254928,0.410374694031256
2006,"MARYLAND",1,83738,185177,269147,"JIM CORWIN","WAYNE T GILCHREST","Republican",0.688014356466912,-101439,268915,-0.37721584887418
2006,"MARYLAND",2,135818,60195,196228,"C A DUTCH RUPPERSBERGER","JIMMY MATHIS","Democrat",0.692143832684428,75623,196013,0.385806043476708
2006,"MARYLAND",3,150142,79174,234486,"JOHN P SARBANES","JOHN WHITE","Democrat",0.640302619346144,70968,229316,0.309476879066441
2006,"MARYLAND",4,141897,32792,175903,"ALBERT RUSSELL WYNN","MICHAEL MOSHE STARKMAN","Democrat",0.806677543873612,109105,174689,0.624567087796026
2006,"MARYLAND",6,92030,141200,239453,"ANDREW DUCK","ROSCOE G BARTLETT","Republican",0.5896773061937,-49170,233230,-0.210821935428547
2006,"MARYLAND",8,168872,48324,220685,"CHRIS VAN HOLLEN","JEFFREY M STEIN","Democrat",0.765217391304348,120548,217196,0.555019429455423
2006,"MASSACHUSETTS",6,168056,72997,253284,"JOHN F TIERNEY","RICHARD W BARTON","Democrat",0.663508156851597,95059,241053,0.394348960602025
2006,"MASSACHUSETTS",9,169420,47114,234505,"STEPHEN F LYNCH","JACK E ROBINSON","Democrat",0.722457943327434,122306,216534,0.564835083635826
2006,"MASSACHUSETTS",10,171812,78439,276773,"WILLIAM D DELAHUNT","JEFFREY K BEATTY","Democrat",0.620768644340308,93373,250251,0.373117390140299
2006,"MICHIGAN",1,180448,72753,259927,"BART STUPAK","DON HOOPER","Democrat",0.694225686442732,107695,253201,0.425334023167365
2006,"MICHIGAN",2,86950,183006,275394,"KIMON KOTOS","PETER HOEKSTRA","Republican",0.664524281574762,-96056,269956,-0.355820948599031
2006,"MICHIGAN",3,93846,171212,271352,"JAMES R RINCK","VERNON J EHLERS","Republican",0.63095904950028,-77366,265058,-0.291883285922326
2006,"MICHIGAN",4,100260,160041,264245,"MIKE HUCKLEBERRY","DAVE CAMP","Republican",0.605653843970558,-59781,260301,-0.229661046250303
2006,"MICHIGAN",5,176171,60967,241691,"DALE E KILDEE","ERIC J KLAMMER","Democrat",0.728910054573815,115204,237138,0.485809950324284
2006,"MICHIGAN",6,88978,142125,234583,"KIM CLARK","FRED UPTON","Republican",0.605862317388728,-53147,231103,-0.229971051868647
2006,"MICHIGAN",7,112665,122348,245026,"SHARON MARIE RENIER","TIM WALBERG","Republican",0.499326602074882,-9683,235013,-0.0412019760608988
2006,"MICHIGAN",8,122107,157237,284471,"JIM MARCINKOWSKI","MIKE ROGERS","Republican",0.552734725156519,-35130,279344,-0.125758920900395
2006,"MICHIGAN",9,127620,142390,276180,"NANCY SKINNER","JOE KNOLLENBERG","Republican",0.51556955608661,-14770,270010,-0.0547016777156402
2006,"MICHIGAN",10,84689,179072,270421,"ROBERT DENISON","CANDICE S MILLER","Republican",0.662197092681412,-94383,263761,-0.357835313029599
2006,"MICHIGAN",11,114248,143658,265784,"TONY TRUPIANO","THADDEUS G MCCOTTER","Republican",0.540506576769106,-29410,257906,-0.114033795258738
2006,"MICHIGAN",12,168494,62689,238039,"SANDER M LEVIN","RANDELL J SHAFER","Democrat",0.707841992278576,105805,231183,0.457667735084327
2006,"MICHIGAN",14,158755,27367,186122,"JOHN CONYERS JR","CHAD MILES","Democrat",0.852962035654033,131388,186122,0.705924071308067
2006,"MINNESOTA",4,172096,74797,247466,"BETTY MCCOLLUM","OBI SIUM","Democrat",0.695432907955032,97299,246893,0.39409379771804
2006,"MINNESOTA",7,179164,74557,257194,"COLLIN C PETERSON","MICHAEL J BARRETT","Democrat",0.696610340832212,104607,253721,0.412291453998684
2006,"MINNESOTA",8,180670,97683,284016,"JAMES L OBERSTAR","ROD GRAMS","Democrat",0.636126133738944,82987,278353,0.298135820343233
2006,"MISSISSIPPI",1,49174,95098,144272,"JAMES K ""KEN"" HURT","ROGER F WICKER","Republican",0.659157702118221,-45924,144272,-0.318315404236442
2006,"MISSISSIPPI",2,100160,55672,155832,"BENNIE G THOMPSON","YVONNE R BROWN","Democrat",0.642743467323785,44488,155832,0.285486934647569
2006,"MISSISSIPPI",4,110996,28117,139113,"GENE TAYLOR","RANDY MCDONNELL","Democrat",0.797883734805518,82879,139113,0.595767469611036
2006,"MISSOURI",1,141574,47893,194235,"WM LACY CLAY","MARK J BYRNE","Democrat",0.728879964990862,93681,189467,0.49444494291882
2006,"MISSOURI",2,105242,176452,287617,"GEORGE D WEBER","W TODD AKIN","Republican",0.6134964205871,-71210,281694,-0.252792036749097
2006,"MISSOURI",3,145219,70189,221448,"RUSS CARNAHAN","DAVID BERTELSEN","Democrat",0.655770203388606,75030,215408,0.348315754289534
2006,"MISSOURI",4,159303,69254,235525,"IKE SKELTON","JAMES A ""JIM"" NOLAND","Democrat",0.676374057955631,90049,228557,0.393989245571127
2006,"MISSOURI",5,136149,68456,211919,"EMANUEL CLEAVER","JACOB TURK","Democrat",0.642457731491749,67693,204605,0.330847242247257
2006,"MISSOURI",6,87477,150882,244795,"SARA JO SHETTLES","SAM GRAVES","Republican",0.616360628280806,-63405,238359,-0.266006318200697
2006,"MISSOURI",7,72592,160942,241123,"JACK TRUMAN","ROY BLUNT","Republican",0.667468470448692,-88350,233534,-0.37831750408934
2006,"MISSOURI",8,57557,156164,217989,"VERONICA J HAMBACKER","JO ANN EMERSON","Republican",0.716384771708664,-98607,213721,-0.461381895087521
2006,"MISSOURI",9,87145,149114,242671,"DUANE N BURGHARD","KENNY C HULSHOF","Republican",0.614469796555831,-61969,236259,-0.262292653401564
2006,"MONTANA",0,158916,239124,406125,"MONICA J LINDEEN","DENNIS R REHBERG","Republican",0.588794090489381,-80208,398040,-0.201507386192342
2006,"NEBRASKA",1,86360,121015,207375,"MAXINE B MOUL","JEFF FORTENBERRY","Republican",0.583556359252562,-34655,207375,-0.167112718505124
2006,"NEBRASKA",2,82504,99475,181979,"JIM ESCH","LEE TERRY","Republican",0.546629006643624,-16971,181979,-0.0932580132872474
2006,"NEBRASKA",3,93046,113687,206733,"SCOTT KLEEB","ADRIAN SMITH","Republican",0.549921879912738,-20641,206733,-0.0998437598254754
2006,"NEVADA",1,85025,40917,131124,"SHELLEY BERKLEY","KENNETH WEGNER","Democrat",0.648432018547329,44108,125942,0.35022470661098
2006,"NEVADA",2,104593,117168,232724,"JILL DERBY","DEAN HELLER","Republican",0.503463329953077,-12575,221761,-0.0567051916252181
2006,"NEVADA",3,98261,102232,210979,"TESSA M HAFEN","JON C PORTER","Republican",0.484560074699378,-3971,200493,-0.0198061777717925
2006,"NEW HAMPSHIRE",1,100691,95527,196377,"CAROL SHEA-PORTER","JEB BRADLEY","Democrat",0.512743345707491,5164,196218,0.0263176670845692
2006,"NEW HAMPSHIRE",2,108743,94088,206292,"PAUL W HODES","CHARLES F BASS","Democrat",0.527131444748221,14655,202831,0.0722522691304584
2006,"NEW JERSEY",2,64277,111245,180573,"VIOLA THOMAS-HUGHES","FRANK A LOBIONDO","Republican",0.616066632331522,-46968,175522,-0.267590387529768
2006,"NEW JERSEY",3,86113,122559,209851,"RICH SEXTON","JIM SAXTON","Republican",0.584028667959648,-36446,208672,-0.174656877779482
2006,"NEW JERSEY",4,62905,124482,189540,"CAROL E GAY","CHRISTOPHER H SMITH","Republican",0.656758467869579,-61577,187387,-0.328608708181464
2006,"NEW JERSEY",5,89503,112142,204242,"PAUL ARONSOHN","SCOTT GARRETT","Republican",0.549064345237512,-22639,201645,-0.112271566366634
2006,"NEW JERSEY",6,98615,43539,143773,"FRANK PALLONE JR","LEIGH-ANN BELLEW","Democrat",0.685907646080975,55076,142154,0.387438974633144
2006,"NEW JERSEY",7,95454,98399,199075,"LINDA STENDER","MIKE FERGUSON","Republican",0.494281049855582,-2945,193853,-0.0151919237772952
2006,"NEW JERSEY",8,97568,39053,137639,"BILL PASCRELL JR","JOSE M SANDOVAL","Democrat",0.708868852578121,58515,136621,0.42830165201543
2006,"NEW JERSEY",9,105853,40879,148095,"STEVEN R ROTHMAN","VINCENT MICCO","Democrat",0.714764171646578,64974,146732,0.442807294932257
2006,"NEW JERSEY",11,74414,126085,203071,"TOM WYKA","RODNEY P FRELINGHUYSEN","Republican",0.620891215387722,-51671,200499,-0.257712008538696
2006,"NEW JERSEY",12,125468,65509,190977,"RUSH D HOLT","JOSEPH S SINAGRA","Democrat",0.656979636291281,59959,190977,0.313959272582562
2006,"NEW JERSEY",13,77238,19284,99630,"ALBIO SIRES","JOHN J GUARINI","Democrat",0.775248419150858,57954,96522,0.600422701560266
2006,"NEW MEXICO",1,105125,105986,211111,"PATRICIA A MADRID","HEATHER WILSON","Republican",0.502039211599585,-861,211111,-0.00407842319917011
2006,"NEW MEXICO",2,63119,92620,155874,"ALBERT D KISSLING","STEVAN PEARCE","Republican",0.594197877773073,-29501,155739,-0.189425898458318
2006,"NEW MEXICO",3,144880,49219,194099,"TOM UDALL","RONALD M DOLIN","Democrat",0.74642321701812,95661,194099,0.492846434036239
2006,"NEW YORK",1,92546,54044,179113,"TIMOTHY H BISHOP","ITALO A ZANZI","Democrat",0.51669058080653,38502,146590,0.262650931168565
2006,"NEW YORK",2,94100,37671,163589,"STEVE ISRAEL","JOHN W BUGLER","Democrat",0.575222050382361,56429,131771,0.428235347686517
2006,"NEW YORK",3,76169,86918,192919,"DAVID L MEJIAS","PETER T KING","Republican",0.450541418937482,-10749,163087,-0.0659096065290305
2006,"NEW YORK",4,93041,48121,170640,"CAROLYN MCCARTHY","MARTIN W BLESSINGER","Democrat",0.545247304266292,44920,141162,0.318215950468256
2006,"NEW YORK",7,60266,10402,99290,"JOSEPH CROWLEY","KEVIN BRAWLEY","Democrat",0.606969483331655,49864,70668,0.705609328125884
2006,"NEW YORK",8,96115,17413,142528,"JERROLD NADLER","ELEANOR FRIEDMAN","Democrat",0.674358722496632,78702,113528,0.693238672397999
2006,"NEW YORK",10,72171,4666,103030,"EDOLPHUS TOWNS","JONATHAN H ANDERSON","Democrat",0.700485295544987,67505,76837,0.878548095318662
2006,"NEW YORK",11,75520,6776,113812,"YVETTE D CLARKE","STEPHEN FINGER","Democrat",0.663550416476294,68744,82296,0.835326139788082
2006,"NEW YORK",12,55674,6143,84346,"NYDIA M VELAZQUEZ","ALLAN ROMAGUERA","Democrat",0.660066867427027,49531,61817,0.801252082760406
2006,"NEW YORK",13,42229,49818,116051,"STEPHEN A HARRISON","VITO FOSSELLA","Republican",0.429276783483124,-7589,92047,-0.082447010766239
2006,"NEW YORK",14,107095,21969,153883,"CAROLYN B MALONEY","DANNIEL MAIO","Democrat",0.695950819778663,85126,129064,0.65956424719519
2006,"NEW YORK",15,93857,6592,129189,"CHARLES B RANGEL","EDWARD DANIELS","Democrat",0.726509222921456,87265,100449,0.868749315573077
2006,"NEW YORK",16,53179,2045,73362,"JOSE E SERRANO","ALI MOHAMED","Democrat",0.72488481775306,51134,55224,0.925937997971896
2006,"NEW YORK",17,88714,22608,141955,"ELIOT L ENGEL","JIM FAULKNER","Democrat",0.624944524673312,66106,111322,0.593826916512459
2006,"NEW YORK",18,119041,45472,199273,"NITA M LOWEY","RICHARD A HOFFMAN","Democrat",0.597376463444621,73569,164513,0.44719262307538
2006,"NEW YORK",19,100119,79545,209491,"JOHN HALL","SUE W KELLY","Democrat",0.477915519043778,20574,179664,0.114513759016831
2006,"NEW YORK",20,116416,94093,250301,"KIRSTEN E GILLIBRAND","JOHN E SWEENEY","Democrat",0.465104014766221,22323,210509,0.10604297203445
2006,"NEW YORK",21,139997,46752,231910,"MICHAEL R MCNULTY","WARREN REDLICH","Democrat",0.60366952697167,93245,186749,0.499306555858398
2006,"NEW YORK",23,58859,89482,184944,"ROBERT J JOHNSON","JOHN M MCHUGH","Republican",0.4838329440263,-30623,148341,-0.206436521258452
2006,"NEW YORK",24,96093,83228,214965,"MICHAEL A ARCURI","RAYMOND A MEIER","Democrat",0.447016956248692,12865,179321,0.0717428522035902
2006,"NEW YORK",25,100605,91187,227311,"DAN MAFFEI","JAMES T WALSH","Democrat",0.442587468270343,9418,191792,0.0491052807207808
2006,"NEW YORK",26,85145,94157,223964,"JACK DAVIS","THOMAS M REYNOLDS","Republican",0.420411316104374,-9012,179302,-0.0502615698653668
2006,"NEW YORK",27,116935,36614,176641,"BRIAN HIGGINS","MICHAEL J MCHALE","Democrat",0.661992402669822,80321,153549,0.523096861588157
2006,"NEW YORK",28,98382,33361,166565,"LOUISE MCINTOSH SLAUGHTER","JOHN E DONNELLY","Democrat",0.59065229790172,65021,131743,0.493544249030309
2006,"NEW YORK",29,94609,91383,216780,"ERIC J MASSA","JOHN R ""RANDY"" KUHL JR","Democrat",0.436428637328167,3226,185992,0.0173448320357865
2006,"NORTH CAROLINA",2,85993,43271,129264,"BOB ETHERIDGE","DAN MANSELL","Democrat",0.665250959277138,42722,129264,0.330501918554277
2006,"NORTH CAROLINA",3,45458,99519,144977,"CRAIG WEBER","WALTER B JONES","Republican",0.686446815701801,-54061,144977,-0.372893631403602
2006,"NORTH CAROLINA",4,127340,68599,195939,"DAVID E PRICE","STEVE ACUFF","Democrat",0.649896141145969,58741,195939,0.299792282291938
2006,"NORTH CAROLINA",5,72061,96138,168199,"ROGER SHARPE","VIRGINIA FOXX","Republican",0.571572958222106,-24077,168199,-0.143145916444212
2006,"NORTH CAROLINA",6,44661,108433,153094,"RORY BLAKE","HOWARD COBLE","Republican",0.708277267561106,-63772,153094,-0.416554535122213
2006,"NORTH CAROLINA",7,101787,38033,139820,"MIKE MCINTYRE","SHIRLEY DAVIS","Democrat",0.727985981976827,63754,139820,0.455971963953655
2006,"NORTH CAROLINA",8,60597,60926,121523,"LARRY KISSELL","ROBIN HAYES","Republican",0.501353653217909,-329,121523,-0.00270730643581873
2006,"NORTH CAROLINA",9,53437,106206,159643,"BILL GLASS","SUE WILKINS MYRICK","Republican",0.665271887899877,-52769,159643,-0.330543775799753
2006,"NORTH CAROLINA",10,58214,94179,152393,"RICHARD CARSNER","PATRICK T MCHENRY","Republican",0.61800082680963,-35965,152393,-0.236001653619261
2006,"NORTH CAROLINA",11,124972,107342,232314,"HEATH SHULER","CHARLES H TAYLOR","Democrat",0.537944333961793,17630,232314,0.0758886679235862
2006,"NORTH CAROLINA",12,71345,35127,106472,"MELVIN L WATT","ADA M FISHER","Democrat",0.670082275152153,36218,106472,0.340164550304305
2006,"NORTH CAROLINA",13,98540,56120,154660,"BRAD MILLER","VERNON ROBINSON","Democrat",0.637139531876374,42420,154660,0.274279063752748
2006,"NORTH DAKOTA",0,142934,74687,217621,"EARL POMEROY","MATT MECHTEL","Democrat",0.656802422560323,68247,217621,0.313604845120646
2006,"OHIO",1,96584,105680,202264,"JOHN CRANLEY","STEVE CHABOT","Republican",0.522485464541391,-9096,202264,-0.0449709290827829
2006,"OHIO",2,117595,120112,238081,"VICTORIA WULSIN","JEAN SCHMIDT","Republican",0.504500569134034,-2517,237707,-0.0105886658785816
2006,"OHIO",3,90650,127978,218628,"RICHARD CHEMA","MICHAEL R TURNER","Republican",0.585368754230931,-37328,218628,-0.170737508461862
2006,"OHIO",4,86678,129958,216636,"RICHARD E SIFERD","JIM JORDAN","Republican",0.59989106150409,-43280,216636,-0.19978212300818
2006,"OHIO",5,98544,129813,228357,"ROBIN WEIRAUCH","PAUL E GILLMOR","Republican",0.568465166384214,-31269,228357,-0.136930332768428
2006,"OHIO",6,135628,82848,218476,"CHARLES A WILSON JR","CHUCK BLASDEL","Democrat",0.620791299730863,52780,218476,0.241582599461726
2006,"OHIO",7,89579,137899,227478,"WILLIAM R CONNER","DAVID L HOBSON","Republican",0.606208072868585,-48320,227478,-0.21241614573717
2006,"OHIO",8,77640,136863,214503,"MORT MEIER","JOHN A BOEHNER","Republican",0.638047020321394,-59223,214503,-0.276094040642788
2006,"OHIO",9,153880,55119,208999,"MARCY KAPTUR","BRADLEY S LEAVITT","Democrat",0.73627146541371,98761,208999,0.47254293082742
2006,"OHIO",10,138393,69996,208389,"DENNIS J KUCINICH","MICHAEL D DOVILLA","Democrat",0.664108950088536,68397,208389,0.328217900177073
2006,"OHIO",11,146799,29125,175924,"STEPHANIE TUBBS JONES","LINDSEY N STRING","Democrat",0.834445556035561,117674,175924,0.668891112071122
2006,"OHIO",12,108746,145943,254689,"BOB SHAMANSKY","PATRICK J TIBERI","Republican",0.573024355193982,-37197,254689,-0.146048710387963
2006,"OHIO",13,135639,85922,221561,"BETTY SUTTON","CRAIG FOLTIN","Democrat",0.612197092448581,49717,221561,0.224394184897162
2006,"OHIO",14,97753,144069,250322,"LEWIS R KATZ","STEVEN C LATOURETTE","Republican",0.575534711291856,-46316,241822,-0.19152930668012
2006,"OHIO",15,109659,110714,220567,"MARY JO KILROY","DEBORAH PRYCE","Republican",0.501951787892114,-1055,220373,-0.00478733783176705
2006,"OHIO",16,97955,137167,235122,"THOMAS SHAW","RALPH REGULA","Republican",0.583386497222718,-39212,235122,-0.166772994445437
2006,"OHIO",17,170369,41925,212294,"TIM RYAN","DON MANNING II","Democrat",0.802514437525319,128444,212294,0.605028875050637
2006,"OHIO",18,129646,79259,208905,"ZACK T SPACE","JOY PADGETT","Democrat",0.620597879418875,50387,208905,0.241195758837749
2006,"OKLAHOMA",1,56724,116920,183729,"ALAN GENTGES","JOHN SULLIVAN","Republican",0.636372047961944,-60196,173644,-0.346663288106701
2006,"OKLAHOMA",2,122347,45861,168208,"DAN BOREN","PATRICK K MILLER","Democrat",0.727355417102635,76486,168208,0.45471083420527
2006,"OKLAHOMA",3,61749,128042,189791,"SUE BARTON","FRANK D LUCAS","Republican",0.674647375270693,-66293,189791,-0.349294750541385
2006,"OKLAHOMA",4,64775,118266,183041,"HAL SPAKE","TOM COLE","Republican",0.646117536508214,-53491,183041,-0.292235073016428
2006,"OKLAHOMA",5,67293,108936,180425,"DAVID HUNTER","MARY FALLIN","Republican",0.60377442150478,-41643,176229,-0.236300495378173
2006,"OREGON",1,169409,90904,269627,"DAVID WU","DERRICK KITTS","Democrat",0.628308737626425,78505,260313,0.301579252668902
2006,"OREGON",2,82484,181529,271719,"CAROL VOISIN","GREG WALDEN","Republican",0.668076211085717,-99045,264013,-0.375151981152443
2006,"OREGON",3,186380,59529,253610,"EARL BLUMENAUER","BRUCE BROUSSARD","Democrat",0.734907929498048,126851,245909,0.515845292364249
2006,"OREGON",4,180607,109105,290244,"PETER A DEFAZIO","JIM FELDKAMP","Democrat",0.622259202601949,71502,289712,0.246803722317336
2006,"OREGON",5,146973,116424,272234,"DARLENE HOOLEY","MIKE ERICKSON","Democrat",0.539877458363026,30549,263397,0.115980819827105
2006,"PENNSYLVANIA",2,165867,17291,187283,"CHAKA FATTAH","MICHAEL GESSNER","Democrat",0.885648991099032,148576,183158,0.811190338396357
2006,"PENNSYLVANIA",3,85110,108525,202518,"STEVEN PORTER","PHIL ENGLISH","Republican",0.535878292299944,-23415,193635,-0.120923386784414
2006,"PENNSYLVANIA",4,131847,122049,254084,"JASON ALTMIRE","MELISSA A HART","Democrat",0.518911068780403,9798,253896,0.0385906040268456
2006,"PENNSYLVANIA",5,76456,115126,191727,"DONALD L HILLIARD","JOHN E PETERSON","Republican",0.600468374303045,-38670,191582,-0.20184568487645
2006,"PENNSYLVANIA",6,117892,121047,238939,"LOIS MURPHY","JIM GERLACH","Republican",0.506602103465738,-3155,238939,-0.0132042069314762
2006,"PENNSYLVANIA",7,147898,114426,262434,"JOE SESTAK","CURT WELDON","Democrat",0.563562648132483,33472,262324,0.127597932327961
2006,"PENNSYLVANIA",8,125656,124138,249817,"PATRICK J MURPHY","MICHAEL G FITZPATRICK","Democrat",0.502992190283287,1518,249794,0.00607700745414221
2006,"PENNSYLVANIA",9,79610,121069,200820,"TONY BARR","BILL SHUSTER","Republican",0.602873219798825,-41459,200679,-0.206593614678168
2006,"PENNSYLVANIA",10,110115,97862,208173,"CHRISTOPHER CARNEY","DON SHERWOOD","Democrat",0.528959086913288,12253,207977,0.0589151685042096
2006,"PENNSYLVANIA",11,134340,51033,185413,"PAUL E KANJORSKI","JOSEPH F LEONARDI","Democrat",0.724544665152929,83307,185373,0.449402016474891
2006,"PENNSYLVANIA",12,123472,79612,203163,"JOHN P MURTHA","DIANA IREY","Democrat",0.607748458134601,43860,203084,0.215969746508834
2006,"PENNSYLVANIA",13,147368,75492,222860,"ALLYSON Y SCHWARTZ","RAJ PETER BHAKTA","Democrat",0.661258188997577,71876,222860,0.322516377995154
2006,"PENNSYLVANIA",15,86186,106153,198173,"CHARLES DERTINGER","CHARLES W DENT","Republican",0.535658238004168,-19967,192339,-0.103811499487883
2006,"PENNSYLVANIA",16,80915,115741,204669,"LOIS K HERR","JOSEPH R PITTS","Republican",0.565503324880661,-34826,196656,-0.177090960865674
2006,"PENNSYLVANIA",17,137253,75455,212777,"TIM HOLDEN","MATTHEW A WERTZ","Democrat",0.645055621613238,61798,212708,0.290529740301258
2006,"PENNSYLVANIA",18,105419,144632,250240,"CHAD KLUKO","TIM MURPHY","Republican",0.577973145780051,-39213,250051,-0.156820008718221
2006,"PENNSYLVANIA",19,74625,142512,222898,"PHILIP J AVILLO JR","TODD RUSSELL PLATTS","Republican",0.639359707130616,-67887,217137,-0.312645933212672
2006,"RHODE ISLAND",1,124634,41836,180104,"PATRICK J KENNEDY","JONATHAN P SCOTT","Democrat",0.692011282370186,82798,166470,0.497374902384814
2006,"SOUTH CAROLINA",1,73218,115766,193375,"RANDY MAATTA","HENRY E BROWN JR","Republican",0.598660633484163,-42548,188984,-0.22514075265631
2006,"SOUTH CAROLINA",2,76090,127811,204052,"MICHAEL RAY ELLISOR","JOE WILSON","Republican",0.626364848175955,-51721,203901,-0.253657412175517
2006,"SOUTH CAROLINA",3,66039,111882,177988,"LEE BALLENGER","J GRESHAM BARRETT","Republican",0.62859293884981,-45843,177921,-0.257659298227865
2006,"SOUTH CAROLINA",4,57490,115553,179931,"WILLIAM GRIFF GRIFFITH","BOB INGLIS","Republican",0.642207290572497,-58063,173043,-0.335540877123027
2006,"SOUTH CAROLINA",5,99669,75422,175154,"JOHN M SPRATT JR","RALPH NORMAN","Democrat",0.56903639083321,24247,175091,0.138482274931321
2006,"SOUTH CAROLINA",6,100213,53181,155706,"JAMES E CLYBURN","GARY MCLEOD","Democrat",0.643603971587479,47032,153394,0.306609124216071
2006,"SOUTH DAKOTA",0,230468,97864,333562,"STEPHANIE HERSETH","BRUCE W WHALEN","Democrat",0.690930022004905,132604,328332,0.403871690849506
2006,"TENNESSEE",1,65538,108336,177278,"RICK TRENT","DAVID DAVIS","Republican",0.611107977301188,-42798,173874,-0.246143759273957
2006,"TENNESSEE",2,45025,157095,202120,"JOHN GREENE","JOHN J DUNCAN JR","Republican",0.777236295270137,-112070,202120,-0.554472590540273
2006,"TENNESSEE",3,68324,130791,199115,"BRENT BENEDICT","ZACH WAMP","Republican",0.656861612635914,-62467,199115,-0.313723225271828
2006,"TENNESSEE",4,123666,62449,186115,"LINCOLN DAVIS","KENNETH MARTIN","Democrat",0.664460145608898,61217,186115,0.328920291217795
2006,"TENNESSEE",5,122919,49702,178142,"JIM COOPER","THOMAS F KOVACH","Democrat",0.69000572576933,73217,172621,0.424148857902573
2006,"TENNESSEE",6,129069,60392,192380,"BART GORDON","DAVID R DAVIS","Democrat",0.670906539141283,68677,189461,0.362486210882451
2006,"TENNESSEE",7,73369,152288,230582,"BILL MORRISON","MARSHA BLACKBURN","Republican",0.660450512182217,-78919,225657,-0.349729899803684
2006,"TENNESSEE",8,129610,47492,177108,"JOHN S TANNER","JOHN FARMER","Democrat",0.731813356821826,82118,177102,0.463676299533602
2006,"TENNESSEE",9,103341,31002,172586,"STEVE COHEN","MARK WHITE","Democrat",0.59877973879689,72339,134343,0.538464973984502
2006,"TEXAS",1,46303,104099,153070,"ROGER L OWEN","LOUIE GOHMERT","Republican",0.680074475730058,-57796,150402,-0.384276804829723
2006,"TEXAS",2,45080,90490,137865,"GARY E BINDERIM","TED POE","Republican",0.656366735574656,-45410,135570,-0.334956111234049
2006,"TEXAS",3,49529,88690,141881,"DAN DODD","SAM JOHNSON","Republican",0.625101317301119,-39161,138219,-0.283325736693219
2006,"TEXAS",4,55278,106495,165269,"GLENN MELANCON","RALPH M HALL","Republican",0.644373717999141,-51217,161773,-0.316597948977889
2006,"TEXAS",5,50983,88478,143252,"CHARLIE THOMPSON","JEB HENSARLING","Republican",0.617638846229023,-37495,139461,-0.268856526197288
2006,"TEXAS",6,56369,91927,152036,"DAVID T HARRIS","JOE BARTON","Republican",0.604639690599595,-35558,148296,-0.239777202352053
2006,"TEXAS",7,64514,99318,167785,"JIM HENLEY","JOHN ABNEY CULBERSON","Republican",0.591936108710552,-34804,163832,-0.212437130719273
2006,"TEXAS",8,51393,105665,157058,"JAMES ""JIM"" WRIGHT","KEVIN BRADY","Republican",0.672776935909027,-54272,157058,-0.345553871818054
2006,"TEXAS",10,71415,97726,176755,"TED ANKRUM","MICHAEL T MCCAUL","Republican",0.552889592939379,-26311,169141,-0.155556606618147
2006,"TEXAS",12,45676,98371,146935,"JOHN R MORRIS","KAY GRANGER","Republican",0.669486507639432,-52695,144047,-0.365818101036467
2006,"TEXAS",13,33460,108107,145396,"ROGER J WAUN","MAC THORNBERRY","Republican",0.743534897796363,-74647,141567,-0.527290964702226
2006,"TEXAS",14,62429,94380,156809,"SHANE SKLAR","RON PAUL","Republican",0.601878718695993,-31951,156809,-0.203757437391986
2006,"TEXAS",15,43236,26751,69987,"RUBEN HINOJOSA","EDDIE ZAMORA","Democrat",0.617771871919071,16485,69987,0.235543743838141
2006,"TEXAS",17,92478,64142,159124,"CHET EDWARDS","VAN TAYLOR","Democrat",0.58116940247857,28336,156620,0.180921976759035
2006,"TEXAS",18,65936,16448,86051,"SHEILA JACKSON-LEE","AHMAD HASSAN","Democrat",0.766243274337312,49488,82384,0.600699164886386
2006,"TEXAS",19,41676,94785,140007,"ROBERT RICKETTS","RANDY NEUGEBAUER","Republican",0.677001864192505,-53109,136461,-0.389188119682547
2006,"TEXAS",21,68312,122486,203782,"GENE KELLY","LAMAR S SMITH","Republican",0.60106388199154,-54174,190798,-0.283933793855282
2006,"TEXAS",22,76775,100497,123922,"NICK LAMPSON","DON RICHARDSON","Republican",0.810969803586127,-23722,177272,-0.133816959249064
2006,"TEXAS",22,76775,100497,148239,"NICK LAMPSON","DON RICHARDSON","Republican",0.677939003905855,-23722,177272,-0.133816959249064
2006,"TEXAS",23,98539,92392,123799,"ADRIAN DELEON","HENRY BONILLA","Democrat",0.795959579641193,6147,190931,0.0321948766831997
2006,"TEXAS",23,98539,92392,70473,"ADRIAN DELEON","HENRY BONILLA","Democrat",1.39825181275098,6147,190931,0.0321948766831997
2006,"TEXAS",24,52075,83835,140138,"GARY R PAGE","KENNY MARCHANT","Republican",0.598231742996189,-31760,135910,-0.233684055625046
2006,"TEXAS",25,109911,42975,163424,"LLOYD DOGGETT","GRANT ROSTIG","Democrat",0.672551155277071,66936,152886,0.437816412228719
2006,"TEXAS",26,58271,94219,156483,"TIM BARNWELL","MICHAEL C BURGESS","Republican",0.60210374289859,-35948,152490,-0.235740048527772
2006,"TEXAS",27,62058,42538,109314,"SOLOMON P ORTIZ","WM ""WILLIE"" VADEN","Democrat",0.56770404522751,19520,104596,0.186622815404031
2006,"TEXAS",29,37174,12347,50550,"GENE GREEN","ERIC STORY","Democrat",0.735390702274975,24827,49521,0.501342864643283
2006,"TEXAS",30,81348,17850,101448,"EDDIE BERNICE JOHNSON","WILSON AURBACH","Democrat",0.801868937780932,63498,99198,0.640113711969999
2006,"TEXAS",31,60293,90869,155383,"MARY BETH HARRELL","JOHN R CARTER","Republican",0.584806574721816,-30576,151162,-0.202273058043688
2006,"TEXAS",32,52269,71461,126652,"WILL PRYOR","PETE SESSIONS","Republican",0.564231121498279,-19192,123730,-0.155111937282793
2006,"UTAH",1,57922,112546,178474,"STEVEN OLSEN","ROB BISHOP","Republican",0.630601656263657,-54624,170468,-0.320435506957317
2006,"UTAH",2,133231,84234,225818,"JIM MATHESON","LAVAR CHRISTENSEN","Democrat",0.58999282608118,48997,217465,0.22530981997103
2006,"UTAH",3,53330,95455,165398,"CHRISTIAN BURRIDGE","CHRIS CANNON","Republican",0.57712306073834,-42125,148785,-0.283126659273448
2006,"VERMONT",0,139815,117023,262726,"PETER WELCH","MARTHA RAINVILLE","Democrat",0.532170398057292,22792,256838,0.088740762659731
2006,"VIRGINIA",1,81083,143889,228534,"SHAWN M O'DONNELL","JO ANN DAVIS","Republican",0.629617474861509,-62806,224972,-0.27917251924684
2006,"VIRGINIA",2,83901,88777,173159,"PHILIP J KELLAM","THELMA D DRAKE","Republican",0.512690648479143,-4876,172678,-0.0282375288108503
2006,"VIRGINIA",5,84682,125370,212079,"AL C WEED II","VIRGIL H GOODE JR","Republican",0.591147638380038,-40688,210052,-0.193704416049359
2006,"VIRGINIA",7,88206,163706,256397,"JAMES M NACHMAN","ERIC CANTOR","Republican",0.638486409747384,-75500,251912,-0.299707834481883
2006,"VIRGINIA",8,144700,66639,217909,"JAMES P MORAN","TOM M O'DONOGHUE","Democrat",0.664038658339031,78061,211339,0.369363912955015
2006,"VIRGINIA",9,129705,61574,191415,"RICK BOUCHER","C W ""BILL"" CARRICO","Democrat",0.677611472455137,68131,191279,0.356186512894777
2006,"VIRGINIA",10,98769,138213,241134,"JUDY M FEDER","FRANK R WOLF","Republican",0.573179228147005,-39444,236982,-0.166443020988936
2006,"VIRGINIA",11,102511,130468,235280,"ANDREW L HURST","TOM DAVIS","Republican",0.55452227133628,-27957,232979,-0.119997939728473
2006,"WASHINGTON",1,163832,78105,241937,"JAY INSLEE","LARRY W ISHMAEL","Democrat",0.677168023080389,85727,241937,0.354336046160777
2006,"WASHINGTON",2,157064,87730,244794,"RICK LARSEN","DOUG ROULSTONE","Democrat",0.641617033097216,69334,244794,0.283234066194433
2006,"WASHINGTON",3,147065,85915,232980,"BRIAN BAIRD","MICHAEL MESSMORE","Democrat",0.631234440724526,61150,232980,0.262468881449051
2006,"WASHINGTON",4,77054,115246,192300,"RICHARD WRIGHT","DOC HASTINGS","Republican",0.599303172126885,-38192,192300,-0.19860634425377
2006,"WASHINGTON",5,104357,134967,239324,"PETER J GOLDMARK","CATHY MCMORRIS","Republican",0.563950961875951,-30610,239324,-0.127901923751901
2006,"WASHINGTON",6,158202,65883,224085,"NORMAN D DICKS","DOUG CLOUD","Democrat",0.705991030189437,92319,224085,0.411982060378874
2006,"WASHINGTON",7,195462,38715,246133,"JIM MCDERMOTT","STEVE BEREN","Democrat",0.794131628022248,156747,234177,0.669352669134885
2006,"WASHINGTON",8,122021,129362,251383,"DARCY BURNER","DAVID G REICHERT","Republican",0.51460122601767,-7341,251383,-0.0292024520353405
2006,"WASHINGTON",9,119038,62082,181120,"ADAM SMITH","STEVEN C COFCHIN","Democrat",0.65723277385159,56956,181120,0.31446554770318
2006,"WEST VIRGINIA",1,100939,55963,157000,"ALAN B MOLLOHAN","CHRIS WAKIM","Democrat",0.642923566878981,44976,156902,0.286650265770991
2006,"WEST VIRGINIA",2,70470,94110,164580,"MIKE CALLAGHAN","SHELLEY MOORE CAPITO","Republican",0.571819176084579,-23640,164580,-0.143638352169158
2006,"WEST VIRGINIA",3,92413,40820,133233,"NICK J RAHALL II","KIM WOLFE","Democrat",0.693619448635098,51593,133233,0.387238897270196
2006,"WISCONSIN",1,95761,161320,257596,"JEFFREY C THOMAS","PAUL RYAN","Republican",0.626251960434168,-65559,257081,-0.255013011463313
2006,"WISCONSIN",2,191414,113015,304688,"TAMMY BALDWIN","DAVE MAGNUM","Democrat",0.628229533161792,78399,304429,0.257528027881706
2006,"WISCONSIN",3,163322,88523,252087,"RON KIND","PAUL R NELSON","Democrat",0.647879501917989,74799,251845,0.297004109670631
2006,"WISCONSIN",4,136735,54486,191742,"GWEN MOORE","PERFECTO RIVERA","Democrat",0.713119712947607,82249,191221,0.430125352341009
2006,"WISCONSIN",5,112451,194669,315180,"BRYAN KENNEDY","F JAMES SENSENBRENNER JR","Republican",0.617643886033378,-82218,307120,-0.267706433967179
2006,"WISCONSIN",7,161903,91069,260428,"DAVID R OBEY","NICK REID","Democrat",0.621680464466186,70834,252972,0.280007273532249
2006,"WISCONSIN",8,141570,135622,278135,"STEVEN L KAGEN","JOHN GARD","Democrat",0.508997429305913,5948,277192,0.021458050737395
2006,"WYOMING",0,92324,93336,196215,"GARY TRAUNER","BARBARA CUBIN","Republican",0.475682287286905,-1012,185660,-0.00545082408704083
2008,"ALABAMA",2,144368,142578,287394,"BOBBY BRIGHT","JAY LOVE","Democrat",0.502334773864451,1790,286946,0.0062381075184878
2008,"ALABAMA",3,121080,142708,264120,"JOSHUA SEGALL","MIKE ROGERS","Republican",0.540315008329547,-21628,263788,-0.0819900829453955
2008,"ALABAMA",4,66077,196741,263167,"NICHOLAS B SPARKS","ROBERT B ADERHOLT","Republican",0.747589933388305,-130664,262818,-0.497165338751531
2008,"ALABAMA",5,158324,147314,307282,"PARKER GRIFFITH","WAYNE PARKER","Democrat",0.515240072636861,11010,305638,0.0360230076103102
2008,"ALASKA",0,142560,158939,316978,"ETHAN A BERKOWITZ","DON YOUNG","Republican",0.501419656884705,-16379,301499,-0.0543252216425262
2008,"ARIZONA",1,155791,109924,278787,"ANN KIRKPATRICK","SYDNEY HAY","Democrat",0.558817304967592,45867,265715,0.172617277910543
2008,"ARIZONA",2,125611,200914,338023,"JOHN THRASHER","TRENT FRANKS","Republican",0.594379672389157,-75303,326525,-0.230619401270959
2008,"ARIZONA",3,115759,148800,275161,"BOB LORD","JOHN B SHADEGG","Republican",0.540774310312871,-33041,264559,-0.124890856103931
2008,"ARIZONA",4,89721,26435,124427,"ED PASTOR","DON KARG","Democrat",0.721073400467744,63286,116156,0.544836254691966
2008,"ARIZONA",5,149033,122165,280365,"HARRY E MITCHELL","DAVID SCHWEIKERT","Democrat",0.531567777718331,26868,271198,0.0990715270761584
2008,"ARIZONA",6,115457,208582,334176,"REBECCA SCHNEIDER","JEFF FLAKE","Republican",0.624168103035526,-93125,324039,-0.287388246476504
2008,"ARIZONA",7,124304,64425,196489,"RAUL M GRIJALVA","JOSEPH SWEENEY","Democrat",0.632625744952644,59879,188729,0.317275034573383
2008,"ARIZONA",8,179629,140553,328266,"GABRIELLE GIFFORDS","TIM BEE","Democrat",0.547205619832697,39076,320182,0.122043087993704
2008,"CALIFORNIA",1,197812,67853,290472,"MIKE THOMPSON","ZANE STARKEWOLF","Democrat",0.681001955438046,129959,265665,0.489183746447594
2008,"CALIFORNIA",2,118878,163459,282337,"JEFF MORRIS","WALLY HERGER","Republican",0.57894997821752,-44581,282337,-0.15789995643504
2008,"CALIFORNIA",3,137971,155424,314046,"BILL DURSTON","DANIEL E LUNGREN","Republican",0.494908389216866,-17453,293395,-0.0594863579815607
2008,"CALIFORNIA",4,183990,185790,369780,"CHARLIE BROWN","TOM MCCLINTOCK","Republican",0.502433879604089,-1800,369780,-0.00486775920817784
2008,"CALIFORNIA",5,164242,46002,221155,"DORIS O MATSUI","PAUL A SMITH","Democrat",0.742655603535982,118240,210244,0.562394170582751
2008,"CALIFORNIA",6,229672,77073,320362,"LYNN C WOOLSEY","MIKE HALLIWELL","Democrat",0.716913991047627,152599,306745,0.497478361505485
2008,"CALIFORNIA",7,170962,51166,234773,"GEORGE MILLER","ROGER ALLEN PETERSON","Democrat",0.728201283793281,119796,222128,0.539310667723115
2008,"CALIFORNIA",8,204996,27614,285247,"NANCY PELOSI","DANA WALSH","Democrat",0.718661370671734,177382,232610,0.76257254632217
2008,"CALIFORNIA",9,238915,26917,277600,"BARBARA LEE","CHARLES HARGRAVE","Democrat",0.860644812680115,211998,265832,0.797488639441452
2008,"CALIFORNIA",10,192226,91877,295165,"ELLEN O TAUSCHER","NICHOLAS GERBER","Democrat",0.651249301238291,100349,284103,0.353213447235686
2008,"CALIFORNIA",11,164500,133104,297616,"JERRY MCNERNEY","DEAN ANDAL","Democrat",0.552725659910758,31396,297604,0.105495893872394
2008,"CALIFORNIA",12,200442,49258,266853,"JACKIE SPEIER","GREG CONLON","Democrat",0.751132646063563,151184,249700,0.605462555066079
2008,"CALIFORNIA",13,166829,51447,218276,"FORTNEY PETE STARK","RAYMOND CHUI","Democrat",0.764302992541553,115382,218276,0.528605985083106
2008,"CALIFORNIA",14,190301,60610,272766,"ANNA G ESHOO","RONNY SANTANA","Democrat",0.697671264013843,129691,250911,0.516880487503537
2008,"CALIFORNIA",15,170977,55489,238589,"MICHAEL M HONDA","JOYCE STOER CORDI","Democrat",0.71661727908663,115488,226466,0.509957344590358
2008,"CALIFORNIA",16,146481,49399,205327,"ZOE LOFGREN","CHAREL WINSTON","Democrat",0.713403497835161,97082,195880,0.495619767204411
2008,"CALIFORNIA",17,168907,59037,228626,"SAM FARR","JEFF TAYLOR","Democrat",0.73879173847244,109870,227944,0.482004351946092
2008,"CALIFORNIA",20,93023,32118,125141,"JIM COSTA","JIM LOPEZ","Democrat",0.743345506268929,60905,125141,0.486691012537857
2008,"CALIFORNIA",21,66317,143498,209815,"LARRY JOHNSON","DEVIN NUNES","Republican",0.683926316040321,-77181,209815,-0.367852632080642
2008,"CALIFORNIA",23,171403,80385,251788,"LOIS CAPPS","MATT T KOKKONEN","Democrat",0.68074332374855,91018,251788,0.361486647497101
2008,"CALIFORNIA",24,125560,174492,300052,"MARTA ANN JORGENSEN","ELTON GALLEGLY","Republican",0.581539199872022,-48932,300052,-0.163078399744044
2008,"CALIFORNIA",25,105929,144660,250589,"JACKIE CONAWAY","HOWARD P ""BUCK"" MCKEON","Republican",0.577279928488481,-38731,250589,-0.154559856976962
2008,"CALIFORNIA",26,108039,140615,267130,"RUSS WARNER","DAVID DREIER","Republican",0.526391644517651,-32576,248654,-0.131009354363895
2008,"CALIFORNIA",27,145812,52852,212835,"BRAD SHERMAN","NAVRAJ SINGH","Democrat",0.685094086968779,92960,198664,0.467925743969718
2008,"CALIFORNIA",29,146198,56727,212144,"ADAM B SCHIFF","CHARLES HAHN","Democrat",0.689145108982578,89471,202925,0.440906738942959
2008,"CALIFORNIA",33,186924,26536,213460,"DIANE E WATSON","DAVID C CROWLEY II","Democrat",0.875686311252694,160388,213460,0.751372622505387
2008,"CALIFORNIA",34,98503,29266,127769,"LUCILLE ROYBAL-ALLARD","CHRISTOPHER BALDING","Democrat",0.770946004116805,69237,127769,0.541892008233609
2008,"CALIFORNIA",35,150778,24169,182579,"MAXINE WATERS","TED HAYES","Democrat",0.825823342224462,126609,174947,0.723699177465175
2008,"CALIFORNIA",36,171948,78543,250491,"JANE HARMAN","BRIAN GIBSON","Democrat",0.686443824329018,93405,250491,0.372887648658036
2008,"CALIFORNIA",39,125289,54533,179822,"LINDA T SANCHEZ","DIANE A LENNING","Democrat",0.696738997453037,70756,179822,0.393477994906074
2008,"CALIFORNIA",40,86772,144923,231695,"CHRISTINA AVALOS","EDWARD R ROYCE","Republican",0.625490407647985,-58151,231695,-0.250980815295971
2008,"CALIFORNIA",41,99214,159486,258700,"TIM PRINCE","JERRY LEWIS","Republican",0.616490143022806,-60272,258700,-0.232980286045613
2008,"CALIFORNIA",42,104909,158404,263313,"EDWIN ""ED"" CHAU","GARY G MILLER","Republican",0.601580628377634,-53495,263313,-0.203161256755268
2008,"CALIFORNIA",43,108259,48312,156571,"JOE BACA","JOHN ROBERTS","Democrat",0.691437111597933,59947,156571,0.382874223195866
2008,"CALIFORNIA",44,123890,129937,253827,"BILL HEDRICK","KEN CALVERT","Republican",0.511911656364374,-6047,253827,-0.0238233127287483
2008,"CALIFORNIA",45,111026,155166,266192,"JULIE BORNSTEIN","MARY BONO MACK","Republican",0.582910079942297,-44140,266192,-0.165820159884595
2008,"CALIFORNIA",46,122891,149818,285277,"DEBBIE COOK","DANA ROHRABACHER","Republican",0.525166767738023,-26927,272709,-0.0987389488429058
2008,"CALIFORNIA",47,85878,31432,123584,"LORETTA SANCHEZ","ROSEMARIE ""ROSIE"" AVILA","Democrat",0.694895779388918,54446,117310,0.464120705822181
2008,"CALIFORNIA",48,125537,171658,308702,"STEVE YOUNG","JOHN CAMPBELL","Republican",0.556063776716704,-46121,297195,-0.155187671394202
2008,"CALIFORNIA",49,90138,140300,240670,"ROBERT HAMILTON","DARRELL E ISSA","Republican",0.582955914738023,-50162,230438,-0.217681111622215
2008,"CALIFORNIA",50,141635,157502,313502,"NICK LEIBHAM","BRIAN P BILBRAY","Republican",0.502395519007853,-15867,299137,-0.0530425858385957
2008,"CALIFORNIA",51,148281,49345,203825,"BOB FILNER","DAVID LEE JOY","Democrat",0.727491720838955,98936,197626,0.500622387742504
2008,"CALIFORNIA",52,111051,160724,285138,"MIKE LUMPKIN","DUNCAN D HUNTER","Republican",0.563670924254221,-49673,271775,-0.182772514028148
2008,"CALIFORNIA",53,161315,64658,235542,"SUSAN A DAVIS","MICHAEL CRIMMINS","Democrat",0.684867242360174,96657,225973,0.427736942024047
2008,"COLORADO",1,203755,67345,283246,"DIANA DEGETTE","GEORGE C LILLY","Democrat",0.719357025341929,136410,271100,0.503172261158244
2008,"COLORADO",2,215571,116591,344364,"JARED POLIS","SCOTT STARIN","Democrat",0.625997491026937,98980,332162,0.297987126763447
2008,"COLORADO",3,203455,126762,330217,"JOHN T SALAZAR","WAYNE WOLF","Democrat",0.616125154065357,76693,330217,0.232250308130714
2008,"COLORADO",4,187347,146028,333375,"BETSY MARKEY","MARILYN N MUSGRAVE","Democrat",0.561970753655793,41319,333375,0.123941507311586
2008,"COLORADO",5,113025,183178,305142,"HAL BIDLACK","DOUG LAMBORN","Republican",0.600304120704459,-70153,296203,-0.236840950294224
2008,"COLORADO",6,162639,250877,413516,"HANK ENG","MIKE COFFMAN","Republican",0.606692364987086,-88238,413516,-0.213384729974173
2008,"COLORADO",7,173931,100055,273986,"ED PERLMUTTER","JOHN W LEREW","Democrat",0.634817107443446,73876,273986,0.269634214886892
2008,"CONNECTICUT",1,194493,76860,295557,"JOHN B LARSON","JOE VISCONTI","Democrat",0.658055806494179,117633,271353,0.433505433881328
2008,"CONNECTICUT",2,198984,104574,323041,"JOE COURTNEY","SEAN SULLIVAN","Democrat",0.615971347290282,94410,303558,0.311011404739786
2008,"CONNECTICUT",3,204761,58583,297368,"ROSA L DELAURO","BO ITSHAKY","Democrat",0.688577789136693,146178,263344,0.555083844705025
2008,"CONNECTICUT",4,149345,146854,308776,"JIM HIMES","CHRISTOPHER SHAYS","Democrat",0.48366777210664,2491,296199,0.00840988659651113
2008,"CONNECTICUT",5,161178,117914,302657,"CHRISTOPHER S MURPHY","DAVID J CAPPIELLO","Democrat",0.532543440264061,43264,279092,0.155016983646969
2008,"DELAWARE",0,146434,235437,385457,"KAREN HARTLEY-NAGLE","MICHAEL N CASTLE","Republican",0.610799648209787,-89003,381871,-0.23307085376999
2008,"FLORIDA",1,98797,232559,331356,"JAMES ""JIM"" BRYAN","JEFF MILLER","Republican",0.701840316759014,-133762,331356,-0.403680633518029
2008,"FLORIDA",2,216804,133404,350367,"ALLEN BOYD","MARK MULLIGAN","Democrat",0.618791153276422,83400,350208,0.238144188596491
2008,"FLORIDA",4,119330,224112,343442,"JAY MCGOVERN","ANDER CRENSHAW","Republican",0.652546863808154,-104782,343442,-0.305093727616308
2008,"FLORIDA",5,168446,265186,433632,"JOHN RUSSELL","GINNY BROWN-WAITE","Republican",0.611546195852705,-96740,433632,-0.223092391705409
2008,"FLORIDA",6,146655,228302,374957,"TIM CUNHA","CLIFF STEARNS","Republican",0.608875151017317,-81647,374957,-0.217750302034633
2008,"FLORIDA",7,146292,238721,385013,"FAYE ARMITAGE","JOHN L MICA","Republican",0.620033609254752,-92429,385013,-0.240067218509505
2008,"FLORIDA",8,172854,159490,332344,"ALAN GRAYSON","RIC KELLER","Democrat",0.520105673639362,13364,332344,0.0402113472787232
2008,"FLORIDA",9,126346,216591,348378,"BILL MITCHELL","GUS M BILIRAKIS","Republican",0.621712622496254,-90245,342937,-0.263153290546077
2008,"FLORIDA",10,118430,182781,301220,"BOB HACKWORTH","C W BILL YOUNG","Republican",0.606802337162207,-64351,301211,-0.213640936087991
2008,"FLORIDA",11,184106,72825,256931,"KATHY CASTOR","EDDIE ADAMS JR","Democrat",0.716558142069271,111281,256931,0.433116284138543
2008,"FLORIDA",12,137465,185698,323163,"DOUG TUDOR","ADAM H PUTNAM","Republican",0.574626426911497,-48233,323163,-0.149252853822993
2008,"FLORIDA",13,137967,204382,367996,"CHRISTINE JENNINGS","VERN BUCHANAN","Republican",0.555391906433766,-66415,342349,-0.193997937776947
2008,"FLORIDA",14,93590,224602,377891,"ROBERT M NEELD","CONNIE MACK","Republican",0.594356573720994,-131012,318192,-0.411738824357621
2008,"FLORIDA",15,151951,192151,361871,"STEPHEN BLYTHE","BILL POSEY","Republican",0.530993088697354,-40200,344102,-0.116825824900756
2008,"FLORIDA",16,139373,209874,349247,"TIM MAHONEY","TOM ROONEY","Republican",0.600932864133407,-70501,349247,-0.201865728266814
2008,"FLORIDA",18,102372,140617,242989,"ANNETTE TADDEO","ILEANA ROS-LEHTINEN","Republican",0.578696978052504,-38245,242989,-0.157393956105009
2008,"FLORIDA",19,202465,83357,306036,"ROBERT WEXLER","EDWARD J LYNCH","Democrat",0.661572494739181,119108,285822,0.416720896222124
2008,"FLORIDA",21,99776,137226,237002,"RAUL L MARTINEZ","LINCOLN DIAZ-BALART","Republican",0.579007772086311,-37450,237002,-0.158015544172623
2008,"FLORIDA",22,169041,140104,309151,"RON KLEIN","ALLEN WEST","Democrat",0.546791050328157,28937,309145,0.0936033253004254
2008,"FLORIDA",23,172835,37431,210306,"ALCEE L HASTINGS","MARION D THORPE JR","Democrat",0.821826291213755,135404,210266,0.643965263047759
2008,"FLORIDA",24,211284,151863,369370,"SUZANNE M KOSMAS","TOM FEENEY","Democrat",0.572011803882286,59421,363147,0.16362795231683
2008,"FLORIDA",25,115820,130891,246711,"JOE GARCIA","MARIO DIAZ-BALART","Republican",0.530543834689171,-15071,246711,-0.0610876693783415
2008,"GEORGIA",1,83444,165890,249334,"BILL GILLESPIE","JACK KINGSTON","Republican",0.665332445635172,-82446,249334,-0.330664891270344
2008,"GEORGIA",2,158435,71351,229786,"SANFORD D BISHOP JR","LEE FERRELL","Democrat",0.689489350961329,87084,229786,0.378978701922658
2008,"GEORGIA",3,117522,225055,342580,"STEPHEN CAMP","LYNN A WESTMORELAND","Republican",0.65694144433417,-107533,342577,-0.313894394544876
2008,"GEORGIA",6,106551,231520,338071,"BILL JONES","TOM PRICE","Republican",0.684826560101281,-124969,338071,-0.369653120202561
2008,"GEORGIA",7,128159,209354,337513,"DOUG HECKMAN","JOHN LINDER","Republican",0.620284255717558,-81195,337513,-0.240568511435115
2008,"GEORGIA",8,157241,117446,274687,"JIM MARSHALL","RICK GODDARD","Democrat",0.572436991921714,39795,274687,0.144873983843429
2008,"GEORGIA",9,70537,217493,288030,"JEFF SCOTT","NATHAN DEAL","Republican",0.755105370968302,-146956,288030,-0.510210741936604
2008,"GEORGIA",10,114638,177265,291903,"BOBBY SAXON","PAUL C BROUN","Republican",0.607273649123168,-62627,291903,-0.214547298246335
2008,"GEORGIA",11,95220,204082,299302,"HUGH ""BUD"" GAMMON","PHIL GINGREY","Republican",0.681859793786877,-108862,299302,-0.363719587573755
2008,"GEORGIA",12,164562,84773,249335,"JOHN BARROW","JOHN STONE","Democrat",0.66000360960154,79789,249335,0.32000721920308
2008,"GEORGIA",13,205919,92320,298239,"DAVID SCOTT","DEBORAH HONEYCUTT","Democrat",0.690449605853024,113599,298239,0.380899211706048
2008,"HAWAII",1,154208,38115,218434,"NEIL ABERCROMBIE","STEVE TATAII","Democrat",0.705970682219801,116093,192323,0.603635550610171
2008,"HAWAII",2,165748,44425,237630,"MAZIE K HIRONO","ROGER B EVANS","Democrat",0.697504523839583,121323,210173,0.57725302488902
2008,"IDAHO",1,175898,171687,347585,"WALT MINNICK","BILL SALI","Democrat",0.50605751111239,4211,347585,0.0121150222247796
2008,"IDAHO",2,83878,205777,290267,"DEBORAH HOLMES","MICHAEL K SIMPSON","Republican",0.708923163845701,-121899,289655,-0.420842036215498
2008,"ILLINOIS",1,233036,38361,271397,"BOBBY L RUSH","ANTOINE MEMBERS","Democrat",0.858653559177146,194675,271397,0.717307118354293
2008,"ILLINOIS",2,251052,29721,280776,"JESSE L JACKSON JR","ANTHONY W WILLIAMS","Democrat",0.894136250961621,221331,280773,0.788291609235931
2008,"ILLINOIS",3,172581,50336,235524,"DANIEL LIPINSKI","MICHAEL HAWKINS","Democrat",0.732753349977072,122245,222917,0.548387965027342
2008,"ILLINOIS",4,112529,16024,139606,"LUIS V GUTIERREZ","DANIEL CUNNINGHAM","Democrat",0.806047018036474,96505,128553,0.750702045070905
2008,"ILLINOIS",5,170728,50881,230892,"RAHM EMANUEL","TOM HANSON","Democrat",0.739427957659858,119847,221609,0.540803848219161
2008,"ILLINOIS",6,109007,147906,256913,"JILL MORGENTHALER","PETER J ROSKAM","Republican",0.575704615959488,-38899,256913,-0.151409231918976
2008,"ILLINOIS",7,235343,41474,276817,"DANNY K DAVIS","STEVE MILLER","Democrat",0.850175386627266,193869,276817,0.700350773254533
2008,"ILLINOIS",8,179444,116081,295525,"MELISSA L BEAN","STEVE GREENBERG","Democrat",0.607204128246341,63363,295525,0.214408256492683
2008,"ILLINOIS",9,181948,53593,243694,"JANICE D SCHAKOWSKY","MICHAEL BENJAMIN YOUNAN","Democrat",0.74662486561015,128355,235541,0.544936974879108
2008,"ILLINOIS",10,138176,153082,291258,"DANIEL J SEALS","MARK STEVEN KIRK","Republican",0.525588996697086,-14906,291258,-0.0511779933941729
2008,"ILLINOIS",11,185652,109608,317895,"DEBORAH ""DEBBIE"" HALVORSON","MARTY OZINGA","Democrat",0.584004152314443,76044,295260,0.25754927860191
2008,"ILLINOIS",12,212891,74382,298181,"JERRY F COSTELLO","TIMMY JAY RICHARDSON JR","Democrat",0.713965678564362,138509,287273,0.482151124540072
2008,"ILLINOIS",13,147430,180888,337771,"SCOTT HARPER","JUDY BIGGERT","Republican",0.535534430131657,-33458,328318,-0.101907297193575
2008,"ILLINOIS",14,185404,135653,321057,"BILL FOSTER","JIM OBERWEIS","Democrat",0.577480011337551,49751,321057,0.154960022675101
2008,"ILLINOIS",15,104393,187121,291514,"STEVE COX","TIMOTHY V JOHNSON","Republican",0.641893699788003,-82728,291514,-0.283787399576007
2008,"ILLINOIS",16,112648,190039,312220,"ROBERT G ABBOUD","DONALD A MANZULLO","Republican",0.60867016847095,-77391,302687,-0.255679959826487
2008,"ILLINOIS",18,117642,182589,310088,"COLLEEN CALLAHAN","AARON SCHOCK","Republican",0.588829622558757,-64947,300231,-0.216323430958162
2008,"ILLINOIS",19,105338,203434,315589,"DANIEL DAVIS","JOHN SHIMKUS","Republican",0.644616890956275,-98096,308772,-0.317697200523364
2008,"INDIANA",1,199954,76647,282022,"PETER J VISCLOSKY","MARK LEYVA","Democrat",0.709001425420712,123307,276601,0.445793760687778
2008,"INDIANA",2,187416,84455,279346,"JOE DONNELLY","LUKE PUCKETT","Democrat",0.670909911006422,102961,271871,0.378712698301768
2008,"INDIANA",3,112309,155693,282879,"MICHAEL A ""MIKE"" MONTAGANO","MARK E SOUDER","Republican",0.550387268054539,-43384,268002,-0.161879388959784
2008,"INDIANA",4,129038,192526,321564,"NELS ACKERSON","STEVE BUYER","Republican",0.598717518130139,-63488,321564,-0.197435036260278
2008,"INDIANA",5,123357,234705,358062,"MARY ETTA RULEY","DAN BURTON","Republican",0.655487038557568,-111348,358062,-0.310974077115136
2008,"INDIANA",6,94265,180608,282412,"BARRY A WELSH","MIKE PENCE","Republican",0.639519567157203,-86343,274873,-0.314119611602449
2008,"INDIANA",7,172650,92645,265299,"ANDRE CARSON","GABRIELLE CAMPO","Democrat",0.650775163117841,80005,265295,0.301569950432537
2008,"INDIANA",8,188693,102769,291462,"BRAD ELLSWORTH","GREG GOODE","Democrat",0.647401719606673,85924,291462,0.294803439213345
2008,"INDIANA",9,181281,120529,313804,"BARON P HILL","MIKE SODREL","Democrat",0.577688620922614,60752,301810,0.201292203704317
2008,"IOWA",1,186991,102439,289430,"BRUCE L BRALEY","DAVID HARTSUCH","Democrat",0.646066406384964,84552,289430,0.292132812769927
2008,"IOWA",2,175218,118778,306097,"DAVID LOEBSACK","MARIANNETTE MILLER-MEEKS","Democrat",0.572426387713699,56440,293996,0.191975401025864
2008,"IOWA",3,176904,132136,313639,"LEONARD L BOSWELL","KIM SCHMETT","Democrat",0.564036997949872,44768,309040,0.144861506601087
2008,"IOWA",4,120746,185458,306204,"BECKY GREENWALD","TOM LATHAM","Republican",0.605668116680383,-64712,306204,-0.211336233360766
2008,"IOWA",5,99601,159430,266437,"ROB HUBLER","STEVE KING","Republican",0.598377852925832,-59829,259031,-0.230972354660253
2008,"KANSAS",1,34771,214549,262027,"JAMES BORDONARO","JERRY MORAN","Republican",0.818804932316135,-179778,249320,-0.721073319428846
2008,"KANSAS",2,142013,155532,307308,"NANCY E BOYDA","LYNN JENKINS","Republican",0.506111132804873,-13519,297545,-0.0454351442638929
2008,"KANSAS",3,202541,142307,358858,"DENNIS MOORE","NICK JORDAN","Democrat",0.564404304766788,60234,344848,0.174668259639029
2008,"KANSAS",4,90706,177617,280109,"DONALD BETTS JR","TODD TIAHRT","Republican",0.634099582662464,-86911,268323,-0.323904398802935
2008,"KENTUCKY",1,98674,178107,276786,"HEATHER A RYAN","ED WHITFIELD","Republican",0.643482690598513,-79433,276781,-0.286988629999892
2008,"KENTUCKY",2,143379,158936,302315,"DAVID E BOSWELL","S BRETT GUTHRIE","Republican",0.525729785157865,-15557,302315,-0.0514595703157303
2008,"KENTUCKY",3,203843,139527,343370,"JOHN A YARMUTH","ANNE M NORTHUP","Democrat",0.593654075778315,64316,343370,0.18730815155663
2008,"KENTUCKY",4,111549,190210,301759,"MICHAEL KELLEY","GEOFF DAVIS","Republican",0.630337454723803,-78661,301759,-0.260674909447606
2008,"KENTUCKY",6,203764,111378,315142,"BEN CHANDLER","JON LARSON","Democrat",0.646578367846875,92386,315142,0.293156735693751
2008,"LOUISIANA",1,98839,189168,288007,"""JIM"" HARLAN","STEVE SCALISE","Republican",0.656817369022281,-90329,288007,-0.313634738044561
2008,"LOUISIANA",2,31318,33132,66882,"WILLIAM J JEFFERSON","ANH ""JOSEPH"" CAO","Republican",0.495379922849197,-1814,64450,-0.0281458494957331
2008,"LOUISIANA",4,44151,44501,92572,"PAUL J CARMOUCHE","JOHN FLEMING","Republican",0.480717711619064,-350,88652,-0.00394802147723684
2008,"LOUISIANA",6,125886,150332,312416,"DONALD J CAZAYOUX","WILLIAM ""BILL"" CASSIDY","Republican",0.481191744340879,-24446,276218,-0.0885025595725116
2008,"LOUISIANA",7,98280,177173,286299,"DONALD ""DON"" CRAVINS JR","CHARLES W BOUSTANY","Republican",0.618839045892581,-78893,275453,-0.286411837954206
2008,"MAINE",1,205629,168930,374559,"CHELLIE PINGREE","CHARLES E SUMMERS","Democrat",0.548989611783457,36699,374559,0.0979792235669147
2008,"MAINE",2,226274,109268,335542,"MICHAEL H MICHAUD","JOHN N FRARY","Democrat",0.674353732170637,117006,335542,0.348707464341275
2008,"MARYLAND",1,177065,174213,360480,"FRANK M KRATOVIL JR","ANDY HARRIS","Democrat",0.49119229915668,2852,351278,0.0081189257511145
2008,"MARYLAND",2,198578,68561,276333,"C A DUTCH RUPPERSBERGER","RICHARD PRYCE MATTHEWS","Democrat",0.71861847843001,130017,267139,0.48670167964992
2008,"MARYLAND",3,203711,87971,292448,"JOHN P SARBANES","THOMAS E ""PINKSTON"" HARRIS","Democrat",0.696571698216435,115740,291682,0.396801996695031
2008,"MARYLAND",4,258704,38739,301431,"DONNA F EDWARDS","PETER JAMES","Democrat",0.858252800806818,219965,297443,0.739519840776216
2008,"MARYLAND",5,253854,82631,344691,"STENY H HOYER","COLLINS BAILEY","Democrat",0.736468315099611,171223,336485,0.508857749973996
2008,"MARYLAND",6,128207,190926,330535,"JENNIFER P DOUGHERTY","ROSCOE G BARTLETT","Republican",0.577627180177591,-62719,319133,-0.196529346698712
2008,"MARYLAND",7,227379,53147,286020,"ELIJAH E CUMMINGS","MICHAEL T HARGADON","Democrat",0.79497587581288,174232,280526,0.621090380214312
2008,"MARYLAND",8,229740,66351,306014,"CHRIS VAN HOLLEN","STEVE HUDSON","Democrat",0.750749965687844,163389,296091,0.551820217433154
2008,"MASSACHUSETTS",1,215696,80067,309617,"JOHN W OLVER","NATHAN A BECH","Democrat",0.696654253480913,135629,295763,0.458573249527493
2008,"MASSACHUSETTS",4,203032,75571,315734,"BARNEY FRANK","EARL HENRY SHOLLEY","Democrat",0.643047628700108,127461,278603,0.457500457640442
2008,"MASSACHUSETTS",6,226216,94845,338718,"JOHN F TIERNEY","RICHARD A BAKER","Democrat",0.667859399264285,131371,321061,0.409177695204338
2008,"MASSACHUSETTS",7,212304,67978,301210,"EDWARD J MARKEY","JOHN CUNNINGHAM","Democrat",0.704837156800903,144326,280282,0.514931390528111
2008,"MICHIGAN",1,213216,107340,327836,"BART STUPAK","TOM CASPERSON","Democrat",0.650373967471541,105876,320556,0.33028862351664
2008,"MICHIGAN",2,119506,214100,343309,"FRED JOHNSON","PETER HOEKSTRA","Republican",0.623636432485021,-94594,333606,-0.283550056054148
2008,"MICHIGAN",3,117961,203799,333518,"HENRY SANCHEZ","VERNON J EHLERS","Republican",0.611058473605622,-85838,321760,-0.266776479363501
2008,"MICHIGAN",4,117665,204259,329764,"ANDREW D CONCANNON","DAVE CAMP","Republican",0.619409638408074,-86594,321924,-0.268988953914589
2008,"MICHIGAN",5,221841,85017,315295,"DALE E KILDEE","MATT SAWICKI","Democrat",0.703598217542302,136824,306858,0.445887022661948
2008,"MICHIGAN",6,123257,188157,319646,"DON COONEY","FRED UPTON","Republican",0.588641810002315,-64900,311414,-0.208404246437219
2008,"MICHIGAN",7,157213,149781,322286,"MARK SCHAUER","TIM WALBERG","Democrat",0.487805861874236,7432,306994,0.02420894219431
2008,"MICHIGAN",8,145491,204408,361607,"ROBERT D ALEXANDER","MIKE ROGERS","Republican",0.565276667763622,-58917,349899,-0.168382876201418
2008,"MICHIGAN",9,183311,150035,351963,"GARY PETERS","JOE KNOLLENBERG","Democrat",0.520824632134628,33276,333346,0.0998242066801462
2008,"MICHIGAN",10,108354,230471,347603,"ROBERT DENISON","CANDICE S MILLER","Republican",0.663029375465689,-122117,338825,-0.360413192651074
2008,"MICHIGAN",11,156625,177461,345182,"JOSEPH W LARKIN","THADDEUS G MCCOTTER","Republican",0.514108499284435,-20836,334086,-0.0623671749190328
2008,"MICHIGAN",12,225094,74565,312344,"SANDER M LEVIN","BERT COPPLE","Democrat",0.720660553748431,150529,299659,0.502334320010412
2008,"MICHIGAN",13,167481,43098,225922,"CAROLYN C KILPATRICK","EDWARD J GUBICS","Democrat",0.741322226255079,124383,210579,0.590671434473523
2008,"MICHIGAN",15,231784,81802,327827,"JOHN D DINGELL","JOHN J LYNCH","Democrat",0.70703145256492,149982,313586,0.478280280369659
2008,"MISSISSIPPI",1,185959,149818,341389,"TRAVIS CHILDERS","GREG DAVIS","Democrat",0.544712922794818,36141,335777,0.107633935617985
2008,"MISSISSIPPI",2,201606,90364,291970,"BENNIE G THOMPSON","RICHARD COOK","Democrat",0.690502448881734,111242,291970,0.381004897763469
2008,"MISSISSIPPI",3,127698,213171,340869,"JOEL GILL","GREGG HARPER","Republican",0.625375144116948,-85473,340869,-0.250750288233896
2008,"MISSISSIPPI",4,216542,73977,290519,"GENE TAYLOR","JOHN MCCAY III","Democrat",0.74536260967441,142565,290519,0.490725219348821
2008,"MISSOURI",2,132068,232276,372972,"WILLIAM C ""BILL"" HAAS","W TODD AKIN","Republican",0.622770610126229,-100208,364344,-0.275036778429177
2008,"MISSOURI",3,202470,92759,305071,"RUSS CARNAHAN","CHRIS SANDER","Democrat",0.663681569208479,109711,295229,0.371613222278299
2008,"MISSOURI",4,200009,103446,303455,"IKE SKELTON","JEFF PARNELL","Democrat",0.659105962992866,96563,303455,0.318211925985731
2008,"MISSOURI",5,197249,109166,306415,"EMANUEL CLEAVER","JACOB TURK","Democrat",0.64373154055774,88083,306415,0.287463081115481
2008,"MISSOURI",6,121894,196526,330699,"KAY BARNES","SAM GRAVES","Republican",0.594274551782739,-74632,318420,-0.234382262420702
2008,"MISSOURI",7,91010,219016,323212,"RICHARD MONROE","ROY BLUNT","Republican",0.677623355568481,-128006,310026,-0.412887951333114
2008,"MISSOURI",8,72790,198798,278288,"JOE ALLEN","JO ANN EMERSON","Republican",0.714360662335422,-126008,271588,-0.463967480153762
2008,"MISSOURI",9,152956,161031,322095,"JUDY BAKER","BLAINE LUETKEMEYER","Republican",0.499948772877567,-8075,313987,-0.0257176252520009
2008,"MONTANA",0,155930,308470,480900,"JOHN DRISCOLL","DENNIS R REHBERG","Republican",0.641443127469328,-152540,464400,-0.328466838931955
2008,"NEBRASKA",1,77897,184923,262820,"MAX YASHIRIN","JEFF FORTENBERRY","Republican",0.703610836313827,-107026,262820,-0.407221672627654
2008,"NEBRASKA",2,131901,142473,274374,"JIM ESCH","LEE TERRY","Republican",0.519265673861226,-10572,274374,-0.0385313477224518
2008,"NEBRASKA",3,55087,183117,238204,"JAY C STODDARD","ADRIAN SMITH","Republican",0.768740239458615,-128030,238204,-0.537480478917231
2008,"NEVADA",1,154860,64837,228922,"SHELLEY BERKLEY","KENNETH WEGNER","Democrat",0.676474956535414,90023,219697,0.409759805550372
2008,"NEVADA",2,136548,170771,329520,"JILL DERBY","DEAN HELLER","Republican",0.51824168487497,-34223,307319,-0.111359857346926
2008,"NEVADA",3,165912,147940,349812,"DINA TITUS","JON C PORTER","Democrat",0.474289046687935,17972,313852,0.0572626588328257
2008,"NEW HAMPSHIRE",1,176435,156338,340873,"CAROL SHEA-PORTER","JEB BRADLEY","Democrat",0.517597462984748,20097,332773,0.0603925198258272
2008,"NEW HAMPSHIRE",2,188332,138222,333675,"PAUL W HODES","JENNIFER HORN","Democrat",0.564417472091107,50110,326554,0.153450884080428
2008,"NEW JERSEY",1,206453,74001,285157,"ROBERT E ANDREWS","DALE M GLADING","Democrat",0.723997657430819,132452,280454,0.472277093569712
2008,"NEW JERSEY",2,110990,167701,283965,"DAVID KURKOWSKI","FRANK A LOBIONDO","Republican",0.590569260296163,-56711,278691,-0.203490604289338
2008,"NEW JERSEY",3,166390,153122,319512,"JOHN ADLER","CHRIS MEYERS","Democrat",0.520762913443001,13268,319512,0.0415258268860011
2008,"NEW JERSEY",4,100036,202972,306551,"JOSHUA M ZEITZ","CHRISTOPHER H SMITH","Republican",0.662114949877834,-102936,303008,-0.339713802935896
2008,"NEW JERSEY",5,131033,172653,309007,"DENNIS SHULMAN","SCOTT GARRETT","Republican",0.558734915390266,-41620,303686,-0.137049452394908
2008,"NEW JERSEY",6,164077,77469,245077,"FRANK PALLONE JR","ROBERT E MCLEOD","Democrat",0.669491629161447,86608,241546,0.358556962234937
2008,"NEW JERSEY",7,124818,148461,295628,"LINDA STENDER","LEONARD LANCE","Republican",0.502188561300012,-23643,273279,-0.0865159781761496
2008,"NEW JERSEY",8,159279,63107,223986,"BILL PASCRELL JR","ROLAND STRATEN","Democrat",0.711111408748761,96172,222386,0.432455280458302
2008,"NEW JERSEY",9,151182,69503,223885,"STEVEN R ROTHMAN","VINCENT MICCO","Democrat",0.675266319762378,81679,220685,0.370115775879647
2008,"NEW JERSEY",11,113510,189696,306732,"TOM WYKA","RODNEY P FRELINGHUYSEN","Republican",0.61844215797504,-76186,303206,-0.25126811474707
2008,"NEW JERSEY",12,193732,108400,306934,"RUSH D HOLT","ALAN R BATEMAN","Democrat",0.631184554334157,85332,302132,0.282432843922524
2008,"NEW JERSEY",13,120382,34735,159753,"ALBIO SIRES","JOSEPH TURULA","Democrat",0.753550794038297,85647,155117,0.552144510272891
2008,"NEW MEXICO",1,166271,132485,298756,"MARTIN T HEINRICH","DARREN WHITE","Democrat",0.556544471073384,33786,298756,0.113088942146769
2008,"NEW MEXICO",2,129572,101980,231552,"HARRY TEAGUE","EDWARD R TINSLEY","Democrat",0.559580569375346,27592,231552,0.119161138750691
2008,"NEW MEXICO",3,161292,86618,284258,"BEN R LUJAN","DANIEL K EAST","Democrat",0.567414109717229,74674,247910,0.301214150296479
2008,"NEW YORK",1,141727,100036,325670,"TIMOTHY H BISHOP","LEE M ZELDIN","Democrat",0.435185924402002,41691,241763,0.17244574231789
2008,"NEW YORK",2,143759,70145,295105,"STEVE ISRAEL","FRANK J STALZER","Democrat",0.487145253384389,73614,213904,0.344145037025956
2008,"NEW YORK",3,93481,149344,320337,"GRAHAM E LONG","PETER T KING","Republican",0.466209023621998,-55863,242825,-0.230054566045506
2008,"NEW YORK",4,151792,84444,298708,"CAROLYN MCCARTHY","JACK M MARTINS","Democrat",0.508161816891412,67348,236236,0.28508779356237
2008,"NEW YORK",5,105836,43039,205768,"GARY L ACKERMAN","ELIZABETH BERNEY","Democrat",0.514346254033669,62797,148875,0.421810243492863
2008,"NEW YORK",7,113988,19373,189071,"JOSEPH CROWLEY","WILLIAM E BRITT JR","Democrat",0.602884630641399,94615,133361,0.709465285953165
2008,"NEW YORK",8,152153,36897,253235,"JERROLD NADLER","GRACE LIN","Democrat",0.600837167058266,115256,189050,0.609658820417879
2008,"NEW YORK",10,155090,8204,228761,"EDOLPHUS TOWNS","SALVATORE GRUPICO","Democrat",0.677956469852816,146886,163294,0.899518659595576
2008,"NEW YORK",11,158235,11644,230988,"YVETTE D CLARKE","HUGH C CARR","Democrat",0.685035586264222,146591,169879,0.862914191865975
2008,"NEW YORK",12,115633,12486,181916,"NYDIA M VELAZQUEZ","ALLAN E ROMAGUERA","Democrat",0.635639525935047,103147,128119,0.805087457754119
2008,"NEW YORK",13,107640,62441,224764,"MICHAEL E MCMAHON","ROBERT A STRANIERE","Democrat",0.4789023153174,45199,170081,0.265749848601549
2008,"NEW YORK",14,176426,43385,274592,"CAROLYN B MALONEY","ROBERT G HEIM","Democrat",0.642502330730684,133041,219811,0.605251784487583
2008,"NEW YORK",15,170372,15676,245159,"CHARLES B RANGEL","EDWARD DANIELS","Democrat",0.694944913301164,154696,186048,0.831484348125215
2008,"NEW YORK",16,123312,3941,169499,"JOSE E SERRANO","ALI MOHAMED","Democrat",0.727508716865586,119371,127253,0.938060399361901
2008,"NEW YORK",17,149676,35994,243765,"ELIOT L ENGEL","ROBERT GOODMAN","Democrat",0.61401759891699,113682,185670,0.612279851349168
2008,"NEW YORK",18,167365,73237,302028,"NITA M LOWEY","JIM RUSSELL","Democrat",0.554137364747639,94128,240602,0.391218693111445
2008,"NEW YORK",19,141173,103813,320510,"JOHN J HALL","KIERAN MICHAEL LALOR","Democrat",0.440463636079998,37360,244986,0.152498510118946
2008,"NEW YORK",20,178996,99930,334716,"KIRSTEN E GILLIBRAND","SANDY TREADWELL","Democrat",0.53476977497341,79066,278926,0.283465865498376
2008,"NEW YORK",21,159849,85267,311931,"PAUL D TONKO","JAMES BUHRMASTER","Democrat",0.512449868720967,74582,245116,0.304272262928573
2008,"NEW YORK",22,147238,76569,290102,"MAURICE D HINCHEY","GEORGE K PHILLIPS","Democrat",0.507538727757823,70669,223807,0.31575866706582
2008,"NEW YORK",23,70037,120778,261238,"MICHAEL P OOT","JOHN M MCHUGH","Republican",0.462329370152887,-50741,190815,-0.26591724969211
2008,"NEW YORK",24,121345,103379,282114,"MICHAEL A ARCURI","RICHARD L HANNA","Democrat",0.430127537094933,17966,224724,0.079946957156334
2008,"NEW YORK",25,148290,106653,322180,"DANIEL B MAFFEI","DALE A SWEETLAND","Democrat",0.460270656154944,41637,254943,0.163318859509773
2008,"NEW YORK",26,109615,124845,323251,"ALICE KRYZAN","CHRISTOPHER J LEE","Republican",0.386216902654593,-15230,234460,-0.0649577753134863
2008,"NEW YORK",27,169196,50420,293504,"BRIAN HIGGINS","DANIEL J HUMISTON","Democrat",0.576469145224597,118776,219616,0.540834911846131
2008,"NEW YORK",28,155409,42016,271887,"LOUISE MCINTOSH SLAUGHTER","DAVID W CRIMMEN","Democrat",0.571594081364685,113393,197425,0.574359883500063
2008,"NEW YORK",29,131526,116137,307298,"ERIC J J MASSA","JOHN R ""RANDY"" KUHL JR","Democrat",0.428007992242058,15389,247663,0.0621368553235647
2008,"NORTH CAROLINA",1,192765,81506,274271,"G K BUTTERFIELD","DEAN STEPHENS","Democrat",0.702826766227563,111259,274271,0.405653532455126
2008,"NORTH CAROLINA",2,199730,93323,298430,"BOB ETHERIDGE","DAN MANSELL","Democrat",0.669269175351004,106407,293053,0.363098142656789
2008,"NORTH CAROLINA",3,104364,201686,306050,"CRAIG WEBER","WALTER B JONES","Republican",0.658996895932037,-97322,306050,-0.317993791864075
2008,"NORTH CAROLINA",4,265751,153947,419698,"DAVID E PRICE","WILLIAM ""B J"" LAWSON","Democrat",0.633195774104237,111804,419698,0.266391548208474
2008,"NORTH CAROLINA",5,136103,190820,326923,"ROY CARTER","VIRGINIA FOXX","Republican",0.583684843219963,-54717,326923,-0.167369686439926
2008,"NORTH CAROLINA",6,108873,221018,329891,"TERESA SUE BRATTON","HOWARD COBLE","Republican",0.669972809200615,-112145,329891,-0.339945618401229
2008,"NORTH CAROLINA",7,215383,97472,312855,"MIKE MCINTYRE","WILL BREAZEALE","Democrat",0.688443528152019,117911,312855,0.376887056304039
2008,"NORTH CAROLINA",8,157185,126634,283819,"LARRY KISSELL","ROBERT C ""ROBIN"" HAYES","Democrat",0.553821273417213,30551,283819,0.107642546834426
2008,"NORTH CAROLINA",9,138719,241053,386483,"HARRY TAYLOR","SUE WILKINS MYRICK","Republican",0.623709192901111,-102334,379772,-0.269461677006204
2008,"NORTH CAROLINA",10,126699,171774,298473,"DANIEL JOHNSON","PATRICK T MCHENRY","Republican",0.575509342553598,-45075,298473,-0.151018685107196
2008,"NORTH CAROLINA",11,211112,122087,340716,"HEATH SHULER","CARL MUMPOWER","Democrat",0.61961281536529,89025,333199,0.267182674617871
2008,"NORTH CAROLINA",12,215908,85814,301722,"MELVIN L WATT","TY COBB JR","Democrat",0.715585870437025,130094,301722,0.43117174087405
2008,"NORTH CAROLINA",13,221379,114383,335762,"BRAD MILLER","HUGH WEBSTER","Democrat",0.659333099040392,106996,335762,0.318666198080783
2008,"NORTH DAKOTA",0,194577,119388,313965,"EARL POMEROY","DUANE SAND","Democrat",0.619741053939133,75189,313965,0.239482107878267
2008,"OHIO",1,155455,140683,296290,"STEVE DRIEHAUS","STEVE CHABOT","Democrat",0.524671774275203,14772,296138,0.0498821495383909
2008,"OHIO",2,124213,148671,331624,"VICTORIA WULSIN","JEAN SCHMIDT","Republican",0.448311943647022,-24458,272884,-0.0896278272086308
2008,"OHIO",3,115976,200204,316180,"JANE MITAKIDES","MICHAEL R TURNER","Republican",0.633196280599658,-84228,316180,-0.266392561199317
2008,"OHIO",4,99499,186154,285653,"MIKE CARROLL","JIM JORDAN","Republican",0.651678785099404,-86655,285653,-0.303357570198808
2008,"OHIO",5,105840,188905,294745,"GEORGE F MAYS","ROBERT E LATTA","Republican",0.6409099390999,-83065,294745,-0.2818198781998
2008,"OHIO",6,176330,92968,283110,"CHARLES A WILSON","RICHARD D STOBBS","Democrat",0.622832114725725,83362,269298,0.309552985911518
2008,"OHIO",7,125547,174915,300462,"SHAREN SWARTZ NEUHARDT","STEVE AUSTRIA","Republican",0.582153483635202,-49368,300462,-0.164306967270404
2008,"OHIO",8,95510,202063,297573,"NICHOLAS A VON STEIN","JOHN A BOEHNER","Republican",0.6790367405645,-106553,297573,-0.358073481129
2008,"OHIO",9,222054,76512,298566,"MARCY KAPTUR","BRADLEY S LEAVITT","Democrat",0.743735053555998,145542,298566,0.487470107111995
2008,"OHIO",10,157268,107918,275809,"DENNIS J KUCINICH","JIM TRAKAS","Democrat",0.570206193416459,49350,265186,0.186095796912356
2008,"OHIO",11,212667,36708,249542,"MARCIA L FUDGE","THOMAS PEKAREK","Democrat",0.852229284048377,175959,249375,0.7056
2008,"OHIO",12,152234,197447,360388,"DAVID ROBINSON","PATRICK J TIBERI","Republican",0.547873403109981,-45213,349681,-0.129297845750841
2008,"OHIO",13,192593,105050,297680,"BETTY SUTTON","DAVID S POTTER","Democrat",0.646979978500403,87543,297643,0.294120809157279
2008,"OHIO",14,125214,188488,323213,"BILL O'NEILL","STEVEN C LATOURETTE","Republican",0.583169612608404,-63274,313702,-0.20170097736068
2008,"OHIO",15,139584,137272,303838,"MARY JO KILROY","STEVE STIVERS","Democrat",0.459402708022038,2312,276856,0.00835091166527003
2008,"OHIO",16,169044,136293,305337,"JOHN A BOCCIERI","KIRK SCHURING","Democrat",0.553630906179074,32751,305337,0.107261812358149
2008,"OHIO",17,218896,61216,280112,"TIM RYAN","DUANE V GRASSELL","Democrat",0.781458845033415,157680,280112,0.56291769006683
2008,"OHIO",18,164187,110031,274218,"ZACHARY T SPACE","FRED DAILEY","Democrat",0.598746252981205,54156,274218,0.197492505962409
2008,"OKLAHOMA",1,98890,193404,292294,"GEORGIANNA W OLIVER","JOHN SULLIVAN","Republican",0.661676257466797,-94514,292294,-0.323352514933594
2008,"OKLAHOMA",2,173757,72815,246572,"DAN BOREN","RAYMOND J WICKSON","Democrat",0.704690719140859,100942,246572,0.409381438281719
2008,"OKLAHOMA",3,62297,184306,264359,"FRANKIE ROBBINS","FRANK D LUCAS","Republican",0.697180727722529,-122009,246603,-0.494758782334359
2008,"OKLAHOMA",4,79674,180080,272781,"BLAKE CUMMINGS","TOM COLE","Republican",0.660163281166943,-100406,259754,-0.386542651893715
2008,"OKLAHOMA",5,88996,171925,260921,"STEVEN L PERRY","MARY FALLIN","Republican",0.658915917078349,-82929,260921,-0.317831834156699
2008,"OREGON",2,87649,236560,340379,"NOAH LEMAS","GREG WALDEN","Republican",0.694989996445139,-148911,324209,-0.459305571406099
2008,"OREGON",3,254235,71063,341062,"EARL BLUMENAUER","DELIA LOPEZ","Democrat",0.745421653540998,183172,325298,0.563089843774016
2008,"OREGON",5,181577,128297,334674,"KURT SCHRADER","MIKE ERICKSON","Democrat",0.54254886845109,53280,309874,0.171940853379115
2008,"PENNSYLVANIA",1,242799,24714,267513,"ROBERT A BRADY","MIKE MUHAMMAD","Democrat",0.907615704657344,218085,267513,0.815231409314688
2008,"PENNSYLVANIA",2,276870,34466,311336,"CHAKA FATTAH","ADAM A LANG","Democrat",0.889296451422258,242404,311336,0.778592902844515
2008,"PENNSYLVANIA",3,146846,139707,286553,"KATHY DAHLKEMPER","PHIL ENGLISH","Democrat",0.512456683405862,7139,286553,0.0249133668117242
2008,"PENNSYLVANIA",4,186536,147411,333947,"JASON ALTMIRE","MELISSA HART","Democrat",0.558579654855411,39125,333947,0.117159309710822
2008,"PENNSYLVANIA",5,112509,155513,274177,"MARK B MCCRACKEN","GLENN W THOMPSON","Republican",0.567199290968973,-43004,268022,-0.160449515338293
2008,"PENNSYLVANIA",6,164952,179423,344375,"BOB ROGGIO","JIM GERLACH","Republican",0.521010526315789,-14471,344375,-0.0420210526315789
2008,"PENNSYLVANIA",7,209955,142362,352317,"JOE SESTAK","W CRAIG WILLIAMS","Democrat",0.595926395831027,67593,352317,0.191852791662054
2008,"PENNSYLVANIA",8,197869,145103,348515,"PATRICK J MURPHY","TOM MANION","Democrat",0.56774887737974,52766,342972,0.153849293819904
2008,"PENNSYLVANIA",9,98735,174951,273686,"TONY BARR","BILL SHUSTER","Republican",0.639239858816308,-76216,273686,-0.278479717632615
2008,"PENNSYLVANIA",10,160837,124681,285518,"CHRISTOPHER P CARNEY","CHRIS HACKETT","Democrat",0.563316498434424,36156,285518,0.126632996868849
2008,"PENNSYLVANIA",11,146379,137151,283530,"PAUL E KANJORSKI","LOU BARLETTA","Democrat",0.516273410221141,9228,283530,0.0325468204422812
2008,"PENNSYLVANIA",12,155268,113120,268388,"JOHN P MURTHA","WILLIAM RUSSELL","Democrat",0.578520649209354,42148,268388,0.157041298418707
2008,"PENNSYLVANIA",13,196868,108271,313513,"ALLYSON Y SCHWARTZ","MARINA KATS","Democrat",0.627942063008551,88597,305139,0.290349643932765
2008,"PENNSYLVANIA",15,128333,181433,309766,"SAM BENNETT","CHARLES W DENT","Republican",0.585709858409251,-53100,309766,-0.171419716818502
2008,"PENNSYLVANIA",16,120193,170329,305167,"BRUCE A SLATER","JOSEPH R PITTS","Republican",0.558150127635033,-50136,290522,-0.17257212878887
2008,"PENNSYLVANIA",17,192699,109909,302608,"TIM HOLDEN","TONI GILHOOLEY","Democrat",0.636794136308359,82790,302608,0.273588272616719
2008,"PENNSYLVANIA",18,119661,213349,333010,"STEVE O'DONNELL","TIM MURPHY","Republican",0.640668448394943,-93688,333010,-0.281336896789886
2008,"PENNSYLVANIA",19,109533,218862,328395,"PHILIP J AVILLO JR","TODD RUSSELL PLATTS","Republican",0.666459598958571,-109329,328395,-0.332919197917142
2008,"RHODE ISLAND",1,145254,51340,211998,"PATRICK J KENNEDY","JONATHAN P SCOTT","Democrat",0.685166841196615,93914,196594,0.477705321627313
2008,"RHODE ISLAND",2,158416,67433,226234,"JAMES R LANGEVIN","MARK S ZACCARIA","Democrat",0.700230734549184,90983,225849,0.402848806060687
2008,"SOUTH CAROLINA",1,163724,177540,341879,"LINDA KETNER","HENRY E BROWN JR","Republican",0.519306538278163,-13816,341264,-0.0404847859721506
2008,"SOUTH CAROLINA",2,158627,184583,343486,"ROB MILLER","JOE WILSON","Republican",0.537381436215741,-25956,343210,-0.0756271670405874
2008,"SOUTH CAROLINA",3,101724,186799,288741,"JANE BALLARD DYER","J GRESHAM BARRETT","Republican",0.646943108183459,-85075,288523,-0.294863841010942
2008,"SOUTH CAROLINA",4,113291,184440,306928,"PAUL CORDEN","BOB INGLIS","Republican",0.600922691966846,-71149,297731,-0.238970748763145
2008,"SOUTH CAROLINA",5,188785,113282,306285,"JOHN M SPRATT JR","ALBERT F SPENCER","Democrat",0.616370373998074,75503,302067,0.249954480297417
2008,"SOUTH CAROLINA",6,193378,93059,286571,"JAMES E CLYBURN","NANCY HARRELSON","Democrat",0.674799613359342,100319,286437,0.350230591718249
2008,"SOUTH DAKOTA",0,256041,122966,379007,"STEPHANIE HERSETH SANDLIN","CHRIS LIEN","Democrat",0.675557443530067,133075,379007,0.351114887060133
2008,"TENNESSEE",1,57525,168343,234381,"ROB RUSSELL","PHIL ROE","Republican",0.718245079592629,-110818,225868,-0.490631696389041
2008,"TENNESSEE",2,63639,227120,290759,"BOB SCOTT","JOHN J DUNCAN JR","Republican",0.781128013234328,-163481,290759,-0.562256026468656
2008,"TENNESSEE",3,73059,184964,266628,"DOUG VANDAGRIFF","ZACH WAMP","Republican",0.69371558876037,-111905,258023,-0.433701646752421
2008,"TENNESSEE",4,146776,94447,249805,"LINCOLN DAVIS","MONTY J LANKFORD","Democrat",0.587562298592902,52329,241223,0.216932050426369
2008,"TENNESSEE",5,181467,85471,275602,"JIM COOPER","GERARD DONOVAN","Democrat",0.658438618007126,95996,266938,0.359619087578389
2008,"TENNESSEE",7,99549,217332,316881,"RANDY G MORRIS","MARSHA BLACKBURN","Republican",0.685847368570536,-117783,316881,-0.371694737141072
2008,"TEXAS",3,108693,170742,285783,"TOM DALEY","SAM JOHNSON","Republican",0.597453312478349,-62049,279435,-0.22205163991626
2008,"TEXAS",4,88067,206906,300744,"GLENN MELANCON","RALPH M HALL","Republican",0.687980475088447,-118839,294973,-0.402880941645507
2008,"TEXAS",6,99919,174008,280582,"LUDWIG OTTO","JOE BARTON","Republican",0.620168079206792,-74089,273927,-0.270469869709813
2008,"TEXAS",7,123242,162635,290934,"MICHAEL SKELLY","JOHN ABNEY","Republican",0.559009947273265,-39393,285877,-0.137797024594493
2008,"TEXAS",8,70758,207128,285451,"KENT HARGETT","KEVIN BRADY","Republican",0.725616655748272,-136370,277886,-0.490740807381444
2008,"TEXAS",10,143719,179493,333083,"LARRY JOE DOHERTY","MICHAEL T MCCAUL","Republican",0.538883701659947,-35774,323212,-0.110682771679269
2008,"TEXAS",12,82250,181662,268754,"TRACEY SMITH","KAY GRANGER","Republican",0.675941567381323,-99412,263912,-0.376686168116645
2008,"TEXAS",13,51841,180078,231919,"ROGER JAMES WAUN","MAC THORNBERRY","Republican",0.776469370771692,-128237,231919,-0.552938741543384
2008,"TEXAS",15,107578,52303,163708,"RUBEN HINOJOSA","EDDIE ZAMORA","Democrat",0.657133432697241,55275,159881,0.345725883625947
2008,"TEXAS",17,134592,115581,254022,"CHET EDWARDS","ROB CURNOCK","Democrat",0.529843871790632,19011,250173,0.0759914139415524
2008,"TEXAS",18,148617,39095,192198,"SHEILA JACKSON-LEE","JOHN FAULK","Democrat",0.773249461492835,109522,187712,0.583457637231504
2008,"TEXAS",19,58030,168501,232611,"DWIGHT FULLINGIM","RANDY NEUGEBAUER","Republican",0.724389646233411,-110471,226531,-0.487663940034697
2008,"TEXAS",20,127298,44585,177055,"CHARLES A GONZALEZ","ROBERT LITOFF","Democrat",0.718974330010449,82713,171883,0.481216874269125
2008,"TEXAS",22,140160,161996,308995,"NICK LAMPSON","PETE OLSON","Republican",0.524267382967362,-21836,302156,-0.0722673056302043
2008,"TEXAS",23,134090,100799,240470,"CIRO D RODRIGUEZ","LYLE LARSON","Democrat",0.557616334677922,33291,234889,0.14173077496179
2008,"TEXAS",24,111089,151434,270495,"TOM LOVE","KENNY MARCHANT","Republican",0.55984029279654,-40345,262523,-0.153681772644683
2008,"TEXAS",25,191755,88693,291296,"LLOYD DOGGETT","GEORGE L MOROVICH","Democrat",0.65828229704493,103062,280448,0.367490586490187
2008,"TEXAS",26,118167,195181,324376,"KEN LEACH","MICHAEL C BURGESS","Republican",0.601712210521124,-77014,313348,-0.245777857206684
2008,"TEXAS",27,104864,69458,180951,"SOLOMON P ORTIZ","WILLIAM WILLIE VADEN","Democrat",0.579516001569486,35406,174322,0.203106894138433
2008,"TEXAS",28,123494,52524,179740,"HENRY CUELLAR","JIM FISH","Democrat",0.687070212529209,70970,176018,0.403197400265882
2008,"TEXAS",29,79718,25512,106794,"GENE GREEN","ERIC STORY","Democrat",0.74646515721857,54206,105230,0.515119262567709
2008,"TEXAS",30,168249,32361,203976,"EDDIE BERNICE JOHNSON","FRED WOOD","Democrat",0.824847040828333,135888,200610,0.677374009271721
2008,"TEXAS",31,106559,175563,291304,"BRIAN P RUIZ","JOHN R CARTER","Republican",0.602679674841403,-69004,282122,-0.24458922026641
2008,"TEXAS",32,82406,116283,203110,"ERIC ROBERSON","PETE SESSIONS","Republican",0.572512431687263,-33877,198689,-0.170502644836906
2008,"UTAH",1,92469,196799,303445,"MORGAN BOWEN","ROB BISHOP","Republican",0.648549160473891,-104330,289268,-0.360668998990555
2008,"UTAH",2,220666,120083,348325,"JIM MATHESON","BILL DEW","Democrat",0.633506064738391,100583,340749,0.295182084173394
2008,"UTAH",3,80626,187035,285069,"BENNION L SPENCER","JASON CHAFFETZ","Republican",0.656104311587721,-106409,267661,-0.397551380290741
2008,"VIRGINIA",1,150432,203839,360292,"BILL S DAY JR","ROBERT J WITTMAN","Republican",0.565760549776293,-53407,354271,-0.150751825579853
2008,"VIRGINIA",2,141857,128486,270711,"GLENN C NYE III","THELMA DRAKE","Democrat",0.524016386478569,13371,270343,0.0494593904780224
2008,"VIRGINIA",4,135041,199075,334521,"ANDREA R MILLER","J RANDY FORBES","Republican",0.595104642159984,-64034,334116,-0.191652001101414
2008,"VIRGINIA",5,158810,158083,317076,"TOM S P PERRIELLO","VIRGIL H GOODE JR","Democrat",0.500857838499287,727,316893,0.0022941497603292
2008,"VIRGINIA",6,114367,192350,312392,"S ""SAM"" RASOUL","BOB GOODLATTE","Republican",0.615732797254731,-77983,306717,-0.254250661032809
2008,"VIRGINIA",7,138123,233531,372337,"ANITA HARTKE","ERIC CANTOR","Republican",0.627203313127624,-95408,371654,-0.256711887938782
2008,"VIRGINIA",8,222986,97425,328197,"JAMES P MORAN","MARK W ELLMORE","Democrat",0.679427295191607,125561,320411,0.391874810789892
2008,"VIRGINIA",10,147357,223140,379480,"JUDY M FEDER","FRANK R WOLF","Republican",0.588015178665542,-75783,370497,-0.204544166349525
2008,"VIRGINIA",11,196598,154758,359491,"GERALD E ""GERRY"" CONNOLLY","KEITH S FIMIAN","Democrat",0.546878781388129,41840,351356,0.119081501383212
2008,"WASHINGTON",1,233780,111240,345020,"JAY INSLEE","LARRY ISHMAEL","Democrat",0.677583908179236,122540,345020,0.355167816358472
2008,"WASHINGTON",2,217416,131051,348467,"RICK LARSEN","RICK BART","Democrat",0.623921346928117,86365,348467,0.247842693856233
2008,"WASHINGTON",3,216701,121828,338529,"BRIAN BAIRD","MICHAEL DELAVAR","Democrat",0.640125365921383,94873,338529,0.280250731842767
2008,"WASHINGTON",4,99430,169940,269370,"GEORGE FEARING","DOC HASTINGS","Republican",0.630879459479526,-70510,269370,-0.261758918959053
2008,"WASHINGTON",5,112382,211305,323687,"MARK MAYS","CATHY MCMORRIS","Republican",0.65280656930924,-98923,323687,-0.30561313861848
2008,"WASHINGTON",6,205991,102081,308072,"NORMAN D DICKS","DOUG CLOUD","Democrat",0.668645641278662,103910,308072,0.337291282557324
2008,"WASHINGTON",7,291963,57054,349017,"JIM MCDERMOTT","STEVE BEREN","Democrat",0.836529452720068,234909,349017,0.673058905440136
2008,"WASHINGTON",8,171358,191568,362926,"DARCY BURNER","DAVID G REICHERT","Republican",0.527843141577071,-20210,362926,-0.0556862831541416
2008,"WASHINGTON",9,176295,93080,269375,"ADAM SMITH","JAMES POSTMA","Democrat",0.65445939675174,83215,269375,0.30891879350348
2008,"WEST VIRGINIA",2,110819,147334,258169,"ANNE BARTH","SHELLEY MOORE CAPITO","Republican",0.570688192618014,-36515,258153,-0.141447126316564
2008,"WEST VIRGINIA",3,133522,66005,199527,"NICK J RAHALL II","MARTY GEARHEART","Democrat",0.669192640595007,67517,199527,0.338385281190014
2008,"WISCONSIN",1,125268,231009,361107,"MARGE KRUPP","PAUL RYAN","Republican",0.639724513786772,-105741,356277,-0.296794348217819
2008,"WISCONSIN",2,277914,122513,400841,"TAMMY BALDWIN","PETER THERON","Democrat",0.693327279395072,155401,400427,0.388088215829602
2008,"WISCONSIN",3,225208,122760,356400,"RON KIND","PAUL STARK","Democrat",0.631896745230079,102448,347968,0.294417877505978
2008,"WISCONSIN",6,126090,221875,348264,"ROGER A KITTELSON","THOMAS E PETRI","Republican",0.63708853054005,-95785,347965,-0.275271938269654
2008,"WISCONSIN",7,212666,136938,349837,"DAVID R OBEY","DAN MIELKE","Democrat",0.607900250688178,75728,349604,0.216610793926843
2008,"WISCONSIN",8,193662,164621,358647,"STEVE KAGEN","JOHN GARD","Democrat",0.53997942266351,29041,358283,0.0810560367084121
2008,"WYOMING",0,106758,131244,249575,"GARY TRAUNER","CYNTHIA M LUMMIS","Republican",0.525869978964239,-24486,238002,-0.102881488390854
2010,"ALABAMA",2,106865,111645,219028,"BOBBY BRIGHT","MARTHA ROBY","Republican",0.509729349672188,-4780,218510,-0.0218754290421491
2010,"ALABAMA",3,80204,117736,198139,"STEVE SEGREST","MIKE ROGERS","Republican",0.594209115822731,-37532,197940,-0.18961301404466
2010,"ALABAMA",5,95192,131109,226490,"STEVE RABY","MO BROOKS","Republican",0.57887323943662,-35917,226301,-0.158713394991626
2010,"ALABAMA",7,136696,51890,188724,"TERRI A SEWELL","DON CHAMBERLAIN","Democrat",0.724316992009495,84806,188586,0.449694038793972
2010,"ALASKA",0,77606,175384,254335,"HARRY T CRAWFORD JR","DON YOUNG","Republican",0.689578705250949,-97778,252990,-0.38648958456856
2010,"ARIZONA",1,99233,112816,226918,"ANN KIRKPATRICK","PAUL GOSAR","Republican",0.497166377281661,-13583,212049,-0.0640559493324656
2010,"ARIZONA",2,82891,173173,266894,"JOHN THRASHER","TRENT FRANKS","Republican",0.648845609118227,-90282,256064,-0.35257591852037
2010,"ARIZONA",3,85610,108689,208071,"JON HULBURD","BEN QUAYLE","Republican",0.5223649619601,-23079,194299,-0.11878084807436
2010,"ARIZONA",4,61524,25300,91907,"ED PASTOR","JANET CONTRERAS","Democrat",0.669415822516239,36224,86824,0.417211830830185
2010,"ARIZONA",5,91749,110374,212250,"HARRY E MITCHELL","DAVID SCHWEIKERT","Republican",0.520018845700824,-18625,202123,-0.0921468610697447
2010,"ARIZONA",6,72615,165649,249383,"REBECCA SCHNEIDER","JEFF FLAKE","Republican",0.664235332801354,-93034,238264,-0.390466037672498
2010,"ARIZONA",7,79935,70385,159144,"RAUL M GRIJALVA","RUTH MCCLUNG","Democrat",0.50228095309908,9550,150320,0.0635311335816924
2010,"ARIZONA",8,138280,134124,283578,"GABRIELLE GIFFORDS","JESSE KELLY","Democrat",0.487625979448335,4156,272404,0.0152567510021879
2010,"ARKANSAS",1,78267,93224,180016,"CHAD CAUSEY","RICK CRAWFORD","Republican",0.517865078659675,-14957,171491,-0.0872174049950143
2010,"ARKANSAS",2,80687,122091,210852,"JOYCE ELLIOTT","TIM GRIFFIN","Republican",0.579036480564567,-41404,202778,-0.204183885825879
2010,"ARKANSAS",3,56542,148581,205123,"DAVID WHITAKER","STEVE WOMACK","Republican",0.724350755400418,-92039,205123,-0.448701510800837
2010,"ARKANSAS",4,102479,71526,178134,"MIKE ROSS","BETH ANNE RANKIN","Democrat",0.575291634387596,30953,174005,0.177885692939858
2010,"CALIFORNIA",1,147307,72803,234592,"MIKE THOMPSON","LOREN HANKS","Democrat",0.627928488610012,74504,220110,0.338485302803144
2010,"CALIFORNIA",2,98092,130837,228940,"JIM REED","WALLY HERGER","Republican",0.57149034681576,-32745,228929,-0.143035613661878
2010,"CALIFORNIA",3,113128,131169,261938,"AMI BERA","DANIEL E LUNGREN","Republican",0.500763539463537,-18041,244297,-0.0738486350630585
2010,"CALIFORNIA",4,95653,186397,304229,"CLINT CURTIS","TOM MCCLINTOCK","Republican",0.612686496027663,-90744,282050,-0.32173018968268
2010,"CALIFORNIA",5,124220,43577,172410,"DORIS O MATSUI","PAUL A SMITH","Democrat",0.720491850820718,80643,167797,0.48059858042754
2010,"CALIFORNIA",6,172216,77361,261152,"LYNN C WOOLSEY","JIM JUDD","Democrat",0.659447371645632,94855,249577,0.380063066708871
2010,"CALIFORNIA",7,122435,56764,179199,"GEORGE MILLER","RICK TUBBS","Democrat",0.683234839480131,65671,179199,0.366469678960262
2010,"CALIFORNIA",8,167957,31711,209696,"NANCY PELOSI","JOHN DENNIS","Democrat",0.800954715397528,136246,199668,0.682362722118717
2010,"CALIFORNIA",9,180400,23054,214085,"BARBARA LEE","GERALD HASHIMOTO","Democrat",0.842655954410631,157346,203454,0.773373833888741
2010,"CALIFORNIA",10,137578,88512,233806,"JOHN GARAMENDI","GARY CLIFT","Democrat",0.588428012968016,49066,226090,0.2170197708877
2010,"CALIFORNIA",11,115361,112703,240503,"JERRY MCNERNEY","DAVID HARMER","Democrat",0.479665534317659,2658,228064,0.0116546232636453
2010,"CALIFORNIA",12,152044,44475,201162,"JACKIE SPEIER","MIKE MOLONEY","Democrat",0.755828635627007,107569,196519,0.54737200983111
2010,"CALIFORNIA",13,118278,45575,164378,"FORTNEY PETE STARK","FOREST BAKER","Democrat",0.719548844735914,72703,163853,0.443708690106376
2010,"CALIFORNIA",14,151217,60917,218869,"ANNA G ESHOO","DAVE CHAPMAN","Democrat",0.690901863671877,90300,212134,0.425674337918485
2010,"CALIFORNIA",15,126147,60468,186615,"MICHAEL M HONDA","SCOTT KIRKLAND","Democrat",0.675974600112531,65679,186615,0.351949200225062
2010,"CALIFORNIA",16,105841,37913,156058,"ZOE LOFGREN","DANIEL SAHAGUN","Democrat",0.678215791564675,67928,143754,0.472529460049807
2010,"CALIFORNIA",17,118734,53176,178139,"SAM FARR","JEFF TAYLOR","Democrat",0.666524455621734,65558,171910,0.381350706765168
2010,"CALIFORNIA",18,72853,51716,124569,"DENNIS A CARDOZA","MICHAEL CLARE BERRYHILL SR","Democrat",0.58484053014795,21137,124569,0.1696810602959
2010,"CALIFORNIA",19,69912,128394,198902,"LORAINE GOODWIN","JEFF DENHAM","Republican",0.645513871152628,-58482,198306,-0.294907869655986
2010,"CALIFORNIA",20,46247,43197,89444,"JIM COSTA","ANDY VIDAK","Democrat",0.517049774160368,3050,89444,0.034099548320737
2010,"CALIFORNIA",23,111768,72744,193463,"LOIS CAPPS","TOM WATSON","Democrat",0.57772287207373,39024,184512,0.211498439125911
2010,"CALIFORNIA",24,96279,144055,240334,"TIMOTHY J ALLISON","ELTON GALLEGLY","Republican",0.599395008613014,-47776,240334,-0.198790017226027
2010,"CALIFORNIA",25,73028,118308,191336,"JACKIE CONAWAY","HOWARD P ""BUCK"" MCKEON","Republican",0.618325876991261,-45280,191336,-0.236651753982523
2010,"CALIFORNIA",26,76093,112774,208347,"RUSS WARNER","DAVID DREIER","Republican",0.541279692052201,-36681,188867,-0.194216035622952
2010,"CALIFORNIA",27,102927,55056,157983,"BRAD SHERMAN","MARK REED","Democrat",0.651506807694499,47871,157983,0.303013615388998
2010,"CALIFORNIA",28,88385,28493,127107,"HOWARD L BERMAN","MERLIN FLOYD","Democrat",0.695359028220318,59892,116878,0.512431766457332
2010,"CALIFORNIA",29,104374,51534,161126,"ADAM B SCHIFF","JOHN P COLBERT","Democrat",0.647778756997629,52840,155908,0.338917823331708
2010,"CALIFORNIA",30,153663,75948,237747,"HENRY A WAXMAN","CHARLES E WILKERSON","Democrat",0.646329922144128,77715,229611,0.338463749559037
2010,"CALIFORNIA",31,76363,14740,91106,"XAVIER BECERRA","STEPHEN C SMITH","Democrat",0.838177507518714,61623,91103,0.676410217007124
2010,"CALIFORNIA",32,77759,31697,109456,"JUDY CHU","EDWARD ""ED"" SCHMERLING","Democrat",0.710413316766555,46062,109456,0.420826633533109
2010,"CALIFORNIA",33,131990,21342,153333,"KAREN BASS","JAMES L ANDION","Democrat",0.860806219143955,110648,153332,0.72162366629275
2010,"CALIFORNIA",34,69382,20457,89839,"LUCILLE ROYBAL-ALLARD","WAYNE MILLER","Democrat",0.772292656863946,48925,89839,0.544585313727891
2010,"CALIFORNIA",35,98131,25561,123694,"MAXINE WATERS","K BRUCE BROWN","Democrat",0.793336782705709,72570,123692,0.586699220644827
2010,"CALIFORNIA",36,114489,66706,192035,"JANE HARMAN","MATTIE FEIN","Democrat",0.596188194860312,47783,181195,0.263710367283865
2010,"CALIFORNIA",37,85799,29159,125518,"LAURA RICHARDSON","STAR PARKER","Democrat",0.683559330135917,56640,114958,0.492701682353555
2010,"CALIFORNIA",38,85459,30883,116342,"GRACE F NAPOLITANO","ROBERT VAUGHN","Democrat",0.734549861614894,54576,116342,0.469099723229788
2010,"CALIFORNIA",39,81590,42037,128961,"LINDA T SANCHEZ","LARRY S ANDRE","Democrat",0.632671893052938,39553,123627,0.319938201202003
2010,"CALIFORNIA",40,59400,119455,178855,"CHRISTINA AVALOS","EDWARD R ROYCE","Republican",0.667887394817031,-60055,178855,-0.335774789634061
2010,"CALIFORNIA",41,74394,127857,202286,"PAT MEAGHER","JERRY LEWIS","Republican",0.632060547937079,-53463,202251,-0.264339854932732
2010,"CALIFORNIA",42,65122,127161,204398,"MICHAEL WILLIAMSON","GARY G MILLER","Republican",0.622124482627032,-62039,192283,-0.322644227518813
2010,"CALIFORNIA",43,70026,36890,106916,"JOE BACA","SCOTT FOLKENS","Democrat",0.654962774514572,33136,106916,0.309925549029144
2010,"CALIFORNIA",44,85784,107482,193266,"BILL HEDRICK","KEN CALVERT","Republican",0.556135067730485,-21698,193266,-0.112270135460971
2010,"CALIFORNIA",45,87141,106472,206801,"STEVE POUGNET","MARY BONO MACK","Republican",0.514852442686447,-19331,193613,-0.0998435022441675
2010,"CALIFORNIA",46,84940,139822,224782,"KEN ARNOLD","DANA ROHRABACHER","Republican",0.622033792741412,-54882,224762,-0.244178286365133
2010,"CALIFORNIA",47,50832,37679,95954,"LORETTA SANCHEZ","VAN TRAN","Democrat",0.52975384038185,13153,88511,0.148602998497362
2010,"CALIFORNIA",48,88465,145481,242719,"BETH KROM","JOHN CAMPBELL","Republican",0.599380353412794,-57016,233946,-0.243714361433835
2010,"CALIFORNIA",49,59714,119088,189677,"HOWARD KATZ","DARRELL E ISSA","Republican",0.627846286054714,-59374,178802,-0.3320656368497
2010,"CALIFORNIA",50,97818,142247,251081,"FRANCINE BUSBY","BRIAN P BILBRAY","Republican",0.566538288440782,-44429,240065,-0.185070710016037
2010,"CALIFORNIA",51,86423,57488,143916,"BOB FILNER","NICK POPADITCH","Democrat",0.600510019733734,28935,143911,0.201061767342316
2010,"CALIFORNIA",52,70870,139460,221062,"RAY LUTZ","DUNCAN HUNTER","Republican",0.63086373958437,-68590,210330,-0.326106594399277
2010,"CALIFORNIA",53,104800,57230,168328,"SUSAN A DAVIS","MICHAEL CRIMMINS","Democrat",0.622593983175705,47570,162030,0.293587607233228
2010,"COLORADO",1,140073,59747,207751,"DIANA DEGETTE","MIKE FALLON","Democrat",0.674235021732747,80326,199820,0.401991792613352
2010,"COLORADO",2,148720,98171,259034,"JARED POLIS","STEPHEN BAILEY","Democrat",0.574133125381224,50549,246891,0.204742173671782
2010,"COLORADO",3,118048,129257,257999,"JOHN T SALAZAR","SCOTT R TIPTIN","Republican",0.500998065883976,-11209,247305,-0.0453245991791512
2010,"COLORADO",4,109249,138634,264181,"BETSY MARKEY","CORY GARDNER","Republican",0.524769003069865,-29385,247883,-0.118543829145202
2010,"COLORADO",5,68039,152829,232434,"KEVIN BRADLEY","DOUG LAMBORN","Republican",0.657515681870983,-84790,220868,-0.383894452795335
2010,"COLORADO",6,104104,217368,330943,"JOHN FLERLAGE","MIKE COFFMAN","Republican",0.656814013289298,-113264,321472,-0.352329285287677
2010,"COLORADO",7,112667,88026,210810,"ED PERLMUTTER","RYAN FRAZIER","Democrat",0.534448081210569,24641,200693,0.122779568794128
2010,"CONNECTICUT",1,130538,84076,226038,"JOHN B LARSON","ANN BRICKLEY","Democrat",0.577504667356816,46462,214614,0.216491002450912
2010,"CONNECTICUT",2,140888,95671,246809,"JOE CORTNEY","JANET PECKINPAUGH","Democrat",0.570838178510508,45217,236559,0.191144703858234
2010,"CONNECTICUT",3,134544,74107,220661,"ROSA L DELAURO","JERRY LABRIOLA JR","Democrat",0.609731669846507,60437,208651,0.28965593263392
2010,"CONNECTICUT",4,110746,102030,217391,"JAMES A HIMES","DAN DEBICELLA","Democrat",0.509432313205239,8716,212776,0.0409632665338196
2010,"CONNECTICUT",5,118231,102092,227303,"CHRISTOPHER S MURPHY","SAM S F CALIGIURI","Democrat",0.520147116404095,16139,220323,0.0732515443235613
2010,"DELAWARE",0,173543,125442,305636,"JOHN C CARNEY","GLEN URQUHART","Democrat",0.567809420356241,48101,298985,0.160880980651203
2010,"FLORIDA",2,105211,136371,254438,"ALLEN BOYD","STEVE SOUTHERLAND","Republican",0.535969469969108,-31160,241582,-0.128983119603282
2010,"FLORIDA",3,94744,50932,150301,"CORRINE BROWN","MICAHEL ""MIKE"" YOST","Democrat",0.630361740773514,43812,145676,0.300749608720723
2010,"FLORIDA",5,100858,208815,309673,"JAMES ""JIM"" PICCILLO","RICHARD B ""RICH"" NUGENT","Republican",0.674308060437946,-107957,309673,-0.348616120875892
2010,"FLORIDA",7,83206,185470,268676,"HEATHER BEAVEN","JOHN L MICA","Republican",0.690311006565529,-102264,268676,-0.380622013131057
2010,"FLORIDA",8,84167,123586,220244,"ALAN GRAYSON","DANIEL WEBSTER","Republican",0.56113219883402,-39419,207753,-0.189739739017006
2010,"FLORIDA",9,66158,165433,231591,"ANITA DE PALMA","GUS M BILIRAKIS","Republican",0.714332594962671,-99275,231591,-0.428665189925343
2010,"FLORIDA",10,71313,137943,209256,"CHARLIE JUSTICE","C W BILL YOUNG","Republican",0.659206904461521,-66630,209256,-0.318413808923042
2010,"FLORIDA",11,91328,61817,153145,"KATHY CASTOR","MIKE PRENDERGAST","Democrat",0.596349864507493,29511,153145,0.192699729014986
2010,"FLORIDA",12,87769,102704,213330,"LORI EDWARDS","DENNIS A ROSS","Republican",0.481432522383162,-14935,190473,-0.0784100633685614
2010,"FLORIDA",13,83123,183811,266934,"JAMES T GOLDEN","VERN BUCHANAN","Republican",0.688600927570111,-100688,266934,-0.377201855140222
2010,"FLORIDA",14,74525,188341,274691,"JAMES LLOYD ROACH","CONNIE MACK","Republican",0.685646781292434,-113816,262866,-0.43298106259463
2010,"FLORIDA",15,85595,157079,242674,"SHANNON ROBERTS","BILL POSEY","Republican",0.64728401064803,-71484,242674,-0.29456802129606
2010,"FLORIDA",16,80327,162285,242763,"JIM HORN","THOMAS J ROONEY","Republican",0.668491491701783,-81958,242612,-0.337815112195605
2010,"FLORIDA",18,46235,102360,148595,"ROLANDO A BANCIELLA","ILEANA ROS-LEHTINEN","Republican",0.688852249402739,-56125,148595,-0.377704498805478
2010,"FLORIDA",19,132098,78733,211059,"THEODORE E DEUTCH","JOE BUDD","Democrat",0.625881862417618,53365,210831,0.253117425805503
2010,"FLORIDA",20,100787,63845,167570,"DEBBIE WASSERMAN SCHULTZ","KAREN HARRINGTON","Democrat",0.601462075550516,36942,164632,0.224391369843044
2010,"FLORIDA",22,99804,118890,218694,"RON KLEIN","ALLEN WEST","Republican",0.543636313753464,-19086,218694,-0.0872726275069275
2010,"FLORIDA",23,100066,26804,126870,"ALCEE L HASTINGS","BERNARD SANSARICQ","Democrat",0.788728619847088,73262,126870,0.577457239694175
2010,"FLORIDA",24,98787,146129,245031,"SUZANNE M KOSMAS","SANDRA ""SANDY"" ADAMS","Republican",0.596369438968947,-47342,244916,-0.193298926979046
2010,"FLORIDA",25,61138,74859,143553,"JOE GARCIA","DAVID RIVERA","Republican",0.52147290547742,-13721,135997,-0.100891931439664
2010,"GEORGIA",1,46449,117270,163719,"OSCAR L HARRIS II","JACK KINGSTON","Republican",0.716288274421417,-70821,163719,-0.432576548842834
2010,"GEORGIA",2,86520,81673,168193,"SANFORD D BISHOP JR","MIKE KEOWN","Democrat",0.514409041993424,4847,168193,0.0288180839868484
2010,"GEORGIA",3,73932,168304,242239,"FRANK SAUNDERS","LYNN A WESTMORELAND","Republican",0.694784902513633,-94372,242236,-0.389587014316617
2010,"GEORGIA",4,131760,44707,176467,"HENRY C ""HANK"" JOHNSON JR","LISBETH ""LIZ"" CARTER","Democrat",0.7466551819887,87053,176467,0.493310363977401
2010,"GEORGIA",5,130782,46622,177404,"JOHN LEWIS","FENN LITTLE","Democrat",0.737198710288381,84160,177404,0.474397420576763
2010,"GEORGIA",7,78996,160898,239894,"DOUG HECKMANN","ROB WOODALL","Republican",0.670704561181188,-81902,239894,-0.341409122362377
2010,"GEORGIA",8,92250,102770,195020,"JIM MARSHALL","AUSTIN SCOTT","Republican",0.526971592657163,-10520,195020,-0.0539431853143267
2010,"GEORGIA",10,66905,138062,204967,"RUSSELL EDWARDS","PAUL C BROUN","Republican",0.673581600940639,-71157,204967,-0.347163201881278
2010,"GEORGIA",12,92459,70938,163397,"JOHN BARROW","RAYMOND MCKINNEY","Democrat",0.565854942257202,21521,163397,0.131709884514404
2010,"GEORGIA",13,140294,61771,202065,"DAVID SCOTT","MIKE CRANE","Democrat",0.694301338678148,78523,202065,0.388602677356296
2010,"HAWAII",1,94140,82723,176863,"COLLEEN HANABUSA","CHARLES DJOU","Democrat",0.5322763947236,11417,176863,0.0645527894471992
2010,"HAWAII",2,132290,46404,183258,"MAZIE K HIRONO","JOHN W WILLOUGHBY","Democrat",0.721878444597234,85886,178694,0.48063169440496
2010,"IDAHO",1,102135,126231,247427,"WALT MINNICK","RAUL R LABRADOR","Republican",0.510174718199711,-24096,228366,-0.10551483145477
2010,"IDAHO",2,48749,137468,199717,"MIKE CRAWFORD","MICHAEL K SIMPSON","Republican",0.688313964259427,-88719,186217,-0.476428038256443
2010,"ILLINOIS",1,148170,29253,184386,"BOBBY L RUSH","RAYMOND G WARDINGLEY","Democrat",0.803585955549771,118917,177423,0.670245684043219
2010,"ILLINOIS",2,150666,25883,187113,"JESSE L JACKSON JR","ISAAC C HAYES","Democrat",0.805213961616777,124783,176549,0.70678961648041
2010,"ILLINOIS",3,116120,40479,166627,"DANIEL LIPINSKI","MICHAEL A BENDAS","Democrat",0.696885858834403,75641,156599,0.483023518668702
2010,"ILLINOIS",4,63273,11711,81792,"LUIS V GUTIERREZ","ISRAEL VASQUEZ","Democrat",0.773584213615023,51562,74984,0.68764002987304
2010,"ILLINOIS",5,108360,38935,153435,"MIKE QUIGLEY","DAVID RATOWITZ","Democrat",0.70622739270701,69425,147295,0.471333039139143
2010,"ILLINOIS",6,65379,114456,179835,"BENJAMIN S LOWE","PETER J ROSKAM","Republican",0.636450079239303,-49077,179835,-0.272900158478605
2010,"ILLINOIS",7,149846,29575,183849,"DANNY K DAVIS","MARK M WEIMAN","Democrat",0.815049306768054,120271,179421,0.670328445388221
2010,"ILLINOIS",8,97825,98115,202435,"MELISSA L BEAN","JOE WALSH","Republican",0.484674092918715,-290,195940,-0.00148004491170767
2010,"ILLINOIS",9,117553,55182,177207,"JANICE D SCAKOWSKY","JOEL BARRY POLLAK","Democrat",0.663365442674386,62371,172735,0.36107910961878
2010,"ILLINOIS",10,105290,109941,215232,"DANIEL J SEALS","ROBERT DOLD","Republican",0.5108022970562,-4651,215231,-0.0216093406618935
2010,"ILLINOIS",11,96019,129108,225127,"DEBORAH L HALVORSON","ADAM KINZINGER","Republican",0.573489630297565,-33089,225127,-0.146979260595131
2010,"ILLINOIS",12,121272,74046,202705,"JERRY F COSTELLO","TERI NEWMAN","Democrat",0.598268419624578,47226,195318,0.241790311184837
2010,"ILLINOIS",13,86281,152132,238413,"SCOTT HARPER","JUDY BIGGERT","Republican",0.63810278801911,-65851,238413,-0.276205576038219
2010,"ILLINOIS",14,98645,112369,219013,"BILL FOSTER","RANDALL M ""RANDY"" HULTGREN","Republican",0.513070000410935,-13724,211014,-0.0650383386884283
2010,"ILLINOIS",15,75948,136915,212863,"DAVID GILL","TIMOTHY V JOHNSON","Republican",0.643207133226535,-60967,212863,-0.286414266453071
2010,"ILLINOIS",16,66037,138299,212761,"GEORGE W GAULRAPP","DONALD A MANZULLO","Republican",0.65002044547638,-72262,204336,-0.353643019340694
2010,"ILLINOIS",17,85454,104583,198898,"PHIL HARE","BOBBY SCHILLING","Republican",0.525812225361743,-19129,190037,-0.100659345285392
2010,"ILLINOIS",18,57046,152868,221170,"DEIRDRE ""D K"" HIRNER","AARON SCHOCK","Republican",0.691178731292671,-95822,209914,-0.456482178415923
2010,"ILLINOIS",19,67132,166166,233298,"TIM BAGWELL","JOHN SHIMKUS","Republican",0.712247854675137,-99034,233298,-0.424495709350273
2010,"INDIANA",1,99387,65558,169707,"PETER J VISCLOSKY","MARK LEYVA","Democrat",0.585638777422263,33829,164945,0.205092606626451
2010,"INDIANA",2,91341,88803,189591,"JOE DONNELLY","JACKIE WALORSKI","Democrat",0.48177919837967,2538,180144,0.0140887290167866
2010,"INDIANA",3,61267,116140,185049,"THOMAS HAYHURST","MARLIN A STUTZMAN","Republican",0.62761754994623,-54873,177407,-0.309305720743826
2010,"INDIANA",4,53167,138732,202322,"DAVID SANDERS","TODD ROKITA","Republican",0.68569903421279,-85565,191899,-0.445885596068765
2010,"INDIANA",5,60024,146899,236407,"TIM CRAWFORD","DAN BURTON","Republican",0.621381769575351,-86875,206923,-0.419842163510098
2010,"INDIANA",6,56647,126027,189309,"BARRY WELSH","MIKE PENCE","Republican",0.665721122609068,-69380,182674,-0.37980227071176
2010,"INDIANA",7,86011,55213,146039,"ANDRE CARSON","MARVIN B SCOTT","Democrat",0.588959113661419,30798,141224,0.218079080043052
2010,"INDIANA",8,76265,117259,203764,"W TRENT VANHAAFTEN","LARRY D BUCHSON","Republican",0.575464753342102,-40994,193524,-0.211829023790331
2010,"INDIANA",9,95353,118040,225532,"BARON P HILL","TODD YOUNG","Republican",0.523384708156714,-22687,213393,-0.106315577361957
2010,"IOWA",1,104428,100219,210902,"BRUCE L BRALEY","BENJAMIN M LANGE","Democrat",0.495149405885198,4209,204647,0.0205671228994317
2010,"IOWA",2,115839,104319,227175,"DAVID LOEBSACK","MARIANNETTE MILLER-MEEKS","Democrat",0.509910861670518,11520,220158,0.0523260567410678
2010,"IOWA",3,122147,111925,240756,"LEONARD L BOSWELL","BRAD ZAUN","Democrat",0.507347688115769,10222,234072,0.0436703236610957
2010,"IOWA",4,74300,152588,232519,"BILL MASKE","TOM LATHAM","Republican",0.656238844997613,-78288,226888,-0.345051302845457
2010,"IOWA",5,63160,128363,195239,"MATTHEW CAMPBELL","STEVE KING","Republican",0.657465977596689,-65203,191523,-0.340444750761005
2010,"KANSAS",1,44068,142281,192886,"ALAN JILKA","TIM HUELSKAMP","Republican",0.737642960090416,-98213,186349,-0.527037977128936
2010,"KANSAS",2,66588,130034,205975,"CHERYL HUDSPETH","LYNN JENKINKS","Republican",0.631309624954485,-63446,196622,-0.322680066320147
2010,"KANSAS",3,90193,136246,233285,"STEPHENE MOORE","KEVIN YODER","Republican",0.584032406712819,-46053,226439,-0.203379276538052
2010,"KANSAS",4,74143,119575,203383,"RAJ GOYLE","MIKE POMPEO","Republican",0.587930161321251,-45432,193718,-0.234526476630979
2010,"KENTUCKY",1,62090,153840,215930,"CHARLES KENDALL HATCHETT","ED WHITFIELD","Republican",0.712453109804103,-91750,215930,-0.424906219608206
2010,"KENTUCKY",2,73749,155906,229655,"ED MARKSBERRY","BRETT GUTHRIE","Republican",0.678870479632492,-82157,229655,-0.357740959264984
2010,"KENTUCKY",3,139940,112627,255930,"JOHN A YARMUTH","TODD LALLY","Democrat",0.54679013792834,27313,252567,0.108141602030352
2010,"KENTUCKY",4,66694,151813,218507,"JOHN WALTZ","GEOFF DAVIS","Republican",0.694774080464241,-85119,218507,-0.389548160928483
2010,"KENTUCKY",5,44034,151019,195053,"JAMES E ""JIM"" HOLBERT","HAROLD ROGERS","Republican",0.774245974171123,-106985,195053,-0.548491948342245
2010,"KENTUCKY",6,119812,119164,239223,"BEN CHANDLER","GARLAND ""ANDY"" BARR","Democrat",0.500838130112907,648,238976,0.00271156936261382
2010,"LOUISIANA",1,38416,157182,200176,"MYRON KATZ","STEVE SCALISE","Republican",0.785219007273599,-118766,195598,-0.607194347590466
2010,"LOUISIANA",2,83705,43378,129604,"CEDRIC RICHMOND","ANH ""JOSEPH"" CAO","Democrat",0.645851979877164,40327,127083,0.317328045450611
2010,"LOUISIANA",3,61914,108963,170877,"RAVI SANGISETTY","""JEFF"" LANDRY","Republican",0.637669200653101,-47049,170877,-0.275338401306203
2010,"LOUISIANA",4,54609,105223,168794,"DAVID MELVILLE","JOHN FLEMING","Republican",0.623381162837542,-50614,159832,-0.316670003503679
2010,"LOUISIANA",6,72577,138607,211184,"MERRITT E MCDONALD SR","BILL CASSIDY","Republican",0.656332866126222,-66030,211184,-0.312665732252443
2010,"MAINE",1,169114,128501,297657,"CHELLIE PINGREE","DEAN PETER SCONTRAS","Democrat",0.568150589436835,40613,297615,0.136461535876888
2010,"MAINE",2,147042,119669,266711,"MICHAEL H MICHAUD","JASON J LEVESQUE","Democrat",0.551315843740978,27373,266711,0.102631687481956
2010,"MARYLAND",1,120400,155118,286812,"FRANK KRATOVIL JR","ANDY HARRIS","Republican",0.540835111501611,-34718,275518,-0.126009915867566
2010,"MARYLAND",2,134133,69523,208904,"C A DUTCH RUPPERSBERGER","MARCELO CARDARELLI","Democrat",0.642079615517175,64610,203656,0.317250657972267
2010,"MARYLAND",3,147448,86947,241429,"JOHN P SARBANES","JIM WILHELM","Democrat",0.610730276810159,60501,234395,0.258115574137674
2010,"MARYLAND",4,160228,31467,192020,"DONNA F EDWARDS","ROBERT BROADUS","Democrat",0.834433913134049,128761,191695,0.671697227366389
2010,"MARYLAND",5,155110,83575,241383,"STENY H HOYER","CHARLES LOLLAR","Democrat",0.642588749000551,71535,238685,0.299704631627459
2010,"MARYLAND",6,80455,148820,242189,"ANDREW DUCK","ROSCOE G BARTLETT","Republican",0.614478774841136,-68365,229275,-0.298179042634391
2010,"MARYLAND",7,152669,46375,203068,"ELIJAH E CUMMINGS","FRANK MIRABILE JR","Democrat",0.751812200839128,106294,199044,0.534022628162617
2010,"MARYLAND",8,153613,52421,209667,"CHRIS VAN HOLLEN","MICHAEL LEE PHILIPS","Democrat",0.73265225333505,101192,206034,0.491142238659639
2010,"MASSACHUSETTS",1,128011,74418,213364,"JOHN W OLVER","WILLIAM L GUNN JR","Democrat",0.599965317485611,53593,202429,0.264749615914716
2010,"MASSACHUSETTS",2,122751,91209,214124,"RICHARD E NEAL","THOMAS A WESLEY","Democrat",0.573270628234107,31542,213960,0.147420078519349
2010,"MASSACHUSETTS",3,122708,85124,217352,"JAMES P MCGOVERN","MARTIN A LAMB","Democrat",0.564558872244102,37584,207832,0.18083836945225
2010,"MASSACHUSETTS",4,126194,101517,234127,"BARNEY FRANK","SEAN D M MIELAT","Democrat",0.538998065152674,24677,227711,0.108369819639807
2010,"MASSACHUSETTS",5,122858,94646,224029,"NIKI TSONGAS","JONATHAN A GOLNIK","Democrat",0.548402215784564,28212,217504,0.12970795939385
2010,"MASSACHUSETTS",6,142732,107930,251081,"JOHN F TIERNEY","BILL HUDAK","Democrat",0.56846993599675,34802,250662,0.138840350751211
2010,"MASSACHUSETTS",7,145696,73467,219357,"EDWARD J MARKEY","GERRY DEMBROWSKI","Democrat",0.664195808658944,72229,219163,0.329567490862965
2010,"MASSACHUSETTS",9,157071,59965,229964,"STEPHEN F LYNCH","VERNON M HARRISON","Democrat",0.683024299455567,97106,217036,0.447418861387051
2010,"MASSACHUSETTS",10,132743,120029,283197,"WILLIAM R KEATING","JEFFREY DAVIS PERRY","Democrat",0.468730247848671,12714,252772,0.0502982925324007
2010,"MICHIGAN",1,94824,120523,232037,"GARY MCDOWELL","DAN BENISHEK","Republican",0.519412852260631,-25699,215347,-0.119337627178461
2010,"MICHIGAN",2,72118,148864,228078,"FRED JOHNSON","BILL HUIZENGA","Republican",0.652688992362262,-76746,220982,-0.347295254817134
2010,"MICHIGAN",3,83953,133714,224063,"PAT MILES","JUSTIN AMASH","Republican",0.596769658533537,-49761,217667,-0.228610675940772
2010,"MICHIGAN",4,68458,148531,224354,"JERRY M CAMPBELL","DAVE CAMP","Republican",0.66203856405502,-80073,216989,-0.369018706017356
2010,"MICHIGAN",5,107286,89680,202263,"DALE E KILDEE","JOHN KUPIEC","Democrat",0.530428204861987,17606,196966,0.0893859853984952
2010,"MICHIGAN",6,66729,123142,198696,"DON COONEY","FRED UPTON","Republican",0.619750775053348,-56413,189871,-0.297112249895982
2010,"MICHIGAN",7,102402,113185,225669,"MARK H SCHAUER","TIM WALBERG","Republican",0.501553159716221,-10783,215587,-0.0500169305199293
2010,"MICHIGAN",8,84069,156931,244894,"LANCE ENDERLE","MIKE ROGERS","Republican",0.640811943126414,-72862,241000,-0.302331950207469
2010,"MICHIGAN",9,125730,119325,252650,"GARY C PETERS","ROCKY RACZKOWSKI","Democrat",0.497644963388086,6405,245055,0.0261369896553835
2010,"MICHIGAN",10,58530,168364,233930,"HENRY YANEZ","CANDICE S MILLER","Republican",0.719719574231608,-109834,226894,-0.484076264687475
2010,"MICHIGAN",11,91710,141224,238287,"NATALIE MOSHER","THADDEUS G MCCOTTER","Republican",0.592663468842194,-49514,232934,-0.212566649780625
2010,"MICHIGAN",12,124671,71372,204117,"SANDER M LEVIN","DON VOLARIC","Democrat",0.61078205147048,53299,196043,0.271874027636794
2010,"MICHIGAN",13,100885,23462,127076,"HANSEN CLARKE","JOHN HAULER","Democrat",0.793894991973307,77423,124347,0.622636653879868
2010,"MICHIGAN",14,115511,29902,150478,"JOHN CONYERS JR","DON UKRAINEC","Democrat",0.767627161445527,85609,145413,0.588730031015109
2010,"MICHIGAN",15,118336,83488,208309,"JOHN D DINGELL","ROB STEELE","Democrat",0.568079151644912,34848,201824,0.172665292532107
2010,"MINNESOTA",1,122365,109242,248005,"TIMOTHY J WALZ","RANDY DEMMER","Democrat",0.493397310538094,13123,231607,0.0566606363365529
2010,"MINNESOTA",4,136746,80141,231426,"BETTY MCCOLLUM","TERESA COLLETT","Democrat",0.590884343159368,56605,216887,0.260988440985398
2010,"MINNESOTA",5,154833,55222,228856,"KEITH ELLISON","JOEL DEMOS","Democrat",0.676552067675744,99611,210055,0.474213896360477
2010,"MINNESOTA",7,133096,90652,241097,"COLLIN C PETERSON","LEE BYBERG","Democrat",0.55204336843677,42444,223748,0.189695550351288
2010,"MINNESOTA",8,129091,133490,277081,"JAMES L OBERSTAR","CHIP CRAVAACK","Republican",0.481772478084026,-4399,262581,-0.0167529257638595
2010,"MISSISSIPPI",1,89388,121074,219093,"TRAVIS W CHILDERS","ALAN NUNELEE","Republican",0.552614643096767,-31686,210462,-0.150554494398039
2010,"MISSISSIPPI",2,105327,64499,171356,"BENNIE G THOMPSON","BILL MARCY","Democrat",0.614667709330283,40828,169826,0.240410773379812
2010,"MISSISSIPPI",3,60737,132393,194716,"JEOL L GILL","GREGG HARPER","Republican",0.679928716695084,-71656,193130,-0.371024698389686
2010,"MISSISSIPPI",4,95243,105613,203384,"GENE TAYLOR","STEVEN PALAZZO","Republican",0.51927880265901,-10370,200856,-0.0516290277611821
2010,"MISSOURI",1,135907,43649,184779,"WM LACY CLAY","ROBYN HAMLIN","Democrat",0.735511069980896,92258,179556,0.513811847000379
2010,"MISSOURI",2,77467,180481,265632,"ARTHUR LIEBER","W TODD AKIN","Republican",0.679439977111191,-103014,257948,-0.39935956084172
2010,"MISSOURI",3,99398,94757,203085,"RUSS CARNAHAN","ED MARTIN","Democrat",0.489440382106015,4641,194155,0.0239035821894878
2010,"MISSOURI",4,101532,113489,225056,"IKE SKELTON","VICKY HARTZLER","Republican",0.504270048343523,-11957,215021,-0.0556085219583203
2010,"MISSOURI",5,102076,84578,191423,"EMANUEL CLEAVER","JACOB TURK","Democrat",0.533248355735727,17498,186654,0.0937456470260482
2010,"MISSOURI",6,67762,154103,221912,"CLINT HYLTON","SAM GRAVES","Republican",0.694432928368002,-86341,221865,-0.389160074820274
2010,"MISSOURI",7,67545,141010,222431,"SCOTT ECKERSLEY","BILLY LONG","Republican",0.63394940453444,-73465,208555,-0.352257198340965
2010,"MISSOURI",8,56377,128499,195999,"TOMMY SOWERS","JO ANN EMERSON","Republican",0.655610487808611,-72122,184876,-0.390110127869491
2010,"MONTANA",0,121954,217696,360341,"DENNIS MCDONALD","DENNY REHBERG","Republican",0.604138857360112,-95742,339650,-0.281884292654203
2010,"NEBRASKA",1,47106,116871,163977,"IVY HARPER","JEFF FORTENBERRY","Republican",0.712728004537222,-69765,163977,-0.425456009074443
2010,"NEBRASKA",2,60486,93840,154326,"TOM WHITE","LEE TERRY","Republican",0.608063450099141,-33354,154326,-0.216126900198282
2010,"NEBRASKA",3,29932,117275,167243,"REBEKAH DAVIS","ADRIAN SMITH","Republican",0.701225163385015,-87343,147207,-0.593334556101272
2010,"NEVADA",1,103246,58995,167206,"SHELLEY BERKLEY","KENNETH A WEGNER","Democrat",0.617477841704245,44251,162241,0.272748565405785
2010,"NEVADA",2,87421,169458,267708,"NANCY PRICE","DEAN HELLER","Republican",0.632995651979022,-82037,256879,-0.319360477111792
2010,"NEVADA",3,127168,128916,267874,"DINA TITUS","JOSEPH JOHN HECK","Republican",0.481256112948625,-1748,256084,-0.00682588525640024
2010,"NEW HAMPSHIRE",1,95503,121655,225124,"CAROL SHEA-PORTER","FRANK C GUINTA","Republican",0.540391073364013,-26152,217158,-0.120428443805892
2010,"NEW HAMPSHIRE",2,105060,108610,224663,"ANN MCLANE KUSTER","CHARLES BASS","Republican",0.483435189595082,-3550,213670,-0.0166144053914916
2010,"NEW JERSEY",1,106334,58562,168267,"ROBERT E ANDREWS","DALE GLADING","Democrat",0.631936149096377,47772,164896,0.289709877741122
2010,"NEW JERSEY",2,51690,109460,167120,"GARY STEIN","FRANK A LOBIONDO","Republican",0.654978458592628,-57770,161150,-0.358485882717965
2010,"NEW JERSEY",3,104252,110215,220309,"JOHN H ALDER","JON RUNYAN","Republican",0.500274614291745,-5963,214467,-0.0278038113089659
2010,"NEW JERSEY",4,52118,129752,186938,"HOWARD KLEINHENDLER","CHRISTOPHER H SMITH","Republican",0.694091089024168,-77634,181870,-0.426865343377137
2010,"NEW JERSEY",5,62634,124030,190993,"TOD THEISE","SCOTT GARRETT","Republican",0.649395527584781,-61396,186664,-0.328911841597737
2010,"NEW JERSEY",6,81933,65413,149662,"FRANK PALLONE JR","ANNA C LITTLE","Democrat",0.547453595435047,16520,147346,0.11211705780951
2010,"NEW JERSEY",7,71902,105084,176986,"ED POTOSNAK","LEONARD LANCE","Republican",0.593741877888647,-33182,176986,-0.187483755777293
2010,"NEW JERSEY",8,88478,51023,141208,"BILL BASCRELL JR","ROLAND STRATEN","Democrat",0.626579230638491,37455,139501,0.268492698977068
2010,"NEW JERSEY",9,83564,52082,137626,"STEVEN R ROTHMAN","MICHAEL A AGOSTA","Democrat",0.607181782512025,31482,135646,0.23208940919747
2010,"NEW JERSEY",10,95299,14357,111877,"DONALD M PAYNE","MICHAEL J ALONSO","Democrat",0.851819408815038,80942,109656,0.738144743561684
2010,"NEW JERSEY",11,55472,122149,181800,"DOUGLAS HERBERT","RODNEY P FRELINGHUYSEN","Republican",0.671886688668867,-66677,177621,-0.375389171325463
2010,"NEW JERSEY",12,108214,93634,204002,"RUSH D HOLT","SCOTT SIPPRELLE","Democrat",0.530455583768787,14580,201848,0.0722325710435575
2010,"NEW JERSEY",13,62840,19538,84796,"ALBIO SIRES","HENRIETTA DWYER","Democrat",0.741072692108118,43302,82378,0.525650052198402
2010,"NEW MEXICO",1,112010,104215,216225,"MARTIN HEINRICH","JONATHAN L BARELA","Democrat",0.518025205226038,7795,216225,0.0360504104520754
2010,"NEW MEXICO",2,75708,94053,169761,"HARRY TEAGUE","STEVE PEARCE","Republican",0.55403184477,-18345,169761,-0.10806368954
2010,"NEW MEXICO",3,120048,90617,210665,"BEN RAY LUJAN","THOMAS E MULLINS","Democrat",0.56985260959343,29431,210665,0.139705219186861
2010,"NEW YORK",1,98316,78300,202007,"TIMOTHY H BISHOP","RANDY ALTSCHULER","Democrat",0.486696005583965,20016,176616,0.113330615572768
2010,"NEW YORK",2,94594,58525,174490,"STEVE ISRAEL","JOHN B GOMEZ","Democrat",0.542117026763711,36069,153119,0.235561883241139
2010,"NEW YORK",3,51346,131674,185768,"HOWARD A KUDLER","PETER T KING","Republican",0.708808836828733,-80328,183020,-0.438902852147306
2010,"NEW YORK",4,94483,69323,176253,"CAROLYN MCCARTHY","FRANCIS X BECKER","Democrat",0.536064634360834,25160,163806,0.153596327362856
2010,"NEW YORK",5,72239,36861,120926,"GARY L ACKERMAN","JAMES MILANO","Democrat",0.597381869903908,35378,109100,0.324271310724106
2010,"NEW YORK",6,85096,10057,111573,"GREGORY W MEEKS","ASHER E TAUB","Democrat",0.762693483190378,75039,95153,0.788614126722226
2010,"NEW YORK",7,71247,13751,97971,"JOSEPH CROWLEY","KENNETH A REYNOLDS","Democrat",0.727225403435711,57496,84998,0.676439445634015
2010,"NEW YORK",8,98839,29514,143126,"JERROLD NADLER","SUSAN L KONE","Democrat",0.69057334097229,69325,128353,0.540112034779086
2010,"NEW YORK",9,67011,37750,117613,"ANTHONY D WEINER","ROBERT L TURNER","Democrat",0.569758445069848,29261,104761,0.27931195769418
2010,"NEW YORK",10,95485,7419,119872,"EDOLPHUS TOWNS","DIANA MUNIZ","Democrat",0.796557995194875,88066,102904,0.855807354427428
2010,"NEW YORK",11,104297,9119,124914,"YVETTE D CLARKE","HUGH C CARR","Democrat",0.834950445906784,95178,113416,0.839193764548212
2010,"NEW YORK",13,60773,55821,131426,"MICHAEL E MCMAHON","MICHAEL G GRIMM","Democrat",0.462412308066897,4952,116594,0.0424721683791619
2010,"NEW YORK",14,107327,32065,150481,"CAROLYN B MALONEY","DAVID RYAN BRUMBERG","Democrat",0.713226254477309,75262,139392,0.539930555555556
2010,"NEW YORK",15,91225,10678,127046,"CHARLES B RANGEL","MICHEL J FAULKNER","Democrat",0.718047006596036,80547,101903,0.790428152262446
2010,"NEW YORK",16,61642,2257,71349,"JOSE E SERRANO","FRANK DELLA VALLE","Democrat",0.863950440791041,59385,63899,0.929357266936885
2010,"NEW YORK",17,95346,29792,139126,"ELIOT L ENGEL","ANTHONY MELE","Democrat",0.685321219613875,65554,125138,0.523853665553229
2010,"NEW YORK",18,115619,60513,187364,"NITA M LOWEY","JIM RUSSELL","Democrat",0.617082256997075,55106,176132,0.312867622010765
2010,"NEW YORK",19,98766,88734,215738,"JOHN J HALL","NAN HAYMORTH","Democrat",0.457805300874209,10032,187500,0.053504
2010,"NEW YORK",20,107075,110813,244768,"SCOTT MURPHY","CHRISTOPHER P GIBSON","Republican",0.452726663616159,-3738,217888,-0.0171556028785431
2010,"NEW YORK",21,124889,70211,229425,"PAUL TONKO","THEODORE J DANZ JR","Democrat",0.544356543532745,54678,195100,0.280256278831369
2010,"NEW YORK",22,98661,75558,193358,"MAURICE D HINCHEY","GEORGE K PHILLIPS","Democrat",0.510250416326193,23103,174219,0.132608957691182
2010,"NEW YORK",23,82232,73646,182510,"WILLIAM L OWENS","MATTHEW A DOHENY","Democrat",0.450561613062298,8586,155878,0.0550815381259703
2010,"NEW YORK",24,89809,85702,198453,"MICHAEL A ARCURI","RICHARD L HANNA","Democrat",0.452545438970436,4107,175511,0.0234002427198295
2010,"NEW YORK",25,103954,81380,215613,"DANIEL B MAFFEI","ANN MARIE BUERKLE","Democrat",0.482132338959154,22574,185334,0.121801720137697
2010,"NEW YORK",26,54307,151449,221763,"PHILIP A FEDELE","CHRISTOPHER JOHN LEE","Republican",0.682931778520312,-97142,205756,-0.47212231964074
2010,"NEW YORK",27,119085,63015,205897,"BRIAN HIGGINGS","LEONARD A ROBERTO","Democrat",0.578371710126908,56070,182100,0.307907742998353
2010,"NEW YORK",28,102514,45630,168055,"LOUISE MCINTOSH SLAUGHTER","JILL A ROWLAND","Democrat",0.610002677694802,56884,148144,0.383977751377039
2010,"NEW YORK",29,86099,93167,210145,"MATTHEW C ZELLER","THOMAS W REED II","Republican",0.443346260915082,-7068,179266,-0.0394274430176386
2010,"NORTH CAROLINA",1,103294,70867,174161,"G K BUTTERFIELD","ASHLEY WOOLARD","Democrat",0.59309489495352,32427,174161,0.18618978990704
2010,"NORTH CAROLINA",2,92393,93876,189774,"BOB ETHERIDGE","RENEE ELLMERS","Republican",0.494672610578899,-1483,186269,-0.00796160391691586
2010,"NORTH CAROLINA",3,51317,143225,199304,"JOHNNY G ROUSE","WALTER B JONES","Republican",0.718625817846104,-91908,194542,-0.472432688057078
2010,"NORTH CAROLINA",4,155384,116448,271832,"DAVID E PRICE","WILLIAM ""B J"" LAWSON","Democrat",0.571617763913005,38936,271832,0.14323552782601
2010,"NORTH CAROLINA",5,72762,140525,213287,"BILLY KENNEDY","VIRGINIA FOXX","Republican",0.658854032360153,-67763,213287,-0.317708064720306
2010,"NORTH CAROLINA",6,51507,156252,207759,"SAM TURNER","HOWARD COBLE","Republican",0.752082942255209,-104745,207759,-0.504165884510418
2010,"NORTH CAROLINA",7,113957,98328,212285,"MIKE MCINTYRE","ILARIO GREGORY PANTANO","Democrat",0.536811362083991,15629,212285,0.0736227241679817
2010,"NORTH CAROLINA",8,88776,73129,167442,"LARRY KISSELL","HAROLD JOHNSON","Democrat",0.530189558175368,15647,161905,0.0966430931719218
2010,"NORTH CAROLINA",9,71450,158790,230240,"JEFF DOCTOR","SUE WILKINS MYRICK","Republican",0.689671646977067,-87340,230240,-0.379343293954135
2010,"NORTH CAROLINA",10,52972,130813,183785,"JEFF GREGORY","PATRICK T MCHENRY","Republican",0.711771907391789,-77841,183785,-0.423543814783579
2010,"NORTH CAROLINA",11,131225,110246,241471,"HEATH SHULER","JEFF MILLER","Democrat",0.543439999006092,20979,241471,0.0868799980121837
2010,"NORTH CAROLINA",12,103495,55315,162007,"MELVIN L WATT","GREG DORITY","Democrat",0.638830420907739,48180,158810,0.303381399156224
2010,"NORTH CAROLINA",13,116103,93099,209202,"BRAD MILLER","WILLIAM ""BILL"" RANDALL","Democrat",0.554980353916311,23004,209202,0.109960707832621
2010,"NORTH DAKOTA",0,106542,129802,236344,"EARL POMEROY","RICK BERG","Republican",0.54920793419761,-23260,236344,-0.0984158683952205
2010,"OHIO",1,92672,103770,201518,"STEVE DRIEHAUS","STEVE CHABOT","Republican",0.514941593306801,-11098,196442,-0.0564950468840676
2010,"OHIO",2,82431,139027,237845,"SURYA YALAMANCHILI","JEAN SCHMIDT","Republican",0.584527738653325,-56596,221458,-0.255560873845153
2010,"OHIO",3,71455,152629,224084,"JOE ROBERTS","MICHAEL R TURNER","Republican",0.681124042769676,-81174,224084,-0.362248085539351
2010,"OHIO",4,50533,146029,204270,"DOUG LITT","JIM JORDAN","Republican",0.714882263670632,-95496,196562,-0.485831442496515
2010,"OHIO",5,54919,140703,207453,"CALEB FINKENBINER","ROBERT E LATTA","Republican",0.678240372518113,-85784,195622,-0.438519184958747
2010,"OHIO",6,92823,103170,205575,"CHARLES A WILSON","BILL JOHNSON","Republican",0.501860634804816,-10347,195993,-0.0527927017801656
2010,"OHIO",7,70400,135721,218313,"BILL CONNER","STEVE AUSTRIA","Republican",0.621680797753684,-65321,206121,-0.316906089141815
2010,"OHIO",8,65883,142731,217436,"JUSTIN A COUSSOULE","JOHN A BOEHNER","Republican",0.656427638477529,-76848,208614,-0.368374126376945
2010,"OHIO",9,121819,83423,205242,"MARCY KAPTUR","RICH IOTT","Democrat",0.593538359595015,38396,205242,0.187076719190029
2010,"OHIO",10,101343,83809,191026,"DENNIS J KUCINICH","PETER J CORRIGAN","Democrat",0.530519405735345,17534,185152,0.0947005703422053
2010,"OHIO",11,139693,28754,168447,"MARCIA L FUDGE","THOMAS PEKAREK","Democrat",0.829299423557558,110939,168447,0.658598847115116
2010,"OHIO",12,110307,150163,269180,"PAULA BROOKS","PATRICK J TIBERI","Republican",0.557853480942121,-39856,260470,-0.153015702384152
2010,"OHIO",13,118806,94367,213173,"BETTY SUTTON","ROM GANLEY","Democrat",0.557321987306085,24439,213173,0.114643974612169
2010,"OHIO",14,72604,149878,230865,"BILL O'NEILL","STEVEN C LATOURETTE","Republican",0.6492019145388,-77274,222482,-0.347326974766498
2010,"OHIO",15,91077,119471,220596,"MARY JO KILROY","STEVE STIVERS","Republican",0.541582802952003,-28394,210548,-0.134857609666204
2010,"OHIO",16,90833,114652,220137,"JOHN A BOCCIERI","JIM RENACCI","Republican",0.520821125026688,-23819,205485,-0.115916003601236
2010,"OHIO",17,102758,57352,190666,"TIM RYAN","JIM GRAHAM","Democrat",0.538942443854699,45406,160110,0.283592530135532
2010,"OHIO",18,80756,107426,199448,"ZACHARY T SPACE","BOB GIBBS","Republican",0.538616581765673,-26670,188182,-0.141724500749275
2010,"OKLAHOMA",2,108203,83226,191429,"DAN BOREN","CHARLES THOMPSON","Democrat",0.565238286779955,24977,191429,0.13047657355991
2010,"OKLAHOMA",3,45689,161927,207616,"FRANKIE ROBBINS","FRANK D LUCAS","Republican",0.77993507244143,-116238,207616,-0.559870144882861
2010,"OKLAHOMA",5,68074,123236,197105,"BILLY COYLE","JAMES LANKFORD","Republican",0.625230207249943,-55162,191310,-0.288338299095709
2010,"OREGON",1,160357,122858,292909,"DAVID WU","ROB CORNILLES","Democrat",0.547463546698804,37499,283215,0.132404710202496
2010,"OREGON",2,72173,206245,279037,"JOYCE B SEGERS","GREG WALDEN","Republican",0.739131369674989,-134072,278418,-0.481549325115474
2010,"OREGON",3,193104,67714,275802,"EARL BLUMENAUER","DELIA LOPEZ","Democrat",0.700154458633367,125390,260818,0.48075669624029
2010,"OREGON",4,162416,129877,298052,"PETER A DEFAZIO","ART ROBINSON","Democrat",0.544925046636157,32539,292293,0.111323227035885
2010,"OREGON",5,145319,130313,283556,"KURT SCHRADER","SCOTT BRUUN","Democrat",0.512487833091171,15006,275632,0.0544421547570674
2010,"PENNSYLVANIA",2,182800,21907,204707,"CHAKA FATTAH","RICK HELLBERG","Democrat",0.892983630261789,160893,204707,0.785967260523578
2010,"PENNSYLVANIA",3,88924,111909,200833,"KATHLEEN A DAHLKEMPER","MIKE KELLY","Republican",0.557224161367903,-22985,200833,-0.114448322735805
2010,"PENNSYLVANIA",4,120827,116958,237785,"JASON ALTMIRE","KEITH ROTHFUS","Democrat",0.508135500557226,3869,237785,0.0162710011144521
2010,"PENNSYLVANIA",5,52375,127427,185512,"MICHAEL PIPE","GLENN THOMPSON","Republican",0.686893570227263,-75052,179802,-0.417414711738468
2010,"PENNSYLVANIA",6,100493,133770,234263,"MANAN TRIVEDI","JIM GERLACH","Republican",0.571024873753004,-33277,234263,-0.142049747506008
2010,"PENNSYLVANIA",7,110314,137825,250847,"BRYAN LENTZ","PATRICK MEEHAN","Republican",0.549438502354025,-27511,248139,-0.110869311152217
2010,"PENNSYLVANIA",8,113547,130759,244306,"PATRICK J MURPHY","MICHAEL G FITZPATRICK","Republican",0.535226314539962,-17212,244306,-0.0704526290799244
2010,"PENNSYLVANIA",9,52322,141904,194226,"TOM CONNERS","BILL SHUSTER","Republican",0.73061279128438,-89582,194226,-0.46122558256876
2010,"PENNSYLVANIA",10,89846,110599,200445,"CHRISTOPHER P CARNEY","THOMAS A MARINO","Republican",0.551767317718077,-20753,200445,-0.103534635436155
2010,"PENNSYLVANIA",11,84618,102179,186797,"PAUL E KANJORSKI","LOUIS J BARLETTA","Republican",0.54700557289464,-17561,186797,-0.0940111457892793
2010,"PENNSYLVANIA",12,94056,91170,185226,"MARK S CRITZ","TIM BURNS","Democrat",0.507790482977552,2886,185226,0.0155809659551035
2010,"PENNSYLVANIA",13,118710,91987,210697,"ALLYSON Y SCHWARTZ","CARSON DEE ADCOCK","Democrat",0.56341571071254,26723,210697,0.12683142142508
2010,"PENNSYLVANIA",14,122073,49997,177470,"MICHAEL F DOYLE","MELISSA HALUSZCZAK","Democrat",0.687851467853722,72076,172070,0.41887603882141
2010,"PENNSYLVANIA",15,79766,109534,204548,"JOHN B CALLAHAN","CHARLES W DENT","Republican",0.535492891644015,-29768,189300,-0.157253037506603
2010,"PENNSYLVANIA",16,70994,134113,205107,"LOIS HERR","JOSEPH R PITTS","Republican",0.653868468652947,-63119,205107,-0.307736937305894
2010,"PENNSYLVANIA",17,118486,95000,213486,"TIM HOLDEN","DAVE ARGALL","Democrat",0.555005948867841,23486,213486,0.110011897735683
2010,"PENNSYLVANIA",18,78558,161888,240446,"DAN CONNOLLY","TIM MURPHY","Republican",0.673282150670005,-83330,240446,-0.34656430134001
2010,"PENNSYLVANIA",19,53549,165219,229756,"RYAN S SANDERS","RODD RUSSELL PLATTS","Republican",0.719106356308432,-111670,218768,-0.510449425875814
2010,"RHODE ISLAND",1,81269,71542,160814,"DAVID N CICILLINE","JOHN J LOUGHLIN II","Democrat",0.505360229830736,9727,152811,0.0636537945566746
2010,"RHODE ISLAND",2,104442,55409,174670,"JAMES R LANGEVIN","MARK S ZACCARIA","Democrat",0.597938970630332,49033,159851,0.306741903397539
2010,"SOUTH CAROLINA",1,67008,152755,233695,"BEN FRASIER","TIM SCOTT","Republican",0.65365112646826,-85747,219763,-0.390179420557601
2010,"SOUTH CAROLINA",2,113625,138861,259672,"ROB MILLER","JOE WILSON","Republican",0.53475538371484,-25236,252486,-0.09995009624296
2010,"SOUTH CAROLINA",3,66497,126235,202108,"JANE BALLARD DYER","JEFF DUNCAN","Republican",0.624591802402676,-59738,192732,-0.309953718116348
2010,"SOUTH CAROLINA",4,62438,137586,216838,"PAUL CORDEN","TREY GOWDY","Republican",0.634510556267813,-75148,200024,-0.375694916610007
2010,"SOUTH CAROLINA",5,102296,125834,228286,"JOHN M SPRATT JR","MICK MULVANEY","Republican",0.551212076080005,-23538,228130,-0.103178012536712
2010,"SOUTH CAROLINA",6,125459,72661,199590,"JAMES E CLYBURN","JIM PRATT","Democrat",0.628583596372564,52798,198120,0.266495053502928
2010,"SOUTH DAKOTA",0,146589,153703,319426,"STEPHANIE HERSETH SANDLIN","KRISTI NOEM","Republican",0.481185000594817,-7114,300292,-0.0236902747991955
2010,"TENNESSEE",1,26045,123006,152161,"MICHAEL EDWARD CLARK","DAVID P ROE","Republican",0.808393740840294,-96961,149051,-0.650522304446129
2010,"TENNESSEE",2,25400,141796,173380,"DAVE HANCOCK","JOHN J DUNCAN JR","Republican",0.817833660168416,-116396,167196,-0.696164980023446
2010,"TENNESSEE",3,45387,92032,162056,"JOHN WOLFE","CHUCK FLEISCHMANN","Republican",0.567902453472874,-46645,137419,-0.339436322488157
2010,"TENNESSEE",4,70254,103969,182191,"LINCOLN DAVIS","SCOTT DESJARLAIS","Republican",0.570659362976217,-33715,174223,-0.193516355475454
2010,"TENNESSEE",5,99162,74204,176362,"JIM COOPER","DAVID HALL","Democrat",0.562263979768884,24958,173366,0.143961330364662
2010,"TENNESSEE",6,56145,128517,191084,"BRETT CARTER","DIANE BLACK","Republican",0.672568085239999,-72372,184662,-0.391916041199597
2010,"TENNESSEE",7,54347,158916,219583,"GREG RABIDOUX","MARSHA BLACKBURN","Republican",0.723717227654236,-104569,213263,-0.490328842790357
2010,"TENNESSEE",8,64960,98759,167405,"ROY HERRON","STEPHEN LEE FINCHER","Republican",0.589940563304561,-33799,163719,-0.206445189623684
2010,"TENNESSEE",9,99827,33879,134907,"STEVE COHEN","CHARLOTTE BERGMANN","Democrat",0.739969015692292,65948,133706,0.49323141818617
2010,"TEXAS",3,47848,101180,152652,"JOHN LINGENFELDER","SAM JOHNSON","Republican",0.662814768231009,-53332,149028,-0.357865635987868
2010,"TEXAS",4,40975,136338,186286,"VALINDA HATHCOX","RALPH M HALL","Republican",0.731874644364042,-95363,177313,-0.537822945864093
2010,"TEXAS",5,41649,106742,151349,"TOM BERRY","JEB HENSARLING","Republican",0.705270599739675,-65093,148391,-0.438658678760841
2010,"TEXAS",6,50717,107140,162557,"DAVID E COZAD","JOE BARTON","Republican",0.659091887768598,-56423,157857,-0.357431092697821
2010,"TEXAS",8,34694,161417,201099,"KENT HARGETT","KEVIN BRADY","Republican",0.802674304695697,-126723,196111,-0.646179969507065
2010,"TEXAS",9,80107,24201,105767,"AL GREEN","STEVE MUELLER","Democrat",0.757391246797205,55906,104308,0.535970395367565
2010,"TEXAS",10,74086,144980,224171,"TED ANKRUM","MICHAEL T MCCAUL","Republican",0.646738427361255,-70894,219066,-0.323619365853213
2010,"TEXAS",11,23989,125581,155340,"JAMES QUILLIAN","K MICHAEL CONAWAY","Republican",0.808426676966654,-101592,149570,-0.679227117737514
2010,"TEXAS",12,38434,109882,152917,"TRACEY SMITH","KAY GRANGER","Republican",0.71857282054971,-71448,148316,-0.481728201947194
2010,"TEXAS",14,44431,140623,185054,"ROBERT PRUETT","RON PAUL","Republican",0.759902514941585,-96192,185054,-0.519805029883169
2010,"TEXAS",15,53546,39964,96080,"RUBEN HINOJOSA","EDDIE ZAMORA","Democrat",0.557306411323897,13582,93510,0.145246497700781
2010,"TEXAS",16,49301,31051,84892,"SILVESTRE REYES","TIM BESCO","Democrat",0.580749658389483,18250,80352,0.227125647152529
2010,"TEXAS",17,63138,106696,172642,"CHET EDWARDS","BILL FLORES","Republican",0.61801879032912,-43558,169834,-0.256473968698847
2010,"TEXAS",18,85108,33067,121321,"SHEILA JACKSON LEE","JOHN FAULK","Democrat",0.701510867862942,52041,118175,0.440372329172837
2010,"TEXAS",19,25984,106059,136358,"ANDY WILSON","RANDY NEUGEBAUER","Republican",0.777798148990158,-80075,132043,-0.606431238308733
2010,"TEXAS",20,58645,31757,92185,"CHARLES A GONZALEZ","CLAYTON TROTTER","Democrat",0.636166404512665,26888,90402,0.297427048074158
2010,"TEXAS",21,65927,162924,236545,"LAINEY MELNICK","LAMAR SMITH","Republican",0.688765351201674,-96997,228851,-0.423843461466194
2010,"TEXAS",22,62082,140537,208223,"KESHA ROGERS","PETE OLSON","Republican",0.67493504560015,-78455,202619,-0.387204556334796
2010,"TEXAS",23,67348,74853,151534,"CIRO D RODRIGUEZ","FRANCISCO ""QUICO"" CANSECO","Republican",0.493968350337218,-7505,142201,-0.0527774066286454
2010,"TEXAS",25,99967,84849,189247,"LLOYD DOGGETT","DONNA CAMPBELL","Democrat",0.528235586297273,15118,184816,0.0818002770322916
2010,"TEXAS",26,55385,120984,180431,"NEIL L DURRANCE","MICHAEL C BURGESS","Republican",0.670527791787442,-65599,176369,-0.371941781152017
2010,"TEXAS",27,50179,50976,106531,"SOLOMON P ORTIZ","R BLAKE FARENTHOLD","Republican",0.478508603129605,-797,101155,-0.0078789975779744
2010,"TEXAS",28,62773,46740,111402,"HENRY CUELLAR","BRYAN UNDERWOOD","Democrat",0.563481804635464,16033,109513,0.146402710180527
2010,"TEXAS",29,43257,22825,66948,"GENE GREEN","ROY MORALES","Democrat",0.646128338411902,20432,66082,0.309191610423413
2010,"TEXAS",30,86322,24668,113978,"EDDIE BERNICE JOHNSON","STEPHEN E BRODEN","Democrat",0.757356682868624,61654,110990,0.555491485719434
2010,"TEXAS",32,44258,79433,126869,"GRIER RAGGIO","PETE SESSIONS","Republican",0.626102515192837,-35175,123691,-0.284378006483899
2010,"UTAH",1,46765,135247,195462,"MORGAN E BOWEN","ROB BISHOP","Republican",0.691935005269566,-88482,182012,-0.486132782453904
2010,"UTAH",2,127151,116001,251847,"JIM MATHESON","MORGAN PHILPOT","Democrat",0.504873990954826,11150,243152,0.0458560900177667
2010,"UTAH",3,44320,139721,193186,"KAREN HYER","JASON CHAFFETZ","Republican",0.723245990910314,-95401,184041,-0.518368189696861
2010,"VERMONT",0,154006,76403,238521,"PETER WELCH","PAUL D BEAUDRY","Democrat",0.645670611811958,77603,230409,0.336805419927173
2010,"VIRGINIA",1,73824,135564,212236,"KRYSTAL M BALL","ROBERT J WITTMAN","Republican",0.638741778020694,-61740,209388,-0.294859304258124
2010,"VIRGINIA",2,70591,88340,166289,"GLENN C NYE","E SCOTT RIGELL","Republican",0.531243798447282,-17749,158931,-0.111677394592622
2010,"VIRGINIA",3,114754,44553,163900,"ROBERT C ""BOBBY"" SCOTT","C L ""CHUCK"" SMITH JR","Democrat",0.700146430750458,70201,159307,0.440664879760462
2010,"VIRGINIA",4,74298,123659,198389,"WYNNE V E LEGROW","J RANDY FORBES","Republican",0.623315808840208,-49361,197957,-0.249352132028673
2010,"VIRGINIA",5,110562,119560,235299,"THOMAS S P PERRIELLO","ROBERT HURT","Republican",0.508119456521277,-8998,230122,-0.0391009986007422
2010,"VIRGINIA",7,79616,138209,233402,"RICK E WAUGH","ERIC CANTOR","Republican",0.592150024421385,-58593,217825,-0.268991162630552
2010,"VIRGINIA",8,116404,71145,190748,"JAMES P MORAN","J PATRICK MURRAY","Democrat",0.610250173003125,45259,187549,0.241318268825747
2010,"VIRGINIA",9,86743,95726,186917,"RICK BOUCHER","H MORGAN GRIFFITH","Republican",0.512131052820236,-8983,182469,-0.0492302802119812
2010,"VIRGINIA",10,72604,131116,208556,"JEFFERY R BARNETT","FRANK R WOLF","Republican",0.628684861619901,-58512,203720,-0.287217749852739
2010,"VIRGINIA",11,111720,110739,226951,"GERALD E CONNOLLY","KEITH S FIMIAN","Democrat",0.492264850121832,981,222459,0.00440980135665448
2010,"WASHINGTON",1,172642,126737,299379,"JAY INSLEE","JAMES WATKINS","Democrat",0.576667034093908,45905,299379,0.153334068187815
2010,"WASHINGTON",2,155241,148722,303963,"RICK LARSEN","JOHN KOSTER","Democrat",0.510723344617601,6519,303963,0.021446689235203
2010,"WASHINGTON",3,135654,152799,288453,"DENNY HECK","JAIME HERRERA","Republican",0.529718879678838,-17145,288453,-0.059437759357677
2010,"WASHINGTON",4,74973,156726,231699,"JAY CLOUGH","DOC HASTINGS","Republican",0.676420700995688,-81753,231699,-0.352841401991377
2010,"WASHINGTON",5,101146,177235,278381,"DARYL ROMEYN","CATHY MCMORRIS","Republican",0.636663421713407,-76089,278381,-0.273326843426814
2010,"WASHINGTON",6,151873,109800,261673,"NORMAN D DICKS","DOUG CLOUD","Democrat",0.580392321714506,42073,261673,0.160784643429013
2010,"WASHINGTON",8,148581,161296,309877,"SUZAN DELBENE","DAVID G REICHERT","Republican",0.52051620481675,-12715,309877,-0.0410324096334997
2010,"WASHINGTON",9,123743,101851,225594,"ADAM SMITH","RICHARD ""DICK"" MURI","Democrat",0.548520793992748,21892,225594,0.0970415879854961
2010,"WEST VIRGINIA",1,89220,90660,179880,"MIKE OLIVERIO","DAVID B MCKINLEY","Republican",0.50400266844563,-1440,179880,-0.00800533689126084
2010,"WEST VIRGINIA",2,55001,126814,185246,"VIRGINIA LYNCH GRAF","SHELLEY MOORE CAPITO","Republican",0.684570786953564,-71813,181815,-0.394978412122212
2010,"WEST VIRGINIA",3,83636,65611,149247,"NICK J RAHALL II","ELLIOTT E ""SPIKE"" MAYNARD","Democrat",0.560386473429952,18025,149247,0.120772946859903
2010,"WISCONSIN",1,79363,179819,263627,"JOHN HECKENLIVELY","PAUL RYAN","Republican",0.682096295144276,-100456,259182,-0.387588644273136
2010,"WISCONSIN",2,191164,118099,309460,"TAMMY BALDWIN","CHAD LEE","Democrat",0.617734117494991,73065,309263,0.23625522613439
2010,"WISCONSIN",3,126380,116838,251340,"RON KIND","DAN KAPANKE","Democrat",0.502824858757062,9542,243218,0.0392322936624756
2010,"WISCONSIN",4,143559,61543,208103,"GWEN MOORE","DAN SEBRING","Democrat",0.689845893619986,82016,205102,0.399879084553052
2010,"WISCONSIN",5,90634,229642,331258,"TODD P KOLOSSO","F JAMES SENSENBRENNER","Republican",0.693242125473196,-139008,320276,-0.434025652874396
2010,"WISCONSIN",6,75926,183271,259367,"JOSEPH C KALLAS","THOMAS E PETRI","Republican",0.706608782150389,-107345,259197,-0.414144453832413
2010,"WISCONSIN",7,113018,132551,254389,"JULIE M LASSA","SEAN DUFFY","Republican",0.521056334983038,-19533,245569,-0.0795417988426878
2010,"WISCONSIN",8,118646,143998,262938,"STEVE KAGEN","REID J RIBBLE","Republican",0.547650016353665,-25352,262644,-0.0965260961605824
2010,"WYOMING",0,45768,131661,190822,"DAVID WENDT","CYNTHIA M LUMMIS","Republican",0.689967613797151,-85893,177429,-0.484097864497912
2012,"ALABAMA",2,103092,180591,283953,"THERESE FORD","MARTHA ROBY","Republican",0.635989054526629,-77499,283683,-0.273188735313713
2012,"ALABAMA",3,98141,175306,273930,"JOHN ANDREW HARRIS","MIKE ROGERS","Republican",0.639966414777498,-77165,273447,-0.282193624358651
2012,"ALABAMA",4,69706,199071,269118,"DANIEL H BOMAN","ROBERT B ADERHOLT","Republican",0.739716406929302,-129365,268777,-0.481309784691398
2012,"ALABAMA",5,101772,189185,291293,"CHARLIE L HOLLEY","MO BROOKS","Republican",0.649466344882987,-87413,290957,-0.300432709988074
2012,"ALABAMA",6,88267,219262,308102,"PENNY H BAILEY","SPENCER BACHUS","Republican",0.711653932788492,-130995,307529,-0.425959828178806
2012,"ALABAMA",7,232520,73835,306558,"TERRI A SEWELL","DON CHAMBERLAIN","Democrat",0.758486159225987,158685,306355,0.517977509751759
2012,"ALASKA",0,82927,185296,289804,"SHARON M CISSNA","DON YOUNG","Republican",0.639383859436033,-102369,268223,-0.381656308370274
2012,"ARIZONA",1,122774,113594,251595,"ANN KIRKPATRICK","JONATHAN PATON","Democrat",0.487982670561816,9180,236368,0.0388377445339471
2012,"ARIZONA",2,147338,144884,292279,"RON BARBER","MARTHA MCSALLY","Democrat",0.50410053407874,2454,292222,0.00839772501728138
2012,"ARIZONA",3,98468,62663,168698,"RAUL M GRIJALVA","GABRIELA SAUCEDO MERCER","Democrat",0.58369393828024,35805,161131,0.222210499531437
2012,"ARIZONA",4,69154,162907,243760,"JOHNNIE ROBINSON","PAUL A GOSAR","Republican",0.668308992451592,-93753,232061,-0.404001534079402
2012,"ARIZONA",5,89589,183470,273059,"SPENCER MORGAN","MATT SALMON","Republican",0.6719060715816,-93881,273059,-0.343812143163199
2012,"ARIZONA",6,97666,179706,293177,"MATT JETTE","DAVID SCHWEIKERT","Republican",0.612960771138254,-82040,277372,-0.295776069682592
2012,"ARIZONA",8,95635,172809,272791,"GENE SCHARER","TRENT FRANKS","Republican",0.63348497567735,-77174,268444,-0.287486403123184
2012,"ARIZONA",9,121881,111630,250131,"KYRSTEN SINEMA","VERNON B PARKER","Democrat",0.487268671216283,10251,233511,0.0438994308619294
2012,"ARKANSAS",1,96601,138800,246843,"SCOTT ELLINGTON","ERIC A ""RICK"" CRAWFORD","Republican",0.562300733664718,-42199,235401,-0.179264319183011
2012,"ARKANSAS",2,113156,158175,286598,"HERB RULE","TIM GRIFFIN","Republican",0.551905456423283,-45019,271331,-0.165919117240566
2012,"ARKANSAS",4,95013,154149,258953,"GENE JEFFRESS","TOM COTTON","Republican",0.595277907573961,-59136,249162,-0.237339562212536
2012,"CALIFORNIA",1,125386,168827,294213,"JIM REED","DOUG LA MALFA","Republican",0.573825765686764,-43441,294213,-0.147651531373529
2012,"CALIFORNIA",2,226216,91310,317526,"JARED HUFFMAN","DANIEL W ROBERTS","Democrat",0.712432997612794,134906,317526,0.424865995225588
2012,"CALIFORNIA",3,126882,107086,233968,"JOHN GARAMENDI","KIM VANN","Democrat",0.542304930588798,19796,233968,0.0846098611775969
2012,"CALIFORNIA",4,125885,197803,323688,"JACK UPPAL","TOM MCCLINTOCK","Republican",0.611091544944514,-71918,323688,-0.222183089889029
2012,"CALIFORNIA",5,202872,69545,272417,"MIKE THOMPSON","RANDY LOFTIN","Democrat",0.744711233146243,133327,272417,0.489422466292485
2012,"CALIFORNIA",6,160667,53406,214073,"DORIS O MATSUI","JOSEPH MCCRAY SR","Democrat",0.750524353841914,107261,214073,0.501048707683827
2012,"CALIFORNIA",7,141241,132050,273291,"AMI BERA","DANIEL E LUNGREN","Democrat",0.516815409215818,9191,273291,0.0336308184316351
2012,"CALIFORNIA",9,118373,94704,213077,"JERRY MCNERNEY","RICKY GILL","Democrat",0.555540954678356,23669,213077,0.111081909356711
2012,"CALIFORNIA",10,98934,110265,209199,"JOSE HERNANDEZ","JEFF DENHAM","Republican",0.527081869416202,-11331,209199,-0.0541637388324036
2012,"CALIFORNIA",11,200743,87136,287879,"GEORGE MILLER","VIRGINIA FULLER","Democrat",0.697317275660955,113607,287879,0.39463455132191
2012,"CALIFORNIA",12,253709,44478,298187,"NANCY PELOSI","JOHN DENNIS","Democrat",0.850838567744402,209231,298187,0.701677135488804
2012,"CALIFORNIA",14,203828,54455,258283,"JACKIE SPEIER","DEBORAH ""DEBBIE"" BACIGALUPI","Democrat",0.789165372866197,149373,258283,0.578330745732394
2012,"CALIFORNIA",16,84649,62801,147450,"JIM COSTA","BRIAN DANIEL WHELAN","Democrat",0.574086130891828,21848,147450,0.148172261783655
2012,"CALIFORNIA",17,159392,57336,216728,"MICHAEL M HONDA","EVELYN LI","Democrat",0.735447196485918,102056,216728,0.470894392971836
2012,"CALIFORNIA",18,212831,89103,301934,"ANNA G ESHOO","DAVE CHAPMAN","Democrat",0.704892459941577,123728,301934,0.409784919883153
2012,"CALIFORNIA",19,162300,59313,221613,"ZOE LOFGREN","ROBERT MURRAY","Democrat",0.732357758795739,102987,221613,0.464715517591477
2012,"CALIFORNIA",20,172996,60566,233562,"SAM FARR","JEFF TAYLOR","Democrat",0.740685556725837,112430,233562,0.481371113451674
2012,"CALIFORNIA",21,49119,67164,116283,"JOHN HERNANDEZ","DAVID G VALADAO","Republican",0.577590877428343,-18045,116283,-0.155181754856686
2012,"CALIFORNIA",22,81555,132386,213941,"OTTO LEE","DEVIN NUNES","Republican",0.618796771072398,-50831,213941,-0.237593542144797
2012,"CALIFORNIA",24,156749,127746,284495,"LOIS CAPPS","ABEL MALDONADO","Democrat",0.550972776322958,29003,284495,0.101945552645916
2012,"CALIFORNIA",25,106982,129593,236575,"LEE C ROGERS","HOWARD P ""BUCK"" MCKEON","Republican",0.547788227834725,-22611,236575,-0.0955764556694494
2012,"CALIFORNIA",26,139072,124863,263935,"JULIA BROWNLEY","TONY STRICKLAND","Democrat",0.526917612290905,14209,263935,0.0538352245818099
2012,"CALIFORNIA",27,154191,86817,241008,"JUDY CHU","JACK ORSWELL","Democrat",0.639775443138817,67374,241008,0.279550886277634
2012,"CALIFORNIA",28,188703,58008,246711,"ADAM B SCHIFF","PHIL JENNERJAHN","Democrat",0.764874691440592,130695,246711,0.529749382881185
2012,"CALIFORNIA",32,124903,65208,190111,"GRACE F NAPOLITANO","DAVID L MILLER","Democrat",0.657000383986198,59695,190111,0.314000767972395
2012,"CALIFORNIA",34,120367,20223,140590,"XAVIER BECERRA","STEPHEN C SMITH","Democrat",0.856156198876165,100144,140590,0.712312397752329
2012,"CALIFORNIA",36,110189,97953,208142,"RAUL RUIZ","MARY BONO MACK","Democrat",0.52939339489387,12236,208142,0.0587867897877411
2012,"CALIFORNIA",37,207039,32541,239580,"KAREN BASS","MORGAN OSBORNE","Democrat",0.864174805910343,174498,239580,0.728349611820686
2012,"CALIFORNIA",38,145280,69807,215087,"LINDA T SANCHEZ","BENJAMIN CAMPOS","Democrat",0.675447609571941,75473,215087,0.350895219143881
2012,"CALIFORNIA",39,106360,145607,251967,"JAY CHEN","EDWARD R ROYCE","Republican",0.577881230478594,-39247,251967,-0.155762460957189
2012,"CALIFORNIA",41,103578,72074,175652,"MARK TAKANO","JOHN TAVAGLIONE","Democrat",0.589677316512195,31504,175652,0.179354633024389
2012,"CALIFORNIA",42,84702,130245,214947,"MICHAEL WILLIAMSON","KEN CALVERT","Republican",0.605940068947229,-45543,214947,-0.211880137894458
2012,"CALIFORNIA",45,121814,171417,293231,"SUKHEE KANG","JOHN CAMPBELL","Republican",0.584580075094379,-49603,293231,-0.169160150188759
2012,"CALIFORNIA",46,95694,54121,149815,"LORETTA SANCHEZ","JERRY HAYDEN","Democrat",0.638747788939692,41573,149815,0.277495577879385
2012,"CALIFORNIA",47,130093,99919,230012,"ALAN LOWENTHAL","GARY DELONG","Democrat",0.56559222997061,30174,230012,0.13118445994122
2012,"CALIFORNIA",48,113358,177144,290502,"RON VARASTEH","DANA ROHRABACHER","Republican",0.609785819030506,-63786,290502,-0.219571638061012
2012,"CALIFORNIA",49,114893,159725,274618,"JERRY TETALMAN","DARRELL E ISSA","Republican",0.581626113364747,-44832,274618,-0.163252226729493
2012,"CALIFORNIA",50,83455,174838,258293,"DAVID B SECOR","DUNCAN HUNTER","Republican",0.676897941485058,-91383,258293,-0.353795882970115
2012,"CALIFORNIA",51,113934,45464,159398,"JUAN VARGAS","MICHAEL CRIMMINS","Democrat",0.714776847890187,68470,159398,0.429553695780374
2012,"CALIFORNIA",52,151451,144459,295910,"SCOTT PETERS","BRIAN P BILBRAY","Democrat",0.511814403027948,6992,295910,0.0236288060558954
2012,"CALIFORNIA",53,164825,103482,268307,"SUSAN A DAVIS","NICK POPADITCH","Democrat",0.614314945193379,61343,268307,0.228629890386758
2012,"COLORADO",1,237579,93217,348210,"DIANA DEGETTE","DANNY STROUD","Democrat",0.682286551219092,144362,330796,0.436407937218104
2012,"COLORADO",2,234758,162639,421580,"JARED POLIS","KEVIN LUNDBERG","Democrat",0.556852791878173,72119,397397,0.181478471151015
2012,"COLORADO",3,142619,185291,347247,"SAL PACE","SCOTT R TIPTON","Republican",0.533600002303836,-42672,327910,-0.130133268274832
2012,"COLORADO",4,125800,200006,342336,"BRANDON SHAFFER","CORY GARDNER","Republican",0.5842388764255,-74206,325806,-0.227761305807751
2012,"COLORADO",6,156937,163938,342914,"JOE MIKLOSI","MIKE COFFMAN","Republican",0.478073219524429,-7001,320875,-0.0218184651343981
2012,"COLORADO",7,182460,139066,340970,"ED PERLMUTTER","JOE COORS","Democrat",0.535120391823328,43394,321526,0.134962646877702
2012,"CONNECTICUT",1,192840,82321,297061,"JOHN B LARSON","JOHN HENRY DECKER","Democrat",0.649159600216791,110519,275161,0.401652123665781
2012,"CONNECTICUT",2,189444,88103,298960,"JOE COURTNEY","PAUL M FORMICA","Democrat",0.633676746052984,101341,277547,0.36513095079392
2012,"CONNECTICUT",3,197163,73726,291301,"ROSA L DELAURO","WAYNE WINSLEY","Democrat",0.676835987518066,123437,270889,0.455673726138751
2012,"CONNECTICUT",4,167320,117503,293432,"JAMES A HIMES","STEVE OBSITNIK","Democrat",0.570217290547725,49817,284823,0.174905116510956
2012,"CONNECTICUT",5,137631,128927,284757,"ELIZABETH ESTY","ANDREW RORABACK","Democrat",0.483327890095766,8704,266558,0.0326533062222856
2012,"DELAWARE",0,249933,129757,388059,"JOHN C CARNEY","THOMAS H KOVACH","Democrat",0.644059279645621,120176,379690,0.316510837788722
2012,"FLORIDA",1,92961,238440,342594,"JIM BRYAN","JEFF MILLER","Republican",0.695984167848824,-145479,331401,-0.438981777363376
2012,"FLORIDA",2,157634,175856,333718,"AL LAWSON","STEVE SOUTHERLAND II","Republican",0.526959888288915,-18222,333490,-0.0546403190500465
2012,"FLORIDA",3,102468,204331,315669,"J R GAILLOT","TED YOHO","Republican",0.647295109751037,-101863,306799,-0.332018683242123
2012,"FLORIDA",5,190472,70700,269153,"CORRINE BROWN","LEANNE KOLB","Democrat",0.707671844638551,119772,261172,0.45859433629945
2012,"FLORIDA",6,146489,195962,342451,"HEATHER BEAVEN","RON DESANTIS","Republican",0.572233691827444,-49473,342451,-0.144467383654888
2012,"FLORIDA",7,130479,185518,316010,"JASON H KENDALL","JOHN L MICA","Republican",0.587063700515806,-55039,315997,-0.174175704199723
2012,"FLORIDA",8,130870,205432,348909,"SHANNON ROBERTS","BILL POSEY","Republican",0.588783894941088,-74562,336302,-0.221711437933762
2012,"FLORIDA",9,164891,98856,263747,"ALAN GRAYSON","TODD LONG","Democrat",0.625186258042746,66035,263747,0.250372516085491
2012,"FLORIDA",10,153574,164649,318269,"VAL B DEMINGS","DANIEL WEBSTER","Republican",0.517326538242807,-11075,318223,-0.0348026384013726
2012,"FLORIDA",11,120303,218360,338663,"H DAVID WERDER","RICHARD B NUGENT","Republican",0.64477076031335,-98057,338663,-0.2895415206267
2012,"FLORIDA",12,108770,209604,330167,"JONATHAN MICHAEL SNOW","GUS M BILIRAKIS","Republican",0.63484236765031,-100834,318374,-0.316715560944047
2012,"FLORIDA",13,139742,189605,329347,"JESSICA EHRLICH","C W BILL YOUNG","Republican",0.575699793834466,-49863,329347,-0.151399587668933
2012,"FLORIDA",14,197121,83480,280601,"KATHY CASTOR","EVELIO ""E J"" OTERO","Democrat",0.702495714555543,113641,280601,0.404991429111087
2012,"FLORIDA",16,161929,187147,349076,"KEITH FITZGERALD","VERN BUCHANAN","Republican",0.536121073920865,-25218,349076,-0.0722421478417307
2012,"FLORIDA",17,116766,165488,282266,"WILLIAM BRONSON","THOMAS J ROONEY","Republican",0.586283859905196,-48722,282254,-0.172617571407314
2012,"FLORIDA",18,166257,164353,330665,"PATRICK MURPHY","ALLEN B WEST","Democrat",0.502795881027626,1904,330610,0.00575905145034935
2012,"FLORIDA",19,109746,189833,306216,"JIM ROACH","TREY RADEL","Republican",0.61993168221125,-80087,299579,-0.267331822323995
2012,"FLORIDA",22,171021,142050,313071,"LOIS FRANKEL","ADAM HASNER","Democrat",0.546269057178723,28971,313071,0.0925381143574461
2012,"FLORIDA",23,174205,98096,275430,"DEBBIE WASSERMAN SCHULTZ","KAREN HARRINGTON","Democrat",0.632483752677631,76109,272301,0.279503196829979
2012,"FLORIDA",26,135694,108820,252957,"JOE GARCIA","DAVID RIVERA","Democrat",0.536431093031622,26874,244514,0.109907817139305
2012,"FLORIDA",27,85020,138488,230171,"MANNY YEVANCEY","ILEANA ROS-LEHTINEN","Republican",0.601674407288494,-53468,223508,-0.239221862304705
2012,"GEORGIA",1,92399,157181,249580,"LESLI RAE MESSINGER","JACK KINGSTON","Republican",0.629782033816812,-64782,249580,-0.259564067633624
2012,"GEORGIA",2,162751,92410,255161,"SANFORD D BISHOP JR","JOHN HOUSE","Democrat",0.637836503227374,70341,255161,0.275673006454748
2012,"GEORGIA",4,208861,75041,283902,"HENRY C ""HANK"" JOHNSON JR","J CHRIS VAUGHN","Democrat",0.735679917718086,133820,283902,0.471359835436172
2012,"GEORGIA",5,234330,43335,277665,"JOHN LEWIS","HOWARD STOPECK","Democrat",0.84393063583815,190995,277665,0.687861271676301
2012,"GEORGIA",6,104365,189669,294034,"JEFF KAZANOW","TOM PRICE","Republican",0.645058054510703,-85304,294034,-0.290116109021406
2012,"GEORGIA",7,95377,156689,252066,"STEVE REILLY","ROB WOODALL","Republican",0.621618941070989,-61312,252066,-0.243237882141979
2012,"GEORGIA",9,60052,192101,252153,"JODY COOLEY","DOUG COLLINS","Republican",0.761843008014975,-132049,252153,-0.52368601602995
2012,"GEORGIA",11,90353,196968,287321,"PATRICK THOMPSON","PHIL GINGREY","Republican",0.685532905704769,-106615,287321,-0.371065811409538
2012,"GEORGIA",12,139148,119973,259121,"JOHN BARROW","LEE ANDERSON","Democrat",0.537000088761621,19175,259121,0.074000177523242
2012,"GEORGIA",13,201988,79550,281538,"DAVID SCOTT","S MALIK","Democrat",0.717444891986162,122438,281538,0.434889783972323
2012,"GEORGIA",14,59245,159947,219192,"DANIEL ""DANNY"" GRANT","TOM GRAVES","Republican",0.729711850797474,-100702,219192,-0.459423701594949
2012,"HAWAII",1,116505,96824,217876,"COLLEEN W HANABUSA","CHARLES K DJOU","Democrat",0.534730764287944,19681,213329,0.0922565614614047
2012,"HAWAII",2,168503,40707,219283,"TULSI GABBARD","KAWIKA CROWLEY","Democrat",0.768427101052065,127796,209210,0.610850341761866
2012,"IDAHO",1,97450,199402,316724,"JIMMY FARRIS","RAUL R LABRADOR","Republican",0.629576539826474,-101952,296852,-0.343443871019902
2012,"IDAHO",2,110847,207412,318494,"NICOLE LEFAVOUR","MICHAEL K SIMPSON","Republican",0.651227338662581,-96565,318259,-0.303416399850436
2012,"ILLINOIS",1,236854,83989,320844,"BOBBY L RUSH","DONALD E PELOQUIN","Democrat",0.738221690291855,152865,320843,0.476447982346506
2012,"ILLINOIS",2,188303,69115,297712,"JESSE L JACKSON JR","BRIAN WOODWORTH","Democrat",0.632500537432149,119188,257418,0.463013464481893
2012,"ILLINOIS",3,168738,77653,246398,"DANIEL LIPINSKI","RICHARD L GRABOWSKI","Democrat",0.684818870283038,91085,246391,0.369676652150444
2012,"ILLINOIS",4,133226,27279,160509,"LUIS V GUTIERREZ","HECTOR CONCEPCION","Democrat",0.830021992536244,105947,160505,0.660085355596399
2012,"ILLINOIS",5,177729,77289,270377,"MIKE QUIGLEY","DAN SCHMITT","Democrat",0.657337717335424,100440,255018,0.393854551443428
2012,"ILLINOIS",6,132991,193138,326129,"LESLIE COOLIDGE","PETER J ROSKAM","Republican",0.592213510604699,-60147,326129,-0.184427021209399
2012,"ILLINOIS",7,242439,31466,286435,"DANNY K DAVIS","RITA ZAK","Democrat",0.846401452336481,210973,273905,0.770241507091875
2012,"ILLINOIS",8,123206,101860,225066,"TAMMY DUCKWORTH","JOE WALSH","Democrat",0.547421645206295,21346,225066,0.0948432904125901
2012,"ILLINOIS",9,194869,98924,293807,"JANICE D SCHAKOWSKY","TIMOTHY C WOLFE","Democrat",0.663255130068378,95945,293793,0.326573471798171
2012,"ILLINOIS",10,133890,130564,264454,"BRAD SCHNEIDER","ROBERT J DOLD","Democrat",0.506288428233265,3326,264454,0.012576856466531
2012,"ILLINOIS",11,148928,105348,254295,"BILL FOSTER","JUDY BIGGERT","Democrat",0.585650523997719,43580,254276,0.171388569900423
2012,"ILLINOIS",12,157000,129902,303949,"WILLIAM L ENYART","JASON PLUMMER","Democrat",0.516534023800045,27098,286902,0.0944503698126887
2012,"ILLINOIS",13,136032,137034,294385,"DAVID M GILL","RODNEY DAVIS","Republican",0.465492467347181,-1002,273066,-0.00366944255234998
2012,"ILLINOIS",14,124351,177603,301954,"DENNIS ANDERSON","RANDY HULTGREN","Republican",0.588178994151427,-53252,301954,-0.176357988302854
2012,"ILLINOIS",15,94162,205775,299937,"ANGELA MICHAEL","JOHN SHIMKUS","Republican",0.686060739421945,-111613,299937,-0.372121478843891
2012,"ILLINOIS",16,112301,181789,294090,"WANDA ROHL","ADAM KINZINGER","Republican",0.618140705226291,-69488,294090,-0.236281410452583
2012,"ILLINOIS",17,153519,134623,288161,"CHERI BUSTOS","ROBERT T SCHILLING","Democrat",0.532754258903877,18896,288142,0.0655787771307203
2012,"ILLINOIS",18,85164,244467,329631,"STEVE WATERWORTH","AARON SCHOCK","Republican",0.741638377458431,-159303,329631,-0.483276754916862
2012,"INDIANA",1,187743,91291,279034,"PETER J VISCLOSKY","JOEL PHELPS","Democrat",0.672831984632697,96452,279034,0.345663969265394
2012,"INDIANA",2,130113,134033,273475,"BRENDAN MULLEN","JACKIE WALORSKI","Republican",0.490110613401591,-3920,264146,-0.0148402777251974
2012,"INDIANA",3,92363,187872,280235,"KEVIN R BOYD","MARLIN A STUTZMAN","Republican",0.67040876407301,-95509,280235,-0.34081752814602
2012,"INDIANA",4,93015,168688,272268,"TARA E NELSON","TODD ROKITA","Republican",0.619566015837337,-75673,261703,-0.289156028016492
2012,"INDIANA",5,125347,194570,333359,"SCOTT RESKE","SUSAN BROOKS","Republican",0.58366505779055,-69223,319917,-0.216377998043242
2012,"INDIANA",6,96678,162613,275253,"BRADLEY T BOOKOUT","LUKE MESSER","Republican",0.590776485633217,-65935,259291,-0.254289581975464
2012,"INDIANA",7,162122,95828,257950,"ANDRE CARSON","CARLOS A MAY","Democrat",0.628501647606125,66294,257950,0.25700329521225
2012,"INDIANA",8,122325,151533,283992,"DAVE CROOKS","LARRY BUCSHON","Republican",0.533581931885405,-29208,273858,-0.106653813290099
2012,"INDIANA",9,132848,165332,298180,"SHELLI YODER","TODD C YOUNG","Republican",0.554470454088135,-32484,298180,-0.108940908176269
2012,"IOWA",1,222422,162465,390849,"BRUCE L BRALEY","BEN LANGE","Democrat",0.569073990211053,59957,384887,0.155778189442616
2012,"IOWA",2,211863,161977,381275,"DAVID LOEBSACK","JOHN ARCHER","Democrat",0.555669792144777,49886,373840,0.133442114273486
2012,"IOWA",3,168632,202000,386842,"LEONARD L BOSWELL","TOM LATHAM","Republican",0.522177012837282,-33368,370632,-0.0900300028060178
2012,"IOWA",4,169470,200063,377883,"CHRISTIE VILSACK","STEVE KING","Republican",0.529431067288023,-30593,369533,-0.0827882760132383
2012,"KANSAS",2,113735,167463,293718,"TOBIAS SCHLINGENSIEPEN","LYNN JENKINS","Republican",0.570148918350254,-53728,281198,-0.191068215278914
2012,"KANSAS",4,81770,161094,258922,"ROBERT LEON TILLMAN","MIKE POMPEO","Republican",0.622171928225489,-79324,242864,-0.326619013110218
2012,"KENTUCKY",1,87199,199956,287155,"CHARLES KENDALL HATCHETT","ED WHITFIELD","Republican",0.696334732113319,-112757,287155,-0.392669464226637
2012,"KENTUCKY",2,89541,181508,282267,"DAVID LYNN WILLIAMS","BRETT GUTHRIE","Republican",0.643036557585548,-91967,271049,-0.339300274120178
2012,"KENTUCKY",3,206385,111452,322656,"JOHN A YARMUTH","BROOKS WICKER","Democrat",0.639644079143112,94933,317837,0.298684545852119
2012,"KENTUCKY",4,104734,186036,299444,"WILLIAM R ""BILL"" ADKINS","THOMAS MASSIE","Republican",0.621271423037363,-81302,290770,-0.279609313202875
2012,"KENTUCKY",5,55447,195408,250855,"KENNETH S STEPP","HAROLD ROGERS","Republican",0.778967929680493,-139961,250855,-0.557935859360985
2012,"KENTUCKY",6,141438,153222,303000,"BEN CHANDLER","GARLAND ""ANDY"" BARR","Republican",0.505683168316832,-11784,294660,-0.0399918550193443
2012,"LOUISIANA",1,61703,218340,290410,"M V ""VINNY"" MENDOZA","GARY KING","Republican",0.751833614544954,-156637,280043,-0.559331959734755
2012,"LOUISIANA",2,230417,50146,287354,"CEDRIC L RICHMOND","DWAYNE BAILEY","Democrat",0.801857639009723,180271,280563,0.642533049618089
2012,"LOUISIANA",3,67070,240558,311393,"""RON"" RICHARD","BRYAN BARRILLEAUX","Republican",0.77252218257957,-173488,307628,-0.563953866358069
2012,"MAINE",1,236363,128440,380715,"CHELLIE PINGREE","JONATHAN T E COURTNEY","Democrat",0.620839735760346,107923,364803,0.29583912413001
2012,"MAINE",2,191456,137542,343908,"MICHAEL H MICHAUD","KEVIN L RAYE","Democrat",0.556707026297731,53914,328998,0.163873336616028
2012,"MARYLAND",1,107670,214204,337760,"JOHN LAFERLA","ANDY HARRIS","Republican",0.634189957366177,-106534,321874,-0.330980445764492
2012,"MARYLAND",2,194088,92071,295940,"C A DUTCH RUPPERSBERGER","NANCY C JACOBS","Democrat",0.655835642359938,102017,286159,0.356504600589183
2012,"MARYLAND",3,213747,94549,319859,"JOHN P SARBANES","ERIC DELANO KNOWLES","Democrat",0.66825382434135,119198,308296,0.386634922282482
2012,"MARYLAND",4,240385,64560,311512,"DONNA F EDWARDS","FAITH M LOUDON","Democrat",0.77167171730142,175825,304945,0.576579383167456
2012,"MARYLAND",5,238618,95271,343820,"STENY H HOYER","TONY O'DONNELL","Democrat",0.69402012681054,143347,333889,0.429325314700394
2012,"MARYLAND",6,181921,117313,309549,"JOHN DELANEY","ROSCOE G BARTLETT","Democrat",0.587696939741366,64608,299234,0.215911293502744
2012,"MARYLAND",7,247770,67405,323818,"ELIJAH E CUMMINGS","FRANK C MIRABILE","Democrat",0.765152029843925,180365,315175,0.572269374157214
2012,"MARYLAND",8,217531,113033,343256,"CHRIS VAN HOLLEN","KEN TIMMERMAN","Democrat",0.633728179551122,104498,330564,0.316120327682385
2012,"MASSACHUSETTS",3,212119,109372,335111,"NIKI TSONGAS","JONATHAN A GOLNIK","Democrat",0.632981310670196,102747,321491,0.319595260831563
2012,"MASSACHUSETTS",4,221303,129936,373114,"JOSEPH P KENNEDY III","SEAN BIELAT","Democrat",0.593124353414774,91367,351239,0.260127719302241
2012,"MASSACHUSETTS",5,257490,82944,364201,"EDWARD J MARKEY","TOM TIERNEY","Democrat",0.706999706206188,174546,340434,0.512716121186485
2012,"MASSACHUSETTS",6,180942,176612,389852,"JOHN F TIERNEY","RICHARD R TISEI","Democrat",0.464129977529934,4330,357554,0.0121100589001941
2012,"MASSACHUSETTS",8,263999,82242,371694,"STEPHEN F LYNCH","JOE SELVAGGI","Democrat",0.710258976469892,181757,346241,0.524943608642535
2012,"MASSACHUSETTS",9,212754,116531,385799,"WILLIAM R KEATING","CHRISTOPHER SHELDON","Democrat",0.551463326758234,96223,329285,0.292217987457673
2012,"MICHIGAN",1,165179,167060,347037,"GARY MCDOWELL","DAN BENISHEK","Republican",0.481389592464204,-1881,332239,-0.00566158699008846
2012,"MICHIGAN",2,108973,194653,318267,"WILLIE GERMAN JR","BILL HUIZENGA","Republican",0.611602836612027,-85680,303626,-0.282189272328457
2012,"MICHIGAN",3,144108,171675,326283,"STEVE PESTKA","JUSTIN AMASH","Republican",0.526153676409742,-27567,315783,-0.0872972895944367
2012,"MICHIGAN",4,104996,197386,312949,"DEBRA FREIDELL WIRTH","DAVE CAMP","Republican",0.63072896861789,-92390,302382,-0.305540673717351
2012,"MICHIGAN",5,214531,103931,330146,"DANIEL T KILDEE","JIM SLEZAK","Democrat",0.6498064492679,110600,318462,0.347294182665436
2012,"MICHIGAN",6,136563,174955,320475,"MIKE O'BRIEN","FRED UPTON","Republican",0.545924019034246,-38392,311518,-0.123241674638384
2012,"MICHIGAN",7,136849,169668,318069,"KURT RICHARD HASKELL","TIM WALBERG","Republican",0.533431425256784,-32819,306517,-0.107070733434035
2012,"MICHIGAN",8,128657,202217,345054,"LANCE ENDERLE","MIKE ROGERS","Republican",0.586044503179213,-73560,330874,-0.222320279018599
2012,"MICHIGAN",9,208846,114760,337316,"SANDER M LEVIN","DON VOLARIC","Democrat",0.619140509196125,94086,323606,0.290742446060951
2012,"MICHIGAN",10,97734,226075,328612,"CHUCK STADLER","CANDICE S MILLER","Republican",0.687969398561221,-128341,323809,-0.396347847033282
2012,"MICHIGAN",11,158879,181788,358139,"SYED TAJ","KERRY BENTIVOLIO","Republican",0.507590628219769,-22909,340667,-0.0672474880161565
2012,"MICHIGAN",12,216884,92472,319223,"JOHN D DINGELL","CYNTHIA KALLGREN","Democrat",0.679412197742644,124412,309356,0.402164496567062
2012,"MICHIGAN",13,235336,38769,284270,"JOHN CONYERS JR","HARRY T SAWICKI","Democrat",0.827860836528652,196567,274105,0.7171230003101
2012,"MICHIGAN",14,270450,51395,328792,"GARY C PETERS","JOHN HAULER","Democrat",0.822556509890752,219055,321845,0.680622659976075
2012,"MINNESOTA",1,193211,142164,335880,"TIMOTHY J WALZ","ALLEN QUIST","Democrat",0.575238180302489,51047,335375,0.152208721580321
2012,"MINNESOTA",4,216685,109659,347991,"BETTY MCCOLLUM","TONY HERNANDEZ","Democrat",0.622674149618812,107026,326344,0.327954551025911
2012,"MINNESOTA",5,262102,88753,351969,"KEITH ELLISON","CHRIS FIELDS","Democrat",0.74467353658987,173349,350855,0.494075900300694
2012,"MINNESOTA",7,197791,114151,327576,"COLLIN C PETERSON","LEE BYBERG","Democrat",0.603801865826556,83640,311942,0.268126767155433
2012,"MISSISSIPPI",1,114076,186760,309177,"BRAD MORRIS","ALAN NUNNELEE","Republican",0.604055282249326,-72684,300836,-0.241606722599689
2012,"MISSISSIPPI",2,214978,99160,320244,"BENNIE G THOMPSON","BILL MARCY","Democrat",0.671294388029128,115818,314138,0.368685100178902
2012,"MISSISSIPPI",4,82344,182998,285432,"MATT MOORE","STEVEN M PALAZZO","Republican",0.641126432915721,-100654,265342,-0.379336855831342
2012,"MISSOURI",1,267927,60832,340583,"WM LACY CLAY","ROBYN HAMLIN","Democrat",0.786671677682092,207095,328759,0.62992952284196
2012,"MISSOURI",2,146272,236971,394448,"GLENN KOENEN","ANN WAGNER","Republican",0.600766133939074,-90699,383243,-0.236661856837568
2012,"MISSOURI",3,111189,214843,338385,"ERIC C MAYER","BLAINE LUETKEMEYER","Republican",0.634906984647665,-103654,326032,-0.317925847769544
2012,"MISSOURI",4,113120,192237,318723,"TERESA HENSLEY","VICKY HARTZLER","Republican",0.603147560734556,-79117,305357,-0.259096729401979
2012,"MISSOURI",5,200290,122149,330942,"EMANUEL CLEAVER","JACOB TURK","Democrat",0.60521178937699,78141,322439,0.242343513036574
2012,"MISSOURI",6,108503,216906,333688,"KYLE YARBER","SAM GRAVES","Republican",0.650026371940256,-108403,325409,-0.333128462949703
2012,"MISSOURI",7,98498,203565,318740,"JIM EVANS","BILLY LONG","Republican",0.638655330363305,-105067,302063,-0.347831412652327
2012,"MISSOURI",8,73755,216083,300391,"JACK RUSHIN","JO ANN EMERSON","Republican",0.719339128003169,-142328,289838,-0.491060523464832
2012,"MONTANA",0,204939,255468,479740,"KIM GILLAN","STEVE DAINES","Republican",0.532513444782591,-50529,460407,-0.109748548566812
2012,"NEBRASKA",1,81206,174889,256095,"KOREY L REIMAN","JEFF FORTENBERRY","Republican",0.682906733829243,-93683,256095,-0.365813467658486
2012,"NEBRASKA",2,129767,133964,263731,"JOHN W EWING JR","LEE TERRY","Republican",0.507956971307886,-4197,263731,-0.0159139426157714
2012,"NEBRASKA",3,65266,187423,252689,"MARK SULLIVAN","ADRIAN SMITH","Republican",0.741714122894151,-122157,252689,-0.483428245788301
2012,"NEVADA",1,113967,56521,179278,"DINA TITUS","CHRIS EDWARDS","Democrat",0.63569986278294,57446,170488,0.336950401201258
2012,"NEVADA",2,102019,162213,281449,"SAMUEL KOEPNICK","MARK E AMODEI","Republican",0.576349534018597,-60194,264232,-0.22780738139211
2012,"NEVADA",3,116823,137244,272523,"JOHN OCEGUERA","JOSEPH J HECK","Republican",0.503605200295021,-20421,254067,-0.0803764361369245
2012,"NEVADA",4,120501,101261,240492,"STEVEN A HORSFORD","DANNY TARKANIAN","Democrat",0.501060326331021,19240,221762,0.0867596792958217
2012,"NEW HAMPSHIRE",1,171650,158659,345022,"CAROL SHEA-PORTER","FRANK C GUINTA","Democrat",0.497504506958977,12991,330309,0.0393298396350084
2012,"NEW HAMPSHIRE",2,169275,152977,337394,"ANN MCLANE KUSTER","CHARLES F BASS","Democrat",0.501713130642513,16298,322252,0.0505753261422737
2012,"NEW JERSEY",1,210470,92459,308519,"ROBERT E ANDREWS","GREGORY W HORTON","Democrat",0.682194613621852,118011,302929,0.389566532091678
2012,"NEW JERSEY",2,116462,166677,289069,"CASSANDRA SHOBER","FRANK A LOBIONDO","Republican",0.576599358630638,-50215,283139,-0.17735105372273
2012,"NEW JERSEY",3,145506,174253,324399,"SHELLEY ADLER","JON RUNYAN","Republican",0.537156403071526,-28747,319759,-0.0899020825058872
2012,"NEW JERSEY",4,107991,195145,306247,"BRIAN P FROELICH","CHRISTOPHER H SMITH","Republican",0.637214405365604,-87154,303136,-0.287507917238467
2012,"NEW JERSEY",5,130100,167501,304371,"ADAM GUSSEN","SCOTT GARRETT","Republican",0.55031852574654,-37401,297601,-0.125674980930844
2012,"NEW JERSEY",6,151782,84360,239638,"FRANK PALLONE JR","ANNA LITTLE","Democrat",0.633380348692611,67422,236142,0.285514647966054
2012,"NEW JERSEY",7,123057,175662,307315,"UPENDRA J CHIVUKULA","LEONARD LANCE","Republican",0.571602427476693,-52605,298719,-0.176101955349342
2012,"NEW JERSEY",8,130853,31763,167790,"ALBIO SIRES","MARIA KARCZEWSKI","Democrat",0.779861731926813,99090,162616,0.609349633492399
2012,"NEW JERSEY",9,162822,55091,220133,"BILL PASCRELL JR","SHMULEY BOTEACH","Democrat",0.739652846233868,107731,217913,0.494376196004828
2012,"NEW JERSEY",10,201435,24271,230060,"DONALD M PAYNE JR","BRIAN C KELEMEN","Democrat",0.875575936712162,177164,225706,0.784932611450294
2012,"NEW JERSEY",11,123897,182237,309859,"JOHN ARVANITES","RODNEY P FRELINGHUYSEN","Republican",0.588128794064397,-58340,306134,-0.190570142486624
2012,"NEW JERSEY",12,189926,80906,274378,"RUSH D HOLT","ERIC A BECK","Democrat",0.692205643309595,109020,270832,0.402537366337804
2012,"NEW MEXICO",1,162924,112473,275856,"MICHELLE LUJAN GRISHAM","JANICE E ARNOLD-JONES","Democrat",0.590612493474856,50451,275397,0.183193716707154
2012,"NEW MEXICO",2,92162,133180,225515,"EVELYN MADRID ERHARD","STEVEN PEARCE","Republican",0.590559386293595,-41018,225342,-0.18202554339626
2012,"NEW MEXICO",3,167103,97616,264719,"BEN RAY LUJAN","JEFFERSON L BYRD","Democrat",0.631246718218186,69487,264719,0.262493436436372
2012,"NEW YORK",1,134205,106678,294578,"TIMOTHY H BISHOP","RANDY ALTSCHULER","Democrat",0.45558392004834,27527,240883,0.114275395108829
2012,"NEW YORK",2,93375,116083,271832,"VIVIANNE C FALCONE","PETER T KING","Republican",0.427039494982195,-22708,209458,-0.108413142491573
2012,"NEW YORK",3,146016,98455,306274,"STEVE ISRAEL","STEPHEN A LABATE","Democrat",0.476749577175993,47561,244471,0.194546592438367
2012,"NEW YORK",4,152590,84982,299484,"CAROLYN MCCARTHY","FRANCIS X BECKER","Democrat",0.509509690000134,67608,237572,0.28457899079016
2012,"NEW YORK",5,167835,17875,224508,"GREGORY W MEEKS","ALLAN W JENNINGS","Democrat",0.747568015393661,149960,185710,0.807495557589791
2012,"NEW YORK",6,107505,45992,186932,"GRACE MENG","DANIEL J HALLORAN","Democrat",0.575102176192412,61513,153497,0.40074398848186
2012,"NEW YORK",8,178687,15841,236292,"HAKEEM S JEFFRIES","ALAN S BELLONE","Democrat",0.756212652142265,162846,194528,0.837133985852936
2012,"NEW YORK",9,178168,20899,238957,"YVETTE D CLARKE","DANIEL J CAVANAGH","Democrat",0.74560695020443,157269,199067,0.790030492246329
2012,"NEW YORK",10,155908,35440,236323,"JERROLD NADLER","MICHAEL W CHAN","Democrat",0.659724191043614,120468,191348,0.629575433242051
2012,"NEW YORK",11,87718,91030,214755,"MARK S MURPHY","MICHAEL G GRIMM","Republican",0.423878373029732,-3312,178748,-0.018528878644796
2012,"NEW YORK",12,184864,41969,268287,"CAROLYN B MALONEY","CHRISTOPHER R WIGHT","Democrat",0.689053140852893,142895,226833,0.62995684049499
2012,"NEW YORK",13,170470,12132,233172,"CHARLES B RANGEL","CRAIG SCHLEY","Democrat",0.731091211637761,158338,182602,0.867120842049923
2012,"NEW YORK",14,116117,19191,170995,"JOSEPH CROWLEY","WILLIAM F GIBBONS","Democrat",0.67906663937542,96926,135308,0.716336062908328
2012,"NEW YORK",15,150243,3487,178645,"JOSE E SERRANO","FRANK L DELLA VALLE","Democrat",0.841014302107532,146756,153730,0.954634749235673
2012,"NEW YORK",16,173885,53935,270320,"ELIOT L ENGEL","JOSEPH MCLAUGHLIN","Democrat",0.64325614087008,119950,227820,0.526512158721798
2012,"NEW YORK",17,161624,91899,297379,"NITA M LOWEY","JOE E CARVIN","Democrat",0.543495001328271,69725,253523,0.275024356764475
2012,"NEW YORK",18,132456,113386,295436,"SEAN PATRICK MALONEY","NAN A S HAYWORTH","Democrat",0.448340757389079,19070,245842,0.0775701466795747
2012,"NEW YORK",19,120302,122654,305882,"JULIAN SCHREIBMAN","CHRISTOPHER P GIBSON","Republican",0.400984693443877,-2352,242956,-0.00968076524144289
2012,"NEW YORK",20,181092,79102,317678,"PAUL TONKO","ROBERT J DIETERICH","Democrat",0.5700489174573,101990,260194,0.391976755805284
2012,"NEW YORK",21,117856,104368,268741,"WILLIAM L OWENS","MATTHEW A DOHENY","Democrat",0.438548639768402,13488,222224,0.0606955144358845
2012,"NEW YORK",22,102080,145042,280189,"DAN LAMB","RICHARD L HANNA","Republican",0.517657723893515,-42962,247122,-0.173849353760491
2012,"NEW YORK",23,114590,117641,279796,"NATE SHINAGAWA","TOM REED","Republican",0.420452758438291,-3051,232231,-0.0131377809164151
2012,"NEW YORK",24,133908,105584,303567,"DANIEL B MAFFEI","ANN MARIE BUERKLE","Democrat",0.441115140973821,28324,239492,0.118266998480116
2012,"NEW YORK",25,168761,109292,322760,"LOUISE MCINTOSH SLAUGHTER","MAGGIE BROOKS","Democrat",0.522868385177841,59469,278053,0.213876491172546
2012,"NEW YORK",26,195234,57368,304961,"BRIAN HIGGINS","MICHAEL H MADIGAN","Democrat",0.640193336197088,137866,252602,0.545783485483092
2012,"NEW YORK",27,140008,137250,329768,"KATHLEEN C HOCHUL","CHRIS COLLINS","Democrat",0.424565148831906,2758,277258,0.00994741360032894
2012,"NORTH CAROLINA",1,254644,77288,338066,"G K BUTTERFIELD","PETE DILAURO","Democrat",0.753237533499376,177356,331932,0.534314257137004
2012,"NORTH CAROLINA",2,128973,174066,311397,"STEVE WILKINS","RENEE L ELLMERS","Republican",0.558984190599139,-45093,303039,-0.148802629364537
2012,"NORTH CAROLINA",3,114314,195571,309885,"ERIK ANDERSON","WALTER B JONES","Republican",0.631108314374687,-81257,309885,-0.262216628749375
2012,"NORTH CAROLINA",4,259534,88951,348485,"DAVID E PRICE","TIM D'ANNUNZIO","Democrat",0.744749415326341,170583,348485,0.489498830652682
2012,"NORTH CAROLINA",5,148252,200945,349197,"ELISABETH MOTSINGER","VIRGINIA FOXX","Republican",0.575448815425104,-52693,349197,-0.150897630850208
2012,"NORTH CAROLINA",6,142467,222116,364583,"TONY FORIEST","HOWARD COBLE","Republican",0.609233014155899,-79649,364583,-0.218466028311797
2012,"NORTH CAROLINA",7,168695,168041,336736,"MIKE MCINTYRE","DAVID ROUZER","Democrat",0.50097108714245,654,336736,0.00194217428489974
2012,"NORTH CAROLINA",8,137139,160695,302280,"LARRY KISSELL","RICHARD HUDSON","Republican",0.531609765780071,-23556,297834,-0.0790910372892282
2012,"NORTH CAROLINA",9,171503,194537,375690,"JENNIFER ROBERTS","ROBERT PITTENGER","Republican",0.517812558226197,-23034,366040,-0.0629275489017594
2012,"NORTH CAROLINA",10,144023,190826,334849,"PATSY KEEVER","PATRICK T MCHENRY","Republican",0.569886725061147,-46803,334849,-0.139773450122294
2012,"NORTH CAROLINA",11,141107,190319,331426,"HAYDEN ROGERS","MARK MEADOWS","Republican",0.574242817401169,-49212,331426,-0.148485634802339
2012,"NORTH CAROLINA",12,247591,63317,310908,"MELVIN L WATT","JACK BROSCH","Democrat",0.796348115841342,184274,310908,0.592696231682684
2012,"NORTH CAROLINA",13,160115,210495,370610,"CHARLES MALONE","GEORGE HOLDING","Republican",0.567969024041445,-50380,370610,-0.13593804808289
2012,"OHIO",1,131490,201907,349716,"JEFF SINNARD","STEVE CHABOT","Republican",0.577345617586842,-70417,333397,-0.211210658764176
2012,"OHIO",2,137077,194296,331373,"WILLIAM R SMITH","BRAD WENSTRUP","Republican",0.586336243447716,-57219,331373,-0.172672486895432
2012,"OHIO",3,201897,77901,295652,"JOYCE BEATTY","CHRIS LONG","Democrat",0.682887313463126,123996,279798,0.443162567280681
2012,"OHIO",4,114214,182643,312998,"JIM SLONE","JIM JORDAN","Republican",0.583527690272781,-68429,296857,-0.230511660496468
2012,"OHIO",5,137806,201514,351878,"ANGELA ZIMMANN","ROBERT E LATTA","Republican",0.572681440726615,-63708,339320,-0.18775197453731
2012,"OHIO",6,144444,164536,308980,"CHARLIE WILSON","BILL JOHNSON","Republican",0.532513431290051,-20092,308980,-0.0650268625801023
2012,"OHIO",7,137708,178104,315812,"JOYCE R HEALY-ABRAMS","BOB GIBBS","Republican",0.563955771154991,-40396,315812,-0.127911542309982
2012,"OHIO",9,217771,68668,298164,"MARCY KAPTUR","SAMUEL J WURZELBACHER","Democrat",0.730373217423968,149103,286439,0.520540149909754
2012,"OHIO",10,131097,208201,349671,"SHAREN SWARTZ NEUHARDT","MICHAEL R TURNER","Republican",0.595419694512842,-77104,339298,-0.227245666051671
2012,"OHIO",12,134605,233869,368474,"JIM REESE","PATRICK J TIBERI","Republican",0.634696070821822,-99264,368474,-0.269392141643644
2012,"OHIO",13,235492,88120,323612,"TIM RYAN","MARISHA G AGANA","Democrat",0.727698602029591,147372,323612,0.455397204059182
2012,"OHIO",14,131637,183657,339894,"DALE VIRGIL BLANCHARD","DAVID P JOYCE","Republican",0.54033610478561,-52020,315294,-0.16498886753316
2012,"OHIO",15,128188,205274,333462,"PAT LANG","STEVE STIVERS","Republican",0.615584384427611,-77086,333462,-0.231168768855222
2012,"OHIO",16,170600,185165,355765,"BETTY SUTTON","JAMES B RENACCI","Republican",0.520469973156438,-14565,355765,-0.0409399463128751
2012,"OKLAHOMA",1,91421,181084,285312,"JOHN OLSON","JIM BRIDENSTINE","Republican",0.634687640197398,-89663,272505,-0.329032494816609
2012,"OKLAHOMA",2,96081,143701,250612,"ROB WALLACE","MARKWAYNE MULLIN","Republican",0.573400316026367,-47620,239782,-0.198597058995254
2012,"OKLAHOMA",3,53472,201744,268003,"TIMOTHY RAY MURRAY","FRANK D LUCAS","Republican",0.75276769289896,-148272,255216,-0.580966710551063
2012,"OKLAHOMA",4,71846,176740,260331,"DONNA MARIE BEBO","TOM COLE","Republican",0.678904932566617,-104894,248586,-0.421962620582012
2012,"OKLAHOMA",5,97504,153603,261677,"TOM GUILD","JAMES LANKFORD","Republican",0.586994653714312,-56099,251107,-0.22340675488935
2012,"OREGON",1,197845,109699,331980,"SUZANNE BONAMICI","DELINDA MORGAN","Democrat",0.595954575576842,88146,307544,0.286612647295997
2012,"OREGON",2,96741,228043,332255,"JOYCE B SEGERS","GREG WALDEN","Republican",0.686349340115273,-131302,324784,-0.404274841125179
2012,"OREGON",3,264979,70325,355875,"EARL BLUMENAUER","RONALD GREEN","Democrat",0.744584474885845,194654,335304,0.5805299071887
2012,"OREGON",4,212866,140549,360088,"PETER A DEFAZIO","ART ROBINSON","Democrat",0.591149941125503,72317,353415,0.204623459672057
2012,"OREGON",5,177229,139223,327970,"KURT SCHRADER","FRED THOMPSON","Democrat",0.540381742232521,38006,316452,0.120100362772237
2012,"PENNSYLVANIA",1,235394,41708,277102,"ROBERT A BRADY","JOHN FEATHERMAN","Democrat",0.849485027174109,193686,277102,0.698970054348218
2012,"PENNSYLVANIA",2,318176,33381,356386,"CHAKA FATTAH","ROBERT ALLEN MANSFIELD JR","Democrat",0.892784789525963,284795,351557,0.810096229061006
2012,"PENNSYLVANIA",3,123933,165826,302514,"MISSA EATON","MIKE KELLY","Republican",0.54815975458987,-41893,289759,-0.144578770633526
2012,"PENNSYLVANIA",4,104643,181603,303980,"HARRY PERKINSON","SCOTT PERRY","Republican",0.597417593262715,-76960,286246,-0.268859652187279
2012,"PENNSYLVANIA",5,104725,177740,282465,"CHARLES DUMAS","GLENN THOMPSON","Republican",0.629246101286885,-73015,282465,-0.25849220257377
2012,"PENNSYLVANIA",6,143803,191725,335528,"MANAN M TRIVEDI","JIM GERLACH","Republican",0.571412818006247,-47922,335528,-0.142825636012494
2012,"PENNSYLVANIA",7,143509,209942,353451,"GEORGE BADEY","PATRICK MEEHAN","Republican",0.593977665928233,-66433,353451,-0.187955331856467
2012,"PENNSYLVANIA",8,152859,199379,352238,"KATHY BOOCKVAR","MICHAEL G FITZPATRICK","Republican",0.56603489685951,-46520,352238,-0.13206979371902
2012,"PENNSYLVANIA",9,105128,169177,274305,"KAREN RAMSBURG","BILL SHUSTER","Republican",0.616747780754999,-64049,274305,-0.233495561509998
2012,"PENNSYLVANIA",10,94227,179563,273790,"PHILIP SCOLLO","TOM MARINO","Republican",0.655842068738814,-85336,273790,-0.311684137477629
2012,"PENNSYLVANIA",11,118231,166967,285198,"GENE STILP","LOU BARLETTA","Republican",0.585442394406693,-48736,285198,-0.170884788813386
2012,"PENNSYLVANIA",12,163589,175352,338941,"MARK S CRITZ","KEITH J ROTHFUS","Republican",0.51735257758725,-11763,338941,-0.0347051551744994
2012,"PENNSYLVANIA",13,209901,93918,303819,"ALLYSON Y SCHWARTZ","JOSEPH JAMES ROONEY","Democrat",0.69087515922309,115983,303819,0.38175031844618
2012,"PENNSYLVANIA",14,251932,75702,327634,"MICHAEL F DOYLE","HANS LESSMANN","Democrat",0.768943394153232,176230,327634,0.537886788306464
2012,"PENNSYLVANIA",15,128764,168960,297724,"RICK DAUGHERTY","CHARLES W DENT","Republican",0.567505474869342,-40196,297724,-0.135010949738684
2012,"PENNSYLVANIA",16,111185,156192,284781,"ARYANNA C STRADER","JOSEPH R PITTS","Republican",0.548463556206348,-45007,267377,-0.168327866645224
2012,"PENNSYLVANIA",17,161393,106208,267601,"MATTHEW A CARTWRIGHT","LAUREEN A CUMMINGS","Democrat",0.603110601230937,55185,267601,0.206221202461874
2012,"PENNSYLVANIA",18,122146,216727,338873,"LARRY MAGGI","TIM MURPHY","Republican",0.639552280647912,-94581,338873,-0.279104561295825
2012,"RHODE ISLAND",1,108612,83737,205115,"DAVID N CICILLINE","BRENDAN P DOHERTY","Democrat",0.529517587694708,24875,192349,0.129322221586803
2012,"RHODE ISLAND",2,124067,78189,222660,"JAMES R LANGEVIN","MICHAEL G RILEY","Democrat",0.55720380849726,45878,202256,0.226831342457084
2012,"SOUTH CAROLINA",1,98154,179908,290013,"BOBBIE G ROSE","TIM SCOTT","Republican",0.620344605241834,-81754,278062,-0.294013565319965
2012,"SOUTH CAROLINA",3,84735,169512,254763,"BRIAN RYAN B DOYLE","JEFF DUNCAN","Republican",0.665371345132535,-84777,254247,-0.333443462459734
2012,"SOUTH CAROLINA",4,84087,173201,266884,"DEB MORROW","TREY GOWDY","Republican",0.64897483550906,-89114,257288,-0.346358944062685
2012,"SOUTH CAROLINA",5,113904,154324,278003,"JOYCE KNOTT","MICK MULVANEY","Republican",0.555116311694478,-40420,268228,-0.15069269427502
2012,"SOUTH CAROLINA",7,114594,153068,275738,"GLORIA BROMELL TINUBU","TOM RICE","Republican",0.555121165744293,-38474,267662,-0.143740986766893
2012,"SOUTH DAKOTA",0,153789,207640,361429,"MATT VARILEK","KRISTI L NOEM","Republican",0.57449734249327,-53851,361429,-0.14899468498654
2012,"TENNESSEE",1,47663,182252,239672,"ALAN WOODRUFF","DAVID P ROE","Republican",0.760422577522614,-134589,229915,-0.585385903486071
2012,"TENNESSEE",2,54522,196894,264505,"TROY CHRISTOPHER GOODALE","JOHN J DUNCAN JR","Republican",0.744386684561729,-142372,251416,-0.566280586756611
2012,"TENNESSEE",3,91094,157830,256909,"MARY M HEADRICK","CHARLES J ""CHUCK"" FLEISCHMANN","Republican",0.614342043291593,-66736,248924,-0.268097893332905
2012,"TENNESSEE",4,102022,128568,230590,"ERIC STEWART","SCOTT DESJARLAIS","Republican",0.557561039073681,-26546,230590,-0.115122078147361
2012,"TENNESSEE",5,171621,86240,263095,"JIM COOPER","BRAD STAATS","Democrat",0.652315703453125,85381,257861,0.331112498594204
2012,"TENNESSEE",7,61679,182730,257306,"CREDO AMOUZOUVIK","MARSHA BLACKBURN","Republican",0.710166105726256,-121051,244409,-0.495280452029181
2012,"TENNESSEE",8,79490,190923,279422,"TIMOTHY D DIXON","STEPHEN LEE FINCHER","Republican",0.68327833885664,-111433,270413,-0.412084478187069
2012,"TENNESSEE",9,188422,59742,250987,"STEVE COHEN","GEORGE S FLINN JR","Democrat",0.750724141090973,128680,248164,0.518528070147161
2012,"TEXAS",1,67222,178322,249658,"SHIRLEY J MCKELLAR","LOUIE GOHMERT","Republican",0.714265114676878,-111100,245544,-0.452464731371974
2012,"TEXAS",2,80512,159664,246328,"JIM DOUGHERTY","TED POE","Republican",0.648176415186256,-79152,240176,-0.32955832389581
2012,"TEXAS",4,60214,182679,250343,"VALINDA HATHCOX","RALPH M HALL","Republican",0.729714831251523,-122465,242893,-0.504193204415113
2012,"TEXAS",5,69178,134091,208230,"LINDA S MROSKO","JEB HENSARLING","Republican",0.643956202276329,-64913,203269,-0.319345301054268
2012,"TEXAS",6,98053,145019,249936,"KENNETH SANDERS","JOE BARTON","Republican",0.580224537481595,-46966,243072,-0.193218470247499
2012,"TEXAS",7,85553,142793,234837,"JAMES CARGAS","JOHN ABNEY CULBERSON","Republican",0.60805154213348,-57240,228346,-0.250672225482382
2012,"TEXAS",8,51051,194043,251052,"NEIL BURNS","KEVIN BRADY","Republican",0.772919554514603,-142992,245094,-0.583416974711743
2012,"TEXAS",9,144075,36139,183566,"AL GREEN","STEVE MUELLER","Democrat",0.784867568068161,107936,180214,0.5989323803922
2012,"TEXAS",10,95710,159783,264019,"TAWANA W CADIEN","MICHAEL T MCCAUL","Republican",0.605195080657074,-64073,255493,-0.250781821811165
2012,"TEXAS",11,41970,177742,226023,"JIM RILEY","K MICHAEL CONAWAY","Republican",0.786388995810161,-135772,219712,-0.617954413049811
2012,"TEXAS",12,66080,175649,247712,"DAVE ROBINSON","KAY GRANGER","Republican",0.709085550962408,-109569,241729,-0.453272052587815
2012,"TEXAS",14,109697,131460,245839,"NICK LAMPSON","RANDY WEBER","Republican",0.534740216157729,-21763,241157,-0.0902441148297582
2012,"TEXAS",15,89296,54056,146661,"RUBEN HINOJOSA","DALE A BRUEGGEMANN","Democrat",0.608859887768391,35240,143352,0.24582845024834
2012,"TEXAS",16,101403,51043,155005,"BETO O'ROURKE","BARBARA CARRASCO","Democrat",0.654191800264508,50360,152446,0.330346483344922
2012,"TEXAS",18,146223,44015,194932,"SHEILA JACKSON LEE","SEAN SEIBERT","Democrat",0.750123119857181,102208,190238,0.537263848442477
2012,"TEXAS",20,119032,62376,186177,"JOAQUIN CASTRO","DAVID ROSA","Democrat",0.639348576891882,56656,181408,0.312312577174105
2012,"TEXAS",21,109326,187015,308865,"CANDACE E DUVAL","LAMAR SMITH","Republican",0.605491072151264,-77689,296341,-0.262160821486058
2012,"TEXAS",22,80203,160668,250911,"KESHA ROGERS","PETE OLSON","Republican",0.640338606119301,-80465,240871,-0.33405847943505
2012,"TEXAS",23,96676,87547,192169,"PETE P GALLEGO","FRANCISCO ""QUICO"" CANSECO","Democrat",0.503078019867929,9129,184223,0.0495540730527676
2012,"TEXAS",24,87645,148586,243489,"TIM RUSK","KENNY MARCHANT","Republican",0.61023701276033,-60941,236231,-0.257972069711427
2012,"TEXAS",25,98827,154245,263932,"ELAINE M HENDERSON","ROGER WILLIAMS","Republican",0.58441189397269,-55418,253072,-0.218981159511918
2012,"TEXAS",26,74237,176642,258723,"DAVID SANCHEZ","MICHAEL C BURGESS","Republican",0.682745639158482,-102405,250879,-0.408184822165267
2012,"TEXAS",27,83395,120684,212651,"ROSE MEZA HARRISON","BLAKE FARENTHOLD","Republican",0.567521431829618,-37289,204079,-0.182718457068096
2012,"TEXAS",28,112456,49309,165645,"HENRY CUELLAR","WILLIAM R HAYWARD","Democrat",0.678897642548824,63147,161765,0.390362562977158
2012,"TEXAS",30,171059,41222,217014,"EDDIE BERNICE JOHNSON","TRAVIS WASHINGTON JR","Democrat",0.788239468421392,129837,212281,0.611627983663163
2012,"TEXAS",31,82977,145348,237187,"STEPHEN M WYMAN","JOHN R CARTER","Republican",0.612799183766395,-62371,228325,-0.27316763385525
2012,"TEXAS",32,99288,146653,251636,"KATHERINE SAVERS MCGOVERN","PETE SESSIONS","Republican",0.582798168783481,-47365,245941,-0.192586839933155
2012,"TEXAS",33,85114,30252,117375,"MARC VEASEY","CHUCK BRADLEY","Democrat",0.725145899893504,54862,115366,0.475547388311981
2012,"TEXAS",34,89606,52448,144778,"FILEMON VELA","JESSICA PUENTE BRADSHAW","Democrat",0.61892000165771,37158,142054,0.261576583552733
2012,"TEXAS",35,105626,52894,165179,"LLOYD DOGGETT","SUSAN NARVAIZ","Democrat",0.639463854364054,52732,158520,0.332652031289427
2012,"TEXAS",36,62143,165405,233832,"MAX MARTIN","STEVE STOCKMAN","Republican",0.707366827465873,-103262,227548,-0.453803153620335
2012,"UTAH",1,60611,175487,245528,"DONNA M MCALEER","ROB BISHOP","Republican",0.71473314652504,-114876,236098,-0.486560665486366
2012,"UTAH",2,83176,154523,248545,"JAY SEEGMILLER","CHRIS STEWART","Republican",0.621710354261804,-71347,237699,-0.300156921148175
2012,"UTAH",3,60719,198828,259547,"SOREN D SIMONSEN","JASON CHAFFETZ","Republican",0.766057785295149,-138109,259547,-0.532115570590298
2012,"UTAH",4,119803,119035,245277,"JIM MATHESON","MIA B LOVE","Democrat",0.488439600940977,768,238838,0.00321556871184652
2012,"VERMONT",0,208600,67543,289931,"PETER WELCH","MARK DONKA","Democrat",0.719481531812742,141057,276143,0.510811427412609
2012,"VIRGINIA",1,147036,200845,356806,"ADAM M COOK","ROBERT J WITTMAN","Republican",0.562896924379074,-53809,347881,-0.154676455454595
2012,"VIRGINIA",2,142548,166231,309222,"PAUL O HIRSCHBIEL JR","E SCOTT RIGELL","Republican",0.537578180077743,-23683,308779,-0.0766988687702208
2012,"VIRGINIA",3,259199,58931,318936,"ROBERT C ""BOBBY"" SCOTT","DEAN J LONGO","Democrat",0.812699099505857,200268,318130,0.62951623550121
2012,"VIRGINIA",4,150190,199292,350046,"ELLA P WARD","J RANDY FORBES","Republican",0.569330887940442,-49102,349482,-0.140499367635529
2012,"VIRGINIA",5,149214,193009,348111,"JOHN WADE DOUGLASS","ROBERT HURT","Republican",0.554446713835529,-43795,342223,-0.127972111751694
2012,"VIRGINIA",6,111949,211278,323893,"ANDY B SCHMOOKLER","BOB GOODLATTE","Republican",0.65230801530135,-99329,323227,-0.307304154665297
2012,"VIRGINIA",7,158012,222983,381909,"E WAYNE POWELL","ERIC CANTOR","Republican",0.583864218963156,-64971,380995,-0.170529796978963
2012,"VIRGINIA",8,226847,107370,351187,"JAMES P MORAN","J PATRICK MURRAY","Democrat",0.645943614085943,119477,334217,0.357483311740576
2012,"VIRGINIA",9,116400,184882,301658,"ANTHONY J FLACCAVENTO","H MORGAN GRIFFITH","Republican",0.612886116065213,-68482,301282,-0.22730199613651
2012,"VIRGINIA",10,142024,214038,366444,"KRISTIN A CABRAL","FRANK R WOLF","Republican",0.58409470478436,-72014,356062,-0.202251293314086
2012,"VIRGINIA",11,202606,117902,332243,"GERALD E CONNOLLY","CHRIS S PERKINS","Democrat",0.609812697332976,84704,320508,0.26428045477804
2012,"WASHINGTON",1,177025,151187,328212,"SUZAN DELBENE","JOHN KOSTER","Democrat",0.539361753988276,25838,328212,0.0787235079765517
2012,"WASHINGTON",2,184826,117465,302291,"RICK LARSEN","DAN MATTHEWS","Democrat",0.61141747521428,67361,302291,0.222834950428561
2012,"WASHINGTON",3,116438,177446,293884,"JON T HAUGEN","JAIME HERRERA BEUTLER","Republican",0.603796055586558,-61008,293884,-0.207592111173116
2012,"WASHINGTON",4,78940,154749,233689,"MARY BAECHLER","DOC HASTINGS","Republican",0.662200617059425,-75809,233689,-0.32440123411885
2012,"WASHINGTON",5,117512,191066,308578,"RICH COWAN","CATHY MCMORRIS RODGERS","Republican",0.619182184083117,-73554,308578,-0.238364368166233
2012,"WASHINGTON",6,186661,129725,316386,"DEREK KILMER","BILL DRISCOLL","Democrat",0.589978696908207,56936,316386,0.179957393816414
2012,"WASHINGTON",7,298368,76212,374580,"JIM MCDERMOTT","RON BEMIS","Democrat",0.796540124939933,222156,374580,0.593080249879865
2012,"WASHINGTON",8,121886,180204,302090,"KAREN PORTERFIELD","DAVID G REICHERT","Republican",0.596524214638022,-58318,302090,-0.193048429276044
2012,"WASHINGTON",9,192034,76105,268139,"ADAM SMITH","JIM POSTMA","Democrat",0.71617332801271,115929,268139,0.43234665602542
2012,"WASHINGTON",10,163036,115381,278417,"DENNY HECK","RICHARD ""DICK"" MURI","Democrat",0.585582058566826,47655,278417,0.171164117133652
2012,"WEST VIRGINIA",1,80342,133809,214151,"SUE THORN","DAVID B MCKINLEY","Republican",0.624834812818992,-53467,214151,-0.249669625637984
2012,"WEST VIRGINIA",2,68560,158206,226766,"HOWARD SWINT","SHELLEY MOORE CAPITO","Republican",0.69766190698782,-89646,226766,-0.39532381397564
2012,"WEST VIRGINIA",3,108199,92238,200437,"NICK J RAHALL II","RICK SNUFFER","Democrat",0.53981550312567,15961,200437,0.0796310062513408
2012,"WISCONSIN",1,158414,200423,365058,"ROB ZERBAN","PAUL RYAN","Republican",0.549016868552394,-42009,358837,-0.11706986737711
2012,"WISCONSIN",2,265422,124683,390898,"MARK POCAN","CHAD LEE","Democrat",0.67900577644296,140739,390105,0.360772099819279
2012,"WISCONSIN",3,217712,121713,339764,"RON KIND","RAY BOLAND","Democrat",0.640774184433901,95999,339425,0.282828312587464
2012,"WISCONSIN",4,235257,80787,325788,"GWEN MOORE","DAN SEBRING","Democrat",0.722116836715901,154470,316044,0.488761058586779
2012,"WISCONSIN",5,118478,250335,369664,"DAVE HEASTER","F JAMES SENSENBRENNER JR","Republican",0.677196048303324,-131857,368813,-0.357517224175937
2012,"WISCONSIN",6,135921,223460,359745,"JOE KALLAS","THOMAS E PETRI","Republican",0.621162212122476,-87539,359381,-0.243582715836396
2012,"WISCONSIN",7,157524,201720,359669,"PAT KREITLOW","SEAN P DUFFY","Republican",0.560849002833161,-44196,359244,-0.123025019207001
2012,"WISCONSIN",8,156287,198874,355464,"JAMIE WALL","REID J RIBBLE","Republican",0.559477190376522,-42587,355161,-0.119908999017347
2012,"WYOMING",0,57573,166452,250700,"CHRIS HENRICHSEN","CYNTHIA M LUMMIS","Republican",0.663948942959713,-108879,224025,-0.486012721794443
2014,"ALABAMA",1,48278,103758,152234,"BURTON R LEFLORE","BRADLEY BYRNE","Republican",0.681569163261821,-55480,152036,-0.364913573101108
2014,"ALABAMA",2,54692,113103,167952,"ERICK WRIGHT","MARTHA ROBY","Republican",0.673424549871392,-58411,167795,-0.348109300038738
2014,"ALABAMA",3,52816,103558,156620,"JESSE T SMITH","MIKE ROGERS","Republican",0.661205465457796,-50742,156374,-0.324491283717242
2014,"ALABAMA",6,42291,135945,178449,"MARK LESTER","GARY PALMER","Republican",0.761814299884001,-93654,178236,-0.525449404160776
2014,"ALASKA",0,114602,142572,279741,"FORREST DUNBAR","DON YOUNG","Republican",0.509657147146825,-27970,257174,-0.108759050292798
2014,"ARIZONA",1,97391,87723,185114,"ANN KIRKPATRICK","ANDY TOBIN","Democrat",0.526113638082479,9668,185114,0.0522272761649578
2014,"ARIZONA",2,109543,109704,219351,"RON BARBER","MARTHA MCSALLY","Republican",0.500129928744341,-161,219247,-0.000734331598607963
2014,"ARIZONA",3,58192,46185,104428,"RAUL M GRIJALVA","GABBY SAUCEDO","Democrat",0.557245183284177,12007,104377,0.115034921486534
2014,"ARIZONA",4,45179,122560,175179,"MIKE WEISSER","PAUL A GOSAR","Republican",0.699627238424697,-77381,167739,-0.461317880755221
2014,"ARIZONA",5,54596,124867,179463,"JAMES WOODS","MATT SALMON","Republican",0.695781303109833,-70271,179463,-0.391562606219666
2014,"ARIZONA",6,70198,129578,199776,"W JOHN WILLIAMSON","DAVID SCHWEIKERT","Republican",0.648616450424475,-59380,199776,-0.297232900848951
2014,"ARIZONA",9,88609,67841,162062,"KYRSTEN SINEMA","WENDY ROGERS","Democrat",0.546759882020461,20768,156450,0.132745286033877
2014,"ARKANSAS",1,63555,124139,196256,"JACKIE MCPHERSON","ERIC A ""RICK"" CRAWFORD","Republican",0.632536075330181,-60584,187694,-0.322780696239624
2014,"ARKANSAS",2,103477,123073,237330,"PATRICK HENRY HAYS","FRENCH HILL","Republican",0.518573294568744,-19596,226550,-0.086497461928934
2014,"ARKANSAS",4,87742,110789,206131,"JAMES LEE WITT","BRUCE WESTERMAN","Republican",0.537468891142041,-23047,198531,-0.116087663891281
2014,"CALIFORNIA",1,84320,132052,216372,"HEIDI HALL","DOUG LAMALFA","Republican",0.610300778289243,-47732,216372,-0.220601556578485
2014,"CALIFORNIA",2,163124,54400,217524,"JARED HUFFMAN","DALE K MENSING","Democrat",0.749912653316416,108724,217524,0.499825306632831
2014,"CALIFORNIA",3,79224,71036,150260,"JOHN GARAMENDI","DAN LOGUE","Democrat",0.527246106748303,8188,150260,0.0544922134966059
2014,"CALIFORNIA",6,97008,36448,133456,"DORIS O MATSUI","JOSEPH MCCRAY SR","Democrat",0.726891260040763,60560,133456,0.453782520081525
2014,"CALIFORNIA",7,92521,91066,183587,"AMI BERA","DOUG OSE","Democrat",0.503962698883908,1455,183587,0.0079253977678158
2014,"CALIFORNIA",8,37056,77480,114536,"BOB CONAWAY","PAUL COOK","Republican",0.676468533910735,-40424,114536,-0.352937067821471
2014,"CALIFORNIA",9,63475,57729,121204,"JERRY MCNERNEY","ANTONIO C ""TONY"" AMADOR","Democrat",0.523703838157156,5746,121204,0.0474076763143131
2014,"CALIFORNIA",10,55123,70582,125705,"MICHAEL EGGMAN","JEFF DENHEM","Republican",0.561489200906885,-15459,125705,-0.12297840181377
2014,"CALIFORNIA",11,117502,57160,174662,"MARK DESAULNIER","TUE PHAN","Democrat",0.672739347997847,60342,174662,0.345478695995695
2014,"CALIFORNIA",12,160067,32197,192264,"NANCY PELOSI","JOHN DENNIS","Democrat",0.832537552531935,127870,192264,0.66507510506387
2014,"CALIFORNIA",13,168491,21940,190431,"BARBARA LEE","DAKIN SUNDEEN","Democrat",0.884787665873729,146551,190431,0.769575331747457
2014,"CALIFORNIA",14,114389,34757,149146,"JACKIE SPEIER","ROBIN CHEW","Democrat",0.766959891649793,79632,149146,0.533919783299586
2014,"CALIFORNIA",15,99756,43150,142906,"ERIC SWALWELL","HUGH BUSSELL","Democrat",0.698053265783102,56606,142906,0.396106531566204
2014,"CALIFORNIA",16,46277,44943,91220,"JIM COSTA","JOHNNY TACHERRA","Democrat",0.507311992983995,1334,91220,0.0146239859679895
2014,"CALIFORNIA",18,133060,63326,196386,"ANNA G ESHOO","RICHARD B FOX","Democrat",0.677543205727496,69734,196386,0.355086411454992
2014,"CALIFORNIA",21,33470,45907,79377,"AMANDA RENTERIA","DAVID G VALADAO","Republican",0.578341333131764,-12437,79377,-0.156682666263527
2014,"CALIFORNIA",22,37289,96053,133342,"SUZANNA ""SAM"" AGUILERA-MARRERO","DEVIN NUNES","Republican",0.720350677205982,-58764,133342,-0.440701354411963
2014,"CALIFORNIA",23,33726,100317,134043,"RAUL GARCIA","KEVIN MCCARTHY","Republican",0.748394172019427,-66591,134043,-0.496788344038853
2014,"CALIFORNIA",24,103228,95566,198794,"LOIS CAPPS","CHRIS MITCHUM","Democrat",0.519271205368371,7662,198794,0.0385424107367426
2014,"CALIFORNIA",26,87176,82653,169829,"JULIA BROWNLEY","JEFF GORELL","Democrat",0.513316335843702,4523,169829,0.0266326716874032
2014,"CALIFORNIA",27,75728,51852,127580,"JUDY CHU","JACK ORSWELL","Democrat",0.593572660291582,23876,127580,0.187145320583163
2014,"CALIFORNIA",29,50096,17045,67141,"TONY CARDENAS","WILLIAM O'CALLAGHAN LEADER","Democrat",0.746131275971463,33051,67141,0.492262551942926
2014,"CALIFORNIA",30,86568,45315,131883,"BRAD SHERMAN","MARK S REED","Democrat",0.656399990901026,41253,131883,0.312799981802052
2014,"CALIFORNIA",31,51622,48162,99784,"PETE AGUILAR","PAUL CHABOT","Democrat",0.517337448889602,3460,99784,0.0346748977792031
2014,"CALIFORNIA",32,50353,34053,84406,"GRACE F NAPOLITANO","ARTURO ENRIQUE ALAS","Democrat",0.596557116792645,16300,84406,0.19311423358529
2014,"CALIFORNIA",33,108331,74700,183031,"TED LIEU","ELAN CARR","Democrat",0.591872415055373,33631,183031,0.183744830110746
2014,"CALIFORNIA",36,72682,61457,134139,"RAUL RUIZ","BRIAN NESTANDE","Democrat",0.541840926203416,11225,134139,0.0836818524068317
2014,"CALIFORNIA",37,96787,18051,114838,"KAREN BASS","R ADAM KING","Democrat",0.84281335446455,78736,114838,0.6856267089291
2014,"CALIFORNIA",38,58192,40288,98480,"LINDA T SANCHEZ","BENJAMIN CAMPOS","Democrat",0.590901705930138,17904,98480,0.181803411860276
2014,"CALIFORNIA",39,41906,91319,133225,"PETER O ANDERSON","EDWARD R ROYCE","Republican",0.685449427659974,-49413,133225,-0.370898855319947
2014,"CALIFORNIA",41,46948,35936,82884,"MARK TAKANO","STEVE ADAMS","Democrat",0.56643019159307,11012,82884,0.13286038318614
2014,"CALIFORNIA",42,38850,74540,113390,"TIM SHERIDAN","KEN CALVERT","Republican",0.657377193756063,-35690,113390,-0.314754387512126
2014,"CALIFORNIA",43,69681,28521,98202,"MAXINE WATERS","JOHN WOOD JR","Democrat",0.709568033237612,41160,98202,0.419136066475225
2014,"CALIFORNIA",45,56819,106083,162902,"DREW E LEAVENS","MIMI WALTERS","Republican",0.651207474432481,-49264,162902,-0.302414948864962
2014,"CALIFORNIA",46,49738,33577,83315,"LORETTA SANCHEZ","ADAM NICK","Democrat",0.596987337214187,16161,83315,0.193974674428374
2014,"CALIFORNIA",47,69091,54309,123400,"ALAN S LOWENTHAL","ANDY WHALLON","Democrat",0.559894651539708,14782,123400,0.119789303079417
2014,"CALIFORNIA",48,62713,112082,174795,"SUZANNE JOYCE SAVARY","DANA ROHRACHER","Republican",0.641219714522727,-49369,174795,-0.282439429045453
2014,"CALIFORNIA",49,64981,98161,163142,"DAVE PEISER","DARRELL E ISSA","Republican",0.601690551789239,-33180,163142,-0.203381103578478
2014,"CALIFORNIA",50,45302,111997,157299,"JAMES H KIMBER","DUNCAN HUNTER","Republican",0.712000712019784,-66695,157299,-0.424001424039568
2014,"CALIFORNIA",51,56373,25577,81950,"JUAN VARGAS","STEPHEN MEADE","Democrat",0.687895057962172,30796,81950,0.375790115924344
2014,"CALIFORNIA",52,98826,92746,191572,"SCOTT H PETERS","CARL DEMAIO","Democrat",0.515868707326749,6080,191572,0.0317374146534984
2014,"CALIFORNIA",53,87104,60940,148044,"SUSAN A DAVIS","LARRY A WILSKE","Democrat",0.588365621031585,26164,148044,0.17673124206317
2014,"COLORADO",1,183281,80682,278494,"DIANA DEGETTE","MARTIN WALSH","Democrat",0.658114717013652,102599,263963,0.38868705083667
2014,"COLORADO",2,196300,149645,345945,"JARED POLIS","GEORGE LEING","Democrat",0.567431239069794,46655,345945,0.134862478139589
2014,"COLORADO",3,100364,163011,281141,"ABEL J TAPIA","SCOTT R TIPTON","Republican",0.579819378888174,-62647,263375,-0.237862363550071
2014,"COLORADO",4,83727,185292,286507,"VIC MEYERS","KEN BUCK","Republican",0.646727654123634,-101565,269019,-0.377538389481784
2014,"COLORADO",5,105673,157182,262855,"IRV HALTER","DOUG LAMBORN","Republican",0.597979874835936,-51509,262855,-0.195959749671872
2014,"COLORADO",6,118847,143467,276440,"ANDREW ROMANOFF","MIKE COFFMAN","Republican",0.51898061062075,-24620,262314,-0.0938569805652767
2014,"COLORADO",7,148225,120918,269143,"ED PERLMUTTER","DON YTTERBERG","Democrat",0.550729537829332,27307,269143,0.101459075658665
2014,"CONNECTICUT",1,127430,78609,217881,"JOHN B LARSON","MATTHEW M COREY","Democrat",0.584860543140522,48821,206039,0.236950286110882
2014,"CONNECTICUT",2,131294,80837,227936,"JOE COURTNEY","LORI HOPKINS-CAVANAGH","Democrat",0.576012564930507,50457,212131,0.23785773885005
2014,"CONNECTICUT",3,130009,69454,209939,"ROSA L DELAURO","JAMES E BROWN","Democrat",0.619270359485374,60555,199463,0.303590139524624
2014,"CONNECTICUT",4,101401,88209,198800,"JAMES A HIMES","DAN DEBICELLA","Democrat",0.510065392354125,13192,189610,0.0695743895364169
2014,"CONNECTICUT",5,106256,92404,213301,"ELIZABETH H ESTY","MARK GREENBERG","Democrat",0.498150500935298,13852,198660,0.0697271720527534
2014,"DELAWARE",0,137251,85146,231617,"JOHN C CARNEY JR","ROSE IZZO","Democrat",0.592577401486074,52105,222397,0.234288232305292
2014,"FLORIDA",1,54976,165086,235343,"JIM BRYAN","JEFF MILLER","Republican",0.701469769655354,-110110,220062,-0.500358989739255
2014,"FLORIDA",2,126096,123262,249780,"GWEN GRAHAM","STEVE SOUTHERLAND II","Democrat",0.504828248858996,2834,249358,0.011365185797127
2014,"FLORIDA",3,73910,148691,228809,"MARIHELEN WHEELER","TED S YOHO","Republican",0.649847689557666,-74781,222601,-0.335941887053517
2014,"FLORIDA",5,112340,59237,171577,"CORRINE BROWN","GLO SMITH","Democrat",0.654749762497304,53103,171577,0.309499524994609
2014,"FLORIDA",6,99563,166254,265817,"DAVID COX","RON DESANTIS","Republican",0.625445325167314,-66691,265817,-0.250890650334629
2014,"FLORIDA",7,73011,144474,227164,"WES NEUMAN","JOHN L MICA","Republican",0.635989857547851,-71463,217485,-0.328588178495069
2014,"FLORIDA",8,93724,180728,274513,"GABRIEL ROTHBLATT","BILL POSEY","Republican",0.658358620538918,-87004,274452,-0.317009896083833
2014,"FLORIDA",9,93850,74963,173878,"ALAN GRAYSON","CAROL PLATT","Democrat",0.539746258871163,18887,168813,0.111881193983876
2014,"FLORIDA",10,89426,143128,232574,"MICHAEL MCKENNA","DANIEL WEBSTER","Republican",0.615408429145132,-53702,232554,-0.230922710424246
2014,"FLORIDA",11,90786,181508,272294,"DAVE KOLLER","RICHARD B NUGENT","Republican",0.666588319977671,-90722,272294,-0.333176639955342
2014,"FLORIDA",15,84832,128750,213582,"ALAN M COHN","DENNIS A ROSS","Republican",0.602812971130526,-43918,213582,-0.205625942261052
2014,"FLORIDA",16,105483,169126,274829,"HENRY LAWRENCE","VERN BUCHANAN","Republican",0.615386294750554,-63643,274609,-0.231758609513891
2014,"FLORIDA",17,82263,141493,223756,"WILL BRONSON","THOMAS J ROONEY","Republican",0.632353992742094,-59230,223756,-0.264707985484188
2014,"FLORIDA",18,151478,101896,253374,"PATRICK MURPHY","CARL J DOMINO","Democrat",0.597843504069084,49582,253374,0.195687008138167
2014,"FLORIDA",19,80824,159354,246861,"APRIL FREEMAN","CURT CLAWSON","Republican",0.645521163731817,-78530,240178,-0.326965833673359
2014,"FLORIDA",20,128498,28968,157466,"ALCEE L HASTINGS","JAY BONNER","Democrat",0.816036477715824,99530,157466,0.632072955431649
2014,"FLORIDA",22,125404,90685,216096,"LOIS FRANKEL","PAUL SPAIN","Democrat",0.580316155782615,34719,216089,0.160669909157801
2014,"FLORIDA",23,103269,61519,164788,"DEBBIE WASSERMAN SCHULTZ","JOSEPH ""JOE"" KAUFMAN","Democrat",0.626677913440299,41750,164788,0.253355826880598
2014,"FLORIDA",24,129192,15239,149918,"FREDERICA S WILSON","DUFIRSTON JULIO NEREE","Democrat",0.861751090596193,113953,144431,0.788978820336354
2014,"FLORIDA",26,78306,83031,161337,"JOE GARCIA","CARLOS CURBELO","Republican",0.514643262239908,-4725,161337,-0.0292865244798155
2014,"GEORGIA",1,61175,95337,156512,"BRIAN CORWIN REESE","E L ""BUDDY"" CARTER","Republican",0.609135401758332,-34162,156512,-0.218270803516663
2014,"GEORGIA",2,96363,66537,162900,"SANFORD D BISHOP JR","GREGORY P ""GREG"" DUKE","Democrat",0.591546961325967,29826,162900,0.183093922651934
2014,"GEORGIA",6,71486,139018,210504,"ROBERT G MONTIGEL","TOM PRICE","Republican",0.660405502983316,-67532,210504,-0.320811005966632
2014,"GEORGIA",7,60112,113557,173669,"THOMAS D WRIGHT","ROB WOODALL","Republican",0.653870293489339,-53445,173669,-0.307740586978678
2014,"GEORGIA",9,34988,146059,181047,"DAVID D VOGEL","DOUG COLLINS","Republican",0.806746314492922,-111071,181047,-0.613492628985843
2014,"GEORGIA",10,65777,130703,196480,"I K ""KENNETH"" DIOUS","JODY B HICE","Republican",0.665222923452769,-64926,196480,-0.330445846905537
2014,"GEORGIA",12,75478,91336,166814,"JOHN BARROW","R W ""RICK"" ALLEN","Republican",0.547531981728152,-15858,166814,-0.0950639634563046
2014,"HAWAII",1,93390,86454,182268,"MARK TAKAI","CHARLES DJOU","Democrat",0.512377378365923,6936,179844,0.0385667578568092
2014,"HAWAII",2,142010,33630,187435,"TULSI GABBARD","KAWIKA CROWLEY","Democrat",0.757649318430389,108380,175640,0.617057617854703
2014,"IDAHO",1,77277,143580,220864,"SHIRLEY G RINGO","RAUL R LABRADOR","Republican",0.650083309185743,-66303,220857,-0.300207826783847
2014,"IDAHO",2,82801,131492,214293,"RICHARD STALLINGS","MICHAEL K SIMPSON","Republican",0.613608470645331,-48691,214293,-0.227216941290663
2014,"ILLINOIS",1,162268,59749,222017,"BOBBY L RUSH","JIMMY LEE TILLMAN","Democrat",0.730880968574478,102519,222017,0.461761937148957
2014,"ILLINOIS",2,160337,43799,204266,"ROBIN L KELLY","ERIC M WALLACE","Democrat",0.784942183231669,116538,204136,0.570884116471372
2014,"ILLINOIS",3,116764,64091,180855,"DANIEL LIPINSKI","SHARON M BRANNIGAN","Democrat",0.645622183517182,52673,180855,0.291244367034365
2014,"ILLINOIS",4,79666,22278,101944,"LUIS V GUTIERREZ","HECTOR CONCEPCION","Democrat",0.78146825708232,57388,101944,0.562936514164639
2014,"ILLINOIS",5,116364,56350,184019,"MIKE QUIGLEY","VINCE KOLBER","Democrat",0.632347746700069,60014,172714,0.347476174484987
2014,"ILLINOIS",6,78465,160287,238752,"MICHAEL MASON","PETER J ROSKAM","Republican",0.671353538399678,-81822,238752,-0.342707076799357
2014,"ILLINOIS",7,155110,27168,182278,"DANNY K DAVIS","ROBERT L BUMPERS","Democrat",0.850952940014703,127942,182278,0.701905880029406
2014,"ILLINOIS",8,84178,66878,151056,"TAMMY DUCKWORTH","LARRY KAIFESH","Democrat",0.557263531405571,17300,151056,0.114527062811143
2014,"ILLINOIS",9,141000,72384,213450,"JANICE D SCHAKOWSKY","SUSANNE ATANUS","Democrat",0.660576247364722,68616,213384,0.321561129231807
2014,"ILLINOIS",10,91136,95992,187128,"BRADLEY S SCHNEIDER","ROBERT DOLD","Republican",0.512975075883887,-4856,187128,-0.0259501517677739
2014,"ILLINOIS",11,93436,81335,174772,"BILL FOSTER","DARLENE SENGER","Democrat",0.53461652896345,12101,174771,0.069239175835808
2014,"ILLINOIS",12,87860,110038,209738,"WILLIAM L ENYART","MIKE BOST","Republican",0.524645033327294,-22178,197898,-0.112067832924032
2014,"ILLINOIS",13,86935,123337,210272,"ANN E CALLIS","RODNEY DAVIS","Republican",0.58655931365089,-36402,210272,-0.173118627301781
2014,"ILLINOIS",14,76861,145369,222230,"DENNIS ANDERSON","RANDY HULTGREN","Republican",0.654137605183819,-68508,222230,-0.308275210367637
2014,"ILLINOIS",15,55652,166274,221926,"ERIC THORSLAND","JOHN SHIMKUS","Republican",0.749231725890612,-110622,221926,-0.498463451781224
2014,"ILLINOIS",16,63810,153388,217198,"RANDALL WAYNE OLSEN","ADAM KINZINGER","Republican",0.706212764390096,-89578,217198,-0.412425528780191
2014,"ILLINOIS",17,110560,88785,199361,"CHERI BUSTOS","BOBBY SCHILLING","Democrat",0.554571857083381,21775,199345,0.109232737214377
2014,"ILLINOIS",18,62377,184363,246740,"DARREL MILLER","AARON SCHOCK","Republican",0.747195428386155,-121986,246740,-0.494390856772311
2014,"INDIANA",1,86579,51000,142293,"PETER J VISCLOSKY","MARK LEYVA","Democrat",0.608455791922301,35579,137579,0.258607781710872
2014,"INDIANA",2,55590,85583,145200,"JOE BOCK","JACKIE WALORSKI","Republican",0.589414600550964,-29993,141173,-0.212455639534472
2014,"INDIANA",3,39771,97892,148793,"JUSTIN KUHNLE","MARLIN A STUTZMAN","Republican",0.657907294025929,-58121,137663,-0.422197685652644
2014,"INDIANA",4,47056,94998,142054,"JOHN DALE","TODD ROKITA","Republican",0.668745688259394,-47942,142054,-0.337491376518789
2014,"INDIANA",5,49756,105277,161440,"SHAWN A DENNEY","SUSAN W BROOKS","Republican",0.652112239841427,-55521,155033,-0.358123754297472
2014,"INDIANA",6,45509,102187,155071,"SUSAN HALL HEITZMAN","LUKE MESSER","Republican",0.658969117372042,-56678,147696,-0.383747697974217
2014,"INDIANA",7,61443,46887,112261,"ANDRE CARSON","CATHERINE ""CAT"" PING","Democrat",0.547322756789981,14556,108330,0.134367211298809
2014,"INDIANA",8,61384,103344,171315,"TOM SPANGLER","LARRY BUCSHON","Republican",0.603239646265651,-41960,164728,-0.254722937205575
2014,"INDIANA",9,55016,101594,163387,"BILL BAILEY","TODD C YOUNG","Republican",0.62179977599197,-46578,156610,-0.297413958240215
2014,"IOWA",1,141145,147762,289306,"PAT MURPHY","ROD BLUM","Republican",0.510746406918626,-6617,288907,-0.0229035641227108
2014,"IOWA",2,143431,129455,273329,"DAVID LOEBSACK","MARIANNETTE MILLER-MEEKS","Democrat",0.524755880276151,13976,272886,0.0512155258972611
2014,"IOWA",3,119109,148814,282066,"STACI APPEL","DAVID YOUNG","Republican",0.52758574234399,-29705,267923,-0.110871407083378
2014,"IOWA",4,105504,169834,275633,"JIM MOWRER","STEVE KING","Republican",0.616159893771791,-64330,275338,-0.233640107794783
2014,"KANSAS",1,65397,138764,204161,"JAMES E SHEROW","TIM HUELSKAMP","Republican",0.679679272730835,-73367,204161,-0.35935854546167
2014,"KANSAS",2,87153,128742,225686,"MARGIE WAKEFIELD","LYNN JENKINS","Republican",0.570447435817906,-41589,215895,-0.192635308830682
2014,"KANSAS",3,89584,134493,224077,"KELLY KULTALA","KEVIN YODER","Republican",0.600208856776911,-44909,224077,-0.200417713553823
2014,"KANSAS",4,69396,138757,208153,"PERRY L SCHUCKMAN","MIKE POMPEO","Republican",0.666610618151072,-69361,208153,-0.333221236302143
2014,"KENTUCKY",1,63596,173022,236618,"CHARLES KENDALL HATCHETT","ED WHITFIELD","Republican",0.731229238688519,-109426,236618,-0.462458477377038
2014,"KENTUCKY",2,69898,156936,226834,"RON LEACH","BRETT GUTHRIE","Republican",0.69185395487449,-87038,226834,-0.383707909748979
2014,"KENTUCKY",3,157056,87981,247355,"JOHN A YARMUTH","MICHAEL MACFARLANE","Democrat",0.634941683006206,69075,245037,0.281896203430502
2014,"KENTUCKY",4,71694,150464,222158,"PETER NEWBERRY","THOMAS MASSIE","Republican",0.677283734999415,-78770,222158,-0.35456746999883
2014,"KENTUCKY",5,47617,171350,218967,"KENNTH S STEPP","HAROLD ROGERS","Republican",0.782538008010339,-123733,218967,-0.565076016020679
2014,"KENTUCKY",6,98290,147404,245694,"ELIZABETH JENSEN","ANDY BARR","Republican",0.599949530717071,-49114,245694,-0.199899061434142
2014,"LOUISIANA",1,46047,189250,244004,"LEE A DUGAS","STEVE SCALISE","Republican",0.775602039310831,-143203,235297,-0.608605294585141
2014,"LOUISIANA",5,75006,247211,326073,"""JAMIE"" MAYO","""ED"" TARPLEY","Republican",0.758146181989922,-172205,322217,-0.534437971925752
2014,"LOUISIANA",6,95127,234200,332888,"EDWIN EDWARDS","""TREY"" THOMAS","Republican",0.703539929345606,-139073,329327,-0.422294558296162
2014,"MAINE",1,186674,94751,321987,"CHELLIE PINGREE","ISAAC J MISIUK","Democrat",0.579756325565939,91923,281425,0.326634094341299
2014,"MAINE",2,118568,133320,295009,"EMILY ANN CAIN","BRUCE POLIQUIN","Republican",0.451918416048324,-14752,251888,-0.0585657117449025
2014,"MARYLAND",1,73843,176342,250418,"BILL TILGHMAN","ANDY HARRIS","Republican",0.704190593327956,-102499,250185,-0.409692827307792
2014,"MARYLAND",2,120412,70411,196354,"C A DUTCH RUPPERSBERGER","DAVID BANACH","Democrat",0.613239353412714,50001,190823,0.262028162223631
2014,"MARYLAND",3,128594,87029,215946,"JOHN P SARBANES","CHARLES A LONG","Democrat",0.595491465458957,41565,215623,0.192767005375122
2014,"MARYLAND",4,134628,54217,191837,"DONNA F EDWARDS","NANCY HOYT","Democrat",0.701783284767798,80411,188845,0.425804230983081
2014,"MARYLAND",5,144725,80752,226040,"STENY H HOYER","CHRIS CHAFFEE","Democrat",0.640262785347726,63973,225477,0.283722951786657
2014,"MARYLAND",6,94704,91930,190536,"JOHN K DELANEY","DAN BONGINO","Democrat",0.497039929462149,2774,186634,0.0148633153659033
2014,"MARYLAND",7,144639,55860,206809,"ELIJAH E CUMMINGS","CORROGAN R VAUGHN","Democrat",0.699384456189044,88779,200499,0.442790238355304
2014,"MARYLAND",8,136722,87859,225097,"CHRIS VAN HOLLEN","DAVE WALLACE","Democrat",0.60739148011746,48863,224581,0.217574060138658
2014,"MASSACHUSETTS",3,139104,81638,230789,"NIKI TSONGAS","ROSEANN L EHRHARD WOFFORD","Democrat",0.602732365927319,57466,220742,0.260331065225467
2014,"MASSACHUSETTS",6,149638,111989,278919,"SETH W MOULTON","RICHARD R TISEI","Democrat",0.536492673500192,37649,261627,0.143903343309368
2014,"MASSACHUSETTS",9,140413,114971,264552,"WILLIAM R KEATING","JOHN C CHAPMAN","Democrat",0.530757658229762,25442,255384,0.0996225292109138
2014,"MICHIGAN",1,113263,130414,250131,"JERRY CANNON","DAN BENISHEK","Republican",0.521382795415202,-17151,243677,-0.0703841560754605
2014,"MICHIGAN",2,70851,135568,213072,"DEAN VANDERSTELT","BILL HUIZENGA","Republican",0.636254411654277,-64717,206419,-0.313522495506712
2014,"MICHIGAN",3,84720,125754,217165,"BOB GOODRICH","JUSTIN AMASH","Republican",0.579071213132871,-41034,210474,-0.194959947546965
2014,"MICHIGAN",4,85777,123962,219423,"JEFF HOLMES","JOHN MOOLENAAR","Republican",0.564945333898452,-38185,209739,-0.182059607416837
2014,"MICHIGAN",5,148182,69222,222138,"DANIEL T KILDEE","ALLEN HARDWICK","Democrat",0.667071820219863,78960,217404,0.363194789424298
2014,"MICHIGAN",6,84391,116801,208976,"PAUL CLEMENTS","FRED UPTON","Republican",0.558920641604778,-32410,201192,-0.16108990417114
2014,"MICHIGAN",7,92083,119564,223685,"PAM BYRNES","TIM WALBERG","Republican",0.534519525225205,-27481,211647,-0.129843560267804
2014,"MICHIGAN",8,102269,132739,243125,"ERIC SHERTZING","MIKE BISHOP","Republican",0.545970179948586,-30470,235008,-0.129655160675381
2014,"MICHIGAN",9,136342,81470,225757,"SANDER M LEVIN","GEORGE BRIKHO","Democrat",0.603932546942066,54872,217812,0.25192367729969
2014,"MICHIGAN",10,67143,157069,228692,"CHUCK STADLER","CANDICE S MILLER","Republican",0.686814580308887,-89926,224212,-0.401075767577114
2014,"MICHIGAN",11,101681,140435,251238,"BOBBY MCKENZIE","DAVE TROTT","Republican",0.558971970800595,-38754,242116,-0.160063771084934
2014,"MICHIGAN",12,134346,64716,206660,"DEBBIE DINGELL","TERRY BOWMAN","Democrat",0.650082260718088,69630,199062,0.349790517527203
2014,"MICHIGAN",13,132710,27234,166947,"JOHN CONYERS JR","JEFF GORMAN","Democrat",0.794922939615567,105476,159944,0.659455809533337
2014,"MICHIGAN",14,165272,41801,212468,"BRENDA LAWRENCE","CHRISTINA L BARR","Democrat",0.777867725963439,123471,207073,0.596267982788678
2014,"MINNESOTA",5,167079,56577,236010,"KEITH ELLISON","DOUG DAGGETT","Democrat",0.707931867293759,110502,223656,0.494071252280288
2014,"MINNESOTA",8,129090,125358,266083,"RICHARD M NOLAN","STEWART MILLS","Democrat",0.485149370685087,3732,254448,0.0146670439539709
2014,"MISSISSIPPI",1,43713,102622,151111,"RON E DICKEY","ALAN NUNNELEE","Republican",0.679116675821085,-58909,146335,-0.402562613182082
2014,"MISSISSIPPI",3,47744,117771,170946,"DOUGLAS MACARTHUR ""DOUG"" MAGEE","GREGG HARPER","Republican",0.688936857253168,-70027,165515,-0.423085520949763
2014,"MISSISSIPPI",4,37869,108776,155576,"MATT MOORE","STEVEN M PALAZZO","Republican",0.699182393171183,-70907,146645,-0.483528248491254
2014,"MISSOURI",1,119315,35273,163494,"WM LACY CLAY","DANIEL J ELDER","Democrat",0.729782132677652,84042,154588,0.543651512407173
2014,"MISSOURI",2,75384,148191,231117,"ARTHUR LIEBER","ANN WAGNER","Republican",0.641194719557627,-72807,223575,-0.325649111036565
2014,"MISSOURI",3,52021,130940,191620,"COURTNEY DENTON","BLAINE LUETKEMEYER","Republican",0.683331593779355,-78919,182961,-0.43134329173977
2014,"MISSOURI",4,46464,120014,176286,"NATE IRVIN","VICKY HARTZLER","Republican",0.680791441180808,-73550,166478,-0.441800117733274
2014,"MISSOURI",5,79256,69071,153635,"EMANUEL CLEAVER","JACOB TURK","Democrat",0.515872034367169,10185,148327,0.0686658531487861
2014,"MISSOURI",6,55157,124616,186970,"W A ""BILL"" HEDGE","SAM GRAVES","Republican",0.666502647483553,-69459,179773,-0.386370589576855
2014,"MISSOURI",7,47282,104054,163957,"JIM EVANS","BILLY LONG","Republican",0.634642009795251,-56772,151336,-0.375138764074642
2014,"MISSOURI",8,38721,106124,159224,"BARBARA STOCKER","JASON T SMITH","Republican",0.66650756167412,-67403,144845,-0.465345714384342
2014,"MONTANA",0,148690,203871,367963,"JOHN LEWIS","RYAN ZINKE","Republican",0.554052989023353,-55181,352561,-0.156514759148062
2014,"NEBRASKA",1,55838,123219,179057,"DENNIS P CRAWFORD","JEFF FORTENBERRY","Republican",0.688155168465908,-67381,179057,-0.376310336931815
2014,"NEBRASKA",2,83872,78157,171509,"BRAD ASHFORD","LEE TERRY","Democrat",0.489023899620428,5715,162029,0.0352714637503163
2014,"NEBRASKA",3,45524,139440,184964,"MARK SULLIVAN","ADRIAN SMITH","Republican",0.753876430008002,-93916,184964,-0.507752860016003
2014,"NEVADA",1,45643,30413,80299,"DINA TITUS","ANNETTE TEIJEIRO","Democrat",0.568413056202443,15230,76056,0.200247186283791
2014,"NEVADA",2,52016,122402,186210,"KRISTEN SPEES","MARK E AMODEI","Republican",0.657333118522099,-70386,174418,-0.403547798965703
2014,"NEVADA",3,52644,88528,145719,"ERIN BILBRAY","JOSEPH J HECK","Republican",0.607525442804301,-35884,141172,-0.254186382568781
2014,"NEVADA",4,59844,63466,130781,"STEVEN A HORSFORD","CRESENT HARDY","Republican",0.485284559683746,-3622,123310,-0.0293731246452031
2014,"NEW HAMPSHIRE",1,116769,125508,242736,"CAROL SHEA-PORTER","FRANK C GUINTA","Republican",0.517055566541428,-8739,242277,-0.0360702831882515
2014,"NEW HAMPSHIRE",2,130700,106871,238184,"ANN M KUSTER","MARILINDA GARCIA","Democrat",0.548735431431162,23829,237571,0.10030264636677
2014,"NEW JERSEY",1,93315,64073,162492,"DONALD W NORCROSS","GARRY W COBB","Democrat",0.574274425817886,29242,157388,0.185795613388568
2014,"NEW JERSEY",2,66026,108875,177148,"WILLIAM J HUGHES JR","FRANK A LOBIONDO","Republican",0.614599092284418,-42849,174901,-0.244990022927256
2014,"NEW JERSEY",3,82537,100471,186103,"AIMEE BELGARD","TOM MACARTHUR","Republican",0.53986770766726,-17934,183008,-0.0979957160342717
2014,"NEW JERSEY",4,54415,118826,174849,"RUBEN M SCOLAVINO","CHRISTOPHER H SMITH","Republican",0.679592105187905,-64411,173241,-0.371799978065239
2014,"NEW JERSEY",5,81808,104678,188921,"ROY CHO","SCOTT GARRETT","Republican",0.554083452871835,-22870,186486,-0.122636551805497
2014,"NEW JERSEY",6,72190,46891,120457,"FRANK PALLONE JR","ANTHONY E WILKINSON","Democrat",0.599300995375943,25299,119081,0.212452028451222
2014,"NEW JERSEY",7,68232,104287,175997,"JANICE KOVACH","LEONARD LANCE","Republican",0.592549873009199,-36055,172519,-0.20899147340293
2014,"NEW JERSEY",8,61510,15141,79518,"ALBIO SIRES","JUDE ANTHONY TISCORNIA","Democrat",0.773535551698986,46369,76651,0.60493666096985
2014,"NEW JERSEY",9,82498,36246,120459,"BILL PASCRELL","DIERDRE G PAUL","Democrat",0.684863729567737,46252,118744,0.389510206831503
2014,"NEW JERSEY",10,95734,14154,112123,"DONALD M PAYNE JR","YOLANDA DENTLEY","Democrat",0.853830168654067,81580,109888,0.742392253931276
2014,"NEW JERSEY",11,65477,109455,174932,"MARK DUNEC","RODNEY P FRELINGHUYSEN","Republican",0.625700272105733,-43978,174932,-0.251400544211465
2014,"NEW JERSEY",12,90430,54168,148366,"BONNIE WATSON","ALIETA ECK","Democrat",0.60950622110187,36262,144598,0.250778019059738
2014,"NEW MEXICO",1,105474,74558,180032,"MICHELLE LUJAN GRISHAM","MICHAEL H FRESE","Democrat",0.585862513330963,30916,180032,0.171725026661927
2014,"NEW MEXICO",2,52499,95209,147777,"ROXANNE ""ROCKY"" LARA","STEVEN PEARCE","Republican",0.644274819491531,-42710,147708,-0.289151569312427
2014,"NEW MEXICO",3,113249,70775,184076,"BEN RAY LUJAN","JEFFERSON L BYRD","Democrat",0.615229579086899,42474,184024,0.230806851280268
2014,"NEW YORK",1,68387,77062,176719,"TIMOTHY H BISHOP","LEE M ZELDIN","Republican",0.436070824302989,-8675,145449,-0.05964289888552
2014,"NEW YORK",2,41814,76659,146617,"PATRICIA MAHER","PETER T KING","Republican",0.522852056719207,-34845,118473,-0.294117647058824
2014,"NEW YORK",3,80393,63219,171163,"STEVE ISRAEL","GRANT M LALLY","Democrat",0.469686789785176,17174,143612,0.119586107010556
2014,"NEW YORK",4,83772,67811,175305,"KATHLEEN M RICE","BRUCE A BLAKEMAN","Democrat",0.477864293659622,15961,151583,0.105295448698073
2014,"NEW YORK",7,47142,5713,68522,"NYDIA M VELAZQUEZ","JOSE LUIS FERNANDEZ","Democrat",0.687983421382913,41429,52855,0.783823668527103
2014,"NEW YORK",11,41429,48291,110999,"DOMENIC M RECCHIA JR","MICHAEL G GRIMM","Republican",0.435057973495257,-6862,89720,-0.0764823896567098
2014,"NEW YORK",12,78440,19564,117420,"CAROLYN B MALONEY","NICHOLAS S DI IORIO","Democrat",0.668029296542327,58876,98004,0.60075098975552
2014,"NEW YORK",17,89295,63549,181674,"NITA M LOWEY","CHRISTOPHER E DAY","Democrat",0.491512269229499,25746,152844,0.168446258930674
2014,"NEW YORK",18,76235,66523,186715,"SEAN PATRICK MALONEY","NAN HAYWORTH","Democrat",0.408296066197145,9712,142758,0.0680312136622816
2014,"NEW YORK",19,60533,102118,210351,"SEAN S ELDRIDGE","CHRISTOPHER P GIBSON","Republican",0.485464770787874,-41585,162651,-0.255670115769347
2014,"NEW YORK",20,103437,61820,211965,"PAUL TONKO","JAMES M FISCHER","Democrat",0.487990941900786,41617,165257,0.251831995013827
2014,"NEW YORK",21,53140,79615,181558,"AARON G WOOLF","ELISE M STEFANIK","Republican",0.438510007821192,-26475,132755,-0.199427516854356
2014,"NEW YORK",23,60233,94375,190554,"MARTHA ROBERTSON","TOM REED","Republican",0.495266433661849,-34142,154608,-0.220829452550968
2014,"NEW YORK",24,72631,93881,203417,"DANIEL B MAFFEI","JOHN M KATKO","Republican",0.461519931962422,-21250,166512,-0.12761842990295
2014,"NEW YORK",25,87264,75990,196516,"LOUISE MCINTOSH SLAUGHTER","MARK W ASSINI","Democrat",0.444055445867003,11274,163254,0.0690580322687346
2014,"NEW YORK",26,100648,38477,173911,"BRIAN HIGGINS","KATHLEEN A WEPPNER","Democrat",0.578732800110401,62171,139125,0.446871518418688
2014,"NEW YORK",27,50939,109171,215147,"JAMES D O'DONNELL","CHRIS COLLINS","Republican",0.507425155823693,-58232,160110,-0.363699956280057
2014,"NORTH CAROLINA",1,154333,55990,210323,"G K BUTTERFIELD","ARTHUR RICH","Democrat",0.73379040808661,98343,210323,0.467580816173219
2014,"NORTH CAROLINA",2,85479,122128,207607,"CLAY AIKEN","RENEE L ELLMERS","Republican",0.588265328240377,-36649,207607,-0.176530656480754
2014,"NORTH CAROLINA",3,66182,139415,205597,"MARSHALL ADAME","WALTER B JONES","Republican",0.678098415832916,-73233,205597,-0.356196831665832
2014,"NORTH CAROLINA",4,169946,57416,227362,"DAVID E PRICE","PAUL WRIGHT","Democrat",0.747468794257616,112530,227362,0.494937588515231
2014,"NORTH CAROLINA",5,88973,139279,228252,"JOSHUA ""JOSH"" BRANNON","VIRGINIA FOXX","Republican",0.610198377232182,-50306,228252,-0.220396754464364
2014,"NORTH CAROLINA",6,103758,147312,251070,"LAURA FJELD","MARK WALKER","Republican",0.586736766638786,-43554,251070,-0.173473533277572
2014,"NORTH CAROLINA",7,84054,134431,226504,"JONATHAN BARFIELD JR","DAVID ROUZER","Republican",0.593503867481369,-50377,218485,-0.23057418129391
2014,"NORTH CAROLINA",8,65854,121568,187422,"ANTONIO BLUE","RICHARD HUDSON","Republican",0.648632497785745,-55714,187422,-0.297264995571491
2014,"NORTH CAROLINA",10,85292,133504,218796,"TATE MACQUEEN","PATRICK T MCHENRY","Republican",0.610175688769447,-48212,218796,-0.220351377538895
2014,"NORTH CAROLINA",11,85342,144682,230024,"TOM HILL","MARK MEADOWS","Republican",0.628986540534901,-59340,230024,-0.257973081069801
2014,"NORTH CAROLINA",12,130096,42568,172664,"ALMA ADAMS","VINCE COAKLEY","Democrat",0.753463373951721,87528,172664,0.506926747903442
2014,"NORTH CAROLINA",13,114718,153991,268709,"BRENDA CLEARY","GEORGE HOLDING","Republican",0.573077195032545,-39273,268709,-0.146154390065089
2014,"OHIO",1,72604,124779,197383,"FRED KUNDRATA","STEVE CHABOT","Republican",0.632166903938029,-52175,197383,-0.264333807876058
2014,"OHIO",2,68453,132658,201111,"MAREK TYSZKIEWICZ","BRAD R WENSTRUP","Republican",0.659625778798773,-64205,201111,-0.319251557597546
2014,"OHIO",3,91769,51475,143261,"JOYCE BEATTY","JOHN ADAMS","Democrat",0.640572102665764,40294,143244,0.281296249755662
2014,"OHIO",4,60165,125907,186072,"JANET GARRETT","JIM JORDAN","Republican",0.676657422933058,-65742,186072,-0.353314845866116
2014,"OHIO",5,58507,134449,202300,"ROBERT L FRY","ROBERT E LATTA","Republican",0.664602076124567,-75942,192956,-0.393571591450901
2014,"OHIO",6,73561,111026,190652,"JENNIFER GARRISON","BILL JOHNSON","Republican",0.582348991880494,-37465,184587,-0.20296662278492
2014,"OHIO",8,51534,126539,188330,"TOM POETTER","JOHN A BOEHNER","Republican",0.67190038761748,-75005,178073,-0.421203663666025
2014,"OHIO",9,108870,51704,160715,"MARCY KAPTUR","RICHARD MAY","Democrat",0.677410322620788,57166,160574,0.356010313002105
2014,"OHIO",10,63249,130752,200606,"ROBERT KLEPINGER","MICHAEL R TURNER","Republican",0.651785091173744,-67503,194001,-0.347951814681368
2014,"OHIO",11,137105,35461,172566,"MARCIA L FUDGE","MARK ZETZER","Democrat",0.794507608683055,101644,172566,0.589015217366109
2014,"OHIO",12,61360,150573,221081,"DAVID ARTHUR TIBBS","PATRICK J TIBERI","Republican",0.681076166653851,-89213,211933,-0.420949073527955
2014,"OHIO",13,120230,55233,175549,"TIM RYAN","THOMAS PEKAREK","Democrat",0.684880005012845,64997,175463,0.370431372996016
2014,"OHIO",14,70856,135736,214580,"MICHAEL WAGER","DAVID P JOYCE","Republican",0.632565942771927,-64880,206592,-0.314048946716233
2014,"OHIO",15,66125,128496,194621,"SCOTT WHARTON","STEVE STIVERS","Republican",0.660237076163415,-62371,194621,-0.32047415232683
2014,"OHIO",16,75199,132176,207375,"PETE CROSSLAND","JAMES B RENACCI","Republican",0.63737673297167,-56977,207375,-0.274753465943339
2014,"OKLAHOMA",2,38964,110925,158407,"EARL E EVERETT","MARKWAYNE MULLIN","Republican",0.700253145378676,-71961,149889,-0.48009527050017
2014,"OKLAHOMA",3,36270,133335,169605,"FRANKIE ROBBINS","FRANK D LUCAS","Republican",0.786150172459538,-97065,169605,-0.572300344919077
2014,"OKLAHOMA",4,40998,117721,166268,"BERT SMITH","TOM COLE","Republican",0.708019582842158,-76723,158719,-0.483388882238421
2014,"OKLAHOMA",5,57790,95632,159133,"AL MCAFFREY","STEVE RUSSELL","Republican",0.600956432669528,-37842,153422,-0.246653022382709
2014,"OREGON",1,160038,96245,279253,"SUZANNE BONAMICI","JASON YATES","Democrat",0.57309321654557,63793,256283,0.248916237128487
2014,"OREGON",2,73785,202374,287425,"AELEA CHRISTOFFERSON","GREG WALDEN","Republican",0.70409324171523,-128589,276159,-0.465633928280447
2014,"OREGON",3,211748,57424,292757,"EARL BLUMENAUER","JAMES BUCHAL","Democrat",0.723289280871166,154324,269172,0.5733285780096
2014,"OREGON",4,181624,116534,310179,"PETER A DEFAZIO","ART ROBINSON","Democrat",0.585545765509593,65090,298158,0.218307072089295
2014,"OREGON",5,150944,110332,281088,"KURT SCHRADER","TOOTIE SMITH","Democrat",0.536999089253188,40612,261276,0.155437162234572
2014,"PENNSYLVANIA",1,131248,27193,158441,"ROBERT A BRADY","MEGAN RATH","Democrat",0.828371444260008,104055,158441,0.656742888520017
2014,"PENNSYLVANIA",2,181141,25397,206538,"CHAKA FATTAH","ARMOND JAMES","Democrat",0.877034734528271,155744,206538,0.754069469056542
2014,"PENNSYLVANIA",3,73931,113859,187790,"DAN LAVALLEE","MIKE KELLY","Republican",0.606310240161883,-39928,187790,-0.212620480323766
2014,"PENNSYLVANIA",4,50250,147090,197340,"LINDA DELIAH THOMPSON","SCOTT PERRY","Republican",0.745363332319854,-96840,197340,-0.490726664639708
2014,"PENNSYLVANIA",5,65839,115018,180857,"KERITH STRANO TAYLOR","GLENN THOMPSON","Republican",0.635961007868095,-49179,180857,-0.271922015736189
2014,"PENNSYLVANIA",6,92901,119643,212544,"MANAN TRIVEDI","RYAN COSTELLO","Republican",0.562909327009937,-26742,212544,-0.125818654019874
2014,"PENNSYLVANIA",7,89256,145869,235125,"MARY ELLEN BALCHUNIS","PATRICK MEEHAN","Republican",0.620389154704944,-56613,235125,-0.240778309409888
2014,"PENNSYLVANIA",8,84767,137731,222498,"KEVIN STROUSE","MICHAEL G FITZPATRICK","Republican",0.619021294573434,-52964,222498,-0.238042589146869
2014,"PENNSYLVANIA",9,63223,110094,173317,"ALANNA HARTZOK","BILL SHUSTER","Republican",0.635217549345996,-46871,173317,-0.270435098691992
2014,"PENNSYLVANIA",10,44737,112851,180322,"SCOTT F BRION","TOM MARINO","Republican",0.625830458845842,-68114,157588,-0.432228342259563
2014,"PENNSYLVANIA",11,62228,122464,184692,"ANDY OSTROWSKI","LOU BARLETTA","Republican",0.663071491997488,-60236,184692,-0.326142983994975
2014,"PENNSYLVANIA",12,87928,127993,215921,"ERIN MCCLELLAND","KEITH J ROTHFUS","Republican",0.592776987879826,-40065,215921,-0.185553975759653
2014,"PENNSYLVANIA",13,123601,60549,184150,"BRENDAN F BOYLE","CARSON DEE ADCOCK","Democrat",0.67119739342927,63052,184150,0.342394786858539
2014,"PENNSYLVANIA",16,74513,101722,176235,"TOM HOUGHTON","JOSEPH R PITTS","Republican",0.577195222288422,-27209,176235,-0.154390444576843
2014,"PENNSYLVANIA",17,93680,71371,165051,"MATT CARTWRIGHT","DAVID J MOYLAN","Democrat",0.567582141277544,22309,165051,0.135164282555089
2014,"RHODE ISLAND",1,87060,58877,146353,"DAVID N CICILLINE","COMICK BRENDAN LYNCH","Democrat",0.594863104958559,28183,145937,0.19311757813303
2014,"RHODE ISLAND",2,105716,63844,169904,"JAMES R LANGEVIN","RHUE R REIS","Democrat",0.62221018928336,41872,169560,0.246945034206181
2014,"SOUTH CAROLINA",2,68719,121649,194808,"PHIL BLACK","JOE WILSON","Republican",0.624455874502074,-52930,190368,-0.278040426962515
2014,"SOUTH CAROLINA",3,47181,116741,164009,"BARBARA JO MULLIS","JEFF DUNCAN","Republican",0.711796303861373,-69560,163922,-0.424348165590952
2014,"SOUTH CAROLINA",5,66802,103078,175145,"TOM ADAMS","MICK MULVANEY","Republican",0.588529504125153,-36276,169880,-0.213538968683777
2014,"SOUTH CAROLINA",6,125747,44311,173432,"JAMES E CLYBURN","ANTHONY CULLER","Democrat",0.725050740347802,81436,170058,0.478871914288066
2014,"SOUTH CAROLINA",7,68576,102833,171524,"GLORIA BROMELL-TINUBU","TOM RICE","Republican",0.599525430843497,-34257,171409,-0.199855316815336
2014,"SOUTH DAKOTA",0,92485,183834,276319,"CORINNA ROBINSON","KRISTI L NOEM","Republican",0.665296269890959,-91349,276319,-0.330592539781919
2014,"TENNESSEE",2,37612,120883,166751,"BOB SCOTT","JOHN J DUNCAN JR","Republican",0.724931184820481,-83271,158495,-0.525385658853592
2014,"TENNESSEE",3,53983,97344,156097,"MARY M HEADRICK","CHARLES J ""CHUCK"" FLEISCHMANN","Republican",0.623612241106491,-43361,151327,-0.286538423414196
2014,"TENNESSEE",4,51357,84815,145418,"LENDRA SHERRELL","SCOTT DES JARLAIS","Republican",0.583249666478703,-33458,136172,-0.24570396263549
2014,"TENNESSEE",5,96148,55078,154276,"JIM COOPER","BOB RIES","Democrat",0.623220721304675,41070,151226,0.27158028381363
2014,"TENNESSEE",6,37232,115231,162097,"AMOS SCOTT POWERS","DIANE BLACK","Republican",0.710876820669106,-77999,152463,-0.511592976656631
2014,"TENNESSEE",7,42280,110534,157907,"DANIEL CRAMER","MARSHA BLACKBURN","Republican",0.699994300442666,-68254,152814,-0.446647558469774
2014,"TENNESSEE",8,42433,122255,172595,"WES BRADLEY","STEPHEN LEE FINCHER","Republican",0.708334540398042,-79822,164688,-0.484686194501117
2014,"TENNESSEE",9,87376,27173,116550,"STEVE COHEN","CHARLOTTE BERGMANN","Democrat",0.74968682968683,60203,114549,0.525565478528839
2014,"TEXAS",1,33476,115084,148560,"SHIRLEY J MCKELLAR","LOUIE GOHMERT","Republican",0.774663435648896,-81608,148560,-0.549326871297792
2014,"TEXAS",2,44462,101936,150026,"NIKO LETSOS","TED POE","Republican",0.679455561036087,-57474,146398,-0.392587330428011
2014,"TEXAS",6,55027,92334,150996,"DAVID E COZAD","JOE BARTON","Republican",0.611499642374632,-37307,147361,-0.253167391643651
2014,"TEXAS",7,49478,90606,143219,"JAMES CARGAS","JOHN ABNEY CULBERSON","Republican",0.632639524085491,-41128,140084,-0.293595271408583
2014,"TEXAS",10,60243,109726,176460,"TAWANA WALTER-CADIEN","MICHAEL T MCCAUL","Republican",0.621817975745211,-49483,169969,-0.291129558919568
2014,"TEXAS",12,41757,113186,158730,"MARK GREENE","KAY GRANGER","Republican",0.713072513072513,-71429,154943,-0.461001787754206
2014,"TEXAS",13,16822,110842,131451,"MIKE MINTER","MAC THORNBERRY","Republican",0.84321914629786,-94020,127664,-0.736464469231733
2014,"TEXAS",14,52545,90116,145698,"DONALD G BROWN","RANDY K WEBER SR","Republican",0.618512265096295,-37571,142661,-0.263358591345918
2014,"TEXAS",15,48708,39016,90184,"RUBEN HINOJOSA","EDDIE ZAMORA","Democrat",0.540095804133771,9692,87724,0.110482878117733
2014,"TEXAS",16,49338,21324,73105,"BETO O'ROURKE","COREY ROEN","Democrat",0.674892278229943,28014,70662,0.396450709009086
2014,"TEXAS",17,43049,85807,132865,"NICK HAYNES","BILL FLORES","Republican",0.645820946073082,-42758,128856,-0.331827776743031
2014,"TEXAS",18,76097,26249,106010,"SHEILA JACKSON LEE","SEAN SEIBERT","Democrat",0.717828506744647,49848,102346,0.487053719735016
2014,"TEXAS",19,21458,90160,116818,"NEAL MARCHBANKS","RANDY NEUGEBAUER","Republican",0.771798866613022,-68702,111618,-0.615510043182999
2014,"TEXAS",22,47844,100861,151566,"FRANK BRISCOE","PETE OLSON","Republican",0.665459271868361,-53017,148705,-0.356524662923237
2014,"TEXAS",23,55037,57459,115429,"PETE P GALLEGO","WILL HURD","Republican",0.497786518119363,-2422,112496,-0.0215296543877116
2014,"TEXAS",24,46548,93712,144073,"PATRICK MCGEHEARTY","KENNY MARCHANT","Republican",0.650448036759143,-47164,140260,-0.336261229145872
2014,"TEXAS",25,64463,107120,177883,"MARCO MONTOYA","ROGER WILLIAMS","Republican",0.602193576676804,-42657,171583,-0.24860854513559
2014,"TEXAS",27,44152,83342,131047,"WESLEY REED","BLAKE FARENTHOLD","Republican",0.635970300731798,-39190,127494,-0.307387014290869
2014,"TEXAS",31,45715,91607,143028,"LOUIE MINOR","JOHN R CARTER","Republican",0.640482982353106,-45892,137322,-0.334192627546933
2014,"TEXAS",32,55325,96495,156096,"FRANK PEREZ","PETE SESSIONS","Republican",0.618177275522755,-41170,151820,-0.271176393097089
2014,"TEXAS",34,47503,30811,79877,"FILEMON VELA","LARRY S SMITH","Democrat",0.59470185410068,16692,78314,0.213141966953546
2014,"TEXAS",35,60124,32040,96225,"LLOYD DOGGETT","SUSAN NARVAIZ","Democrat",0.62482722785139,28084,92164,0.30471767718415
2014,"TEXAS",36,29543,101663,133842,"MICHAEL K COLE","BRIAN BABIN","Republican",0.759574722433915,-72120,131206,-0.549669984604363
2014,"UTAH",1,36422,84231,130034,"DONNA MCALEER","ROB BISHOP","Republican",0.647761354722611,-47809,120653,-0.396252061697596
2014,"UTAH",2,47585,88915,146188,"LUZ ROBLES","CHRIS STEWART","Republican",0.608223657208526,-41330,136500,-0.302783882783883
2014,"UTAH",3,32059,102952,142580,"BRIAN WONNACOTT","JASON CHAFFETZ","Republican",0.722064805723103,-70893,135011,-0.525090548177556
2014,"UTAH",4,67425,74936,147168,"DOUG OWENS","MIA B LOVE","Republican",0.509186779734725,-7511,142361,-0.0527602363006722
2014,"VERMONT",0,123349,59432,191504,"PETER WELCH","MARK DONKA","Democrat",0.644106650513827,63917,182781,0.349691707562602
2014,"VIRGINIA",1,72059,131861,209621,"NORMAN G ""NORM"" MOSHER","ROBERT J WITTMAN","Republican",0.629044799900773,-59802,203920,-0.293262063554335
2014,"VIRGINIA",2,71178,101558,173060,"SUZANNE D PATRICK","E SCOTT RIGELL","Republican",0.586836935166994,-30380,172736,-0.175875324194146
2014,"VIRGINIA",4,75270,120684,200638,"ELLIOTT G FAUSZ","J RANDY FORBES","Republican",0.601501211136475,-45414,195954,-0.231758473927554
2014,"VIRGINIA",5,73482,124735,204945,"W LAWRENCE GAUGHAN","ROBERT HURT","Republican",0.608626704725658,-51253,198217,-0.258570152913221
2014,"VIRGINIA",7,89914,148026,243351,"JOHN K ""JACK"" TRAMMELL","DAVID A BRAT","Republican",0.608281864467374,-58112,237940,-0.244229637723796
2014,"VIRGINIA",8,128102,63810,203076,"DONALD S BEYER JR","MICAH K EDMOND","Democrat",0.630808170340168,64292,191912,0.335007711867939
2014,"VIRGINIA",10,89957,125914,222910,"JOHN W FOUST","BARBARA J COMSTOCK","Republican",0.564864743618501,-35957,215871,-0.166567070148376
2014,"VIRGINIA",11,106780,75796,187805,"GERALD E CONNOLLY","SUZANNE K SCHOLTE","Democrat",0.568568461968531,30984,182576,0.169704670931557
2014,"WASHINGTON",1,124151,101428,225579,"SUZAN K DELBENE","PEDRO CELIS","Democrat",0.5503659471848,22723,225579,0.1007318943696
2014,"WASHINGTON",2,122173,79518,201691,"RICK LARSEN","B J GUILLOT","Democrat",0.605743439221383,42655,201691,0.211486878442766
2014,"WASHINGTON",3,78018,124796,202814,"BOB DINGETHAL","JAIME HERRERA BEUTLER","Republican",0.615322413640084,-46778,202814,-0.230644827280168
2014,"WASHINGTON",5,87772,135470,223242,"JOSEPH ""JOE"" PAKOOTAS","CATHY MCMORRIS RODGERS","Republican",0.606830255955421,-47698,223242,-0.213660511910841
2014,"WASHINGTON",6,141265,83025,224290,"DEREK KILMER","MARTY MCCLENDON","Democrat",0.629831914039859,58240,224290,0.259663828079718
2014,"WASHINGTON",7,203954,47921,251875,"JIM MCDERMOTT","CRAIG KELLER","Democrat",0.809742928039702,156033,251875,0.619485856079404
2014,"WASHINGTON",8,73003,125741,198744,"JASON RITCHIE","DAVID G REICHERT","Republican",0.632678219216681,-52738,198744,-0.265356438433361
2014,"WASHINGTON",9,118132,48662,166794,"ADAM SMITH","DOUG BASLER","Democrat",0.708250896315215,69470,166794,0.41650179263043
2014,"WASHINGTON",10,99279,82213,181492,"DENNY HECK","JOYCE MCDONALD","Democrat",0.547015846428493,17066,181492,0.0940316928569854
2014,"WEST VIRGINIA",1,52109,92491,144737,"GLEN B GAINER III","DAVID B MCKINLEY","Republican",0.63902803015124,-40382,144600,-0.27926694329184
2014,"WEST VIRGINIA",2,67687,72619,154250,"NICK CASEY","ALEX X MOONEY","Republican",0.470787682333874,-4932,140306,-0.0351517397687911
2014,"WEST VIRGINIA",3,62688,77713,140401,"NICK J RAHALL II","EVAN JENKINS","Republican",0.553507453650615,-15025,140401,-0.10701490730123
2014,"WISCONSIN",1,105552,182316,288170,"ROB ZERVAN","PAUL RYAN","Republican",0.632668216677656,-76764,287868,-0.266663887615157
2014,"WISCONSIN",2,224920,103619,328847,"MARK POCAN","PETER THERON","Democrat",0.683965491550782,121301,328539,0.369213396278676
2014,"WISCONSIN",3,155368,119540,275161,"RON KIND","TONY KURTZ","Democrat",0.564643972074531,35828,274908,0.130327236748294
2014,"WISCONSIN",4,179045,68490,254892,"GWEN MOORE","DAN SEBRING","Democrat",0.702434756681261,110555,247535,0.446623709778415
2014,"WISCONSIN",5,101190,231160,332826,"CHRIS ROCKWOOD","F JAMES SENSENBRENNER JR","Republican",0.694537085444046,-129970,332350,-0.391063637731307
2014,"WISCONSIN",6,122212,169767,299033,"MARK L HARRIS","GLENN GROTHMAN","Republican",0.567719950640899,-47555,291979,-0.162871302388185
2014,"WISCONSIN",7,112949,169896,286603,"KELLY WESTLAND","JOHN SCHIESS","Republican",0.592792120110397,-56947,282845,-0.201336421007973
2014,"WISCONSIN",8,101345,188553,290048,"RON GRUETT","REID J RIBBLE","Republican",0.650075159973522,-87208,289898,-0.300823048106575
2014,"WYOMING",0,37803,113038,171153,"RICHARD GRAYSON","CYNTHIA M LUMMIS","Republican",0.660450006719134,-75235,150841,-0.498770228253592
2016,"ALABAMA",2,112089,134886,276584,"NATHAN MATHIS","MARTHA ROBY","Republican",0.487685477106413,-22797,246975,-0.0923048891588217
2016,"ALABAMA",3,94549,192164,287104,"JESSE SMITH","MIKE ROGERS","Republican",0.66931843513152,-97615,286713,-0.340462413633145
2016,"ALABAMA",5,102234,205647,308326,"WILL BOYD JR","MO BROOKS","Republican",0.666979106530101,-103413,307881,-0.335886267746305
2016,"ALABAMA",6,83709,245313,329306,"DAVID J PUTNAM","GARY J PALMER","Republican",0.744939357315081,-161604,329022,-0.491164724547295
2016,"ALASKA",0,111019,155088,308198,"STEVE LINDBECK","DON YOUNG","Republican",0.503208976047865,-44069,266107,-0.165606316256243
2016,"ARIZONA",1,142219,121745,280710,"TOM O'HALLERAN","PAUL BABEU","Democrat",0.506640304941042,20474,263964,0.0775636071585519
2016,"ARIZONA",2,135873,179806,315679,"MATT HEINZ","MARTHA MCSALLY","Republican",0.569584926460107,-43933,315679,-0.139169852920213
2016,"ARIZONA",3,148973,332,151035,"RAUL M GRIJALVA","JAIME VASQUEZ","Democrat",0.986347535339491,148641,149305,0.995552727638056
2016,"ARIZONA",4,81296,203487,284783,"MIKEL WEISSER","PAUL A GOSAR","Republican",0.714533522015008,-122191,284783,-0.429067044030016
2016,"ARIZONA",5,114940,205184,320124,"TALIA FUENTES","ANDY BIGGS","Republican",0.640951631242893,-90244,320124,-0.281903262485787
2016,"ARIZONA",6,122866,201578,324444,"W JOHN WILLIAMSON","DAVID SCHWEIKERT","Republican",0.621302905894392,-78712,324444,-0.242605811788783
2016,"ARIZONA",7,119465,39286,158811,"RUBEN GALLEGO","EVE NUNEZ","Democrat",0.752246380918198,80179,158751,0.505061385440092
2016,"ARIZONA",9,169055,108350,277507,"KYRSTEN SINEMA","DAVE GILES","Democrat",0.609191840205833,60705,277405,0.218831672103964
2016,"ARKANSAS",2,111347,176472,302464,"DIANNE CURRY","J FRENCH HILL","Republican",0.583447947524333,-65125,287819,-0.226270677057456
2016,"CALIFORNIA",1,128588,185448,314036,"JIM REED","DOUG LAMALFA","Republican",0.590531021921054,-56860,314036,-0.181062043842107
2016,"CALIFORNIA",2,254194,76572,330766,"JARED HUFFMAN","DALE K MENSING","Democrat",0.768500994660878,177622,330766,0.537001989321756
2016,"CALIFORNIA",3,152513,104453,256966,"JOHN GARAMENDI","N EUGENE CLEEK","Democrat",0.593514317069184,48060,256966,0.187028634138369
2016,"CALIFORNIA",4,130845,220133,350978,"ROBERT W DERLET","TOM MCCLINTOCK","Republican",0.627198855768738,-89288,350978,-0.254397711537475
2016,"CALIFORNIA",5,224526,67565,292091,"MIKE THOMPSON","CARLOS SANTAMARIA","Democrat",0.768685101560815,156961,292091,0.53737020312163
2016,"CALIFORNIA",6,177565,57848,235413,"DORIS O MATSUI","ROBERT ""BOB"" EVANS","Democrat",0.754270155004184,119717,235413,0.508540310008368
2016,"CALIFORNIA",7,152133,145168,297301,"AMI BERA","SCOTT R JONES","Democrat",0.511713717747334,6965,297301,0.023427435494667
2016,"CALIFORNIA",8,83035,136972,220007,"RITA RAMIREZ","PAUL COOK","Republican",0.622580190630298,-53937,220007,-0.245160381260596
2016,"CALIFORNIA",9,133163,98992,232155,"JERRY MCNERNEY","ANTONIO C ""TONY"" AMADOR","Democrat",0.573595227326571,34171,232155,0.147190454653141
2016,"CALIFORNIA",10,116470,124671,241141,"MICHAEL EGGMAN","JEFF DENHAM","Republican",0.51700457408736,-8201,241141,-0.0340091481747194
2016,"CALIFORNIA",11,214868,83341,298209,"MARK DESAULNIER","ROGER ALLEN PETERSEN","Democrat",0.720528220140908,131527,298209,0.441056440281816
2016,"CALIFORNIA",13,293117,29754,322871,"BARBARA LEE","SUE CARO","Democrat",0.907845548222045,263363,322871,0.815691096444091
2016,"CALIFORNIA",14,231630,54817,286447,"JACKIE SPEIER","ANGEL CARDENAS","Democrat",0.808631265120598,176813,286447,0.617262530241196
2016,"CALIFORNIA",15,198578,70619,269197,"ERIC SWALWELL","DANNY R TURNER","Democrat",0.737667953208988,127959,269197,0.475335906417976
2016,"CALIFORNIA",16,97473,70483,167956,"JIM COSTA","JOHNNY M TACHERRA","Democrat",0.580348424587392,26990,167956,0.160696849174784
2016,"CALIFORNIA",18,230460,93470,323930,"ANNA G ESHOO","RICHARD B FOX","Democrat",0.71145000463063,136990,323930,0.42290000926126
2016,"CALIFORNIA",19,181802,64061,245863,"ZOE LOFGREN","G BURT LANCASTER","Democrat",0.739444324684886,117741,245863,0.478888649369771
2016,"CALIFORNIA",20,180980,74811,255791,"JIMMY PANETTA","CASEY LUCIUS","Democrat",0.707530757532517,106169,255791,0.415061515065034
2016,"CALIFORNIA",21,57282,75126,132408,"EMILIO HUERTA","DAVID G VALADAO","Republican",0.567382635490303,-17844,132408,-0.134765270980605
2016,"CALIFORNIA",22,76211,158755,234966,"LOUIE J CAMPOS","DEVIN NUNES","Republican",0.675650945243142,-82544,234966,-0.351301890486283
2016,"CALIFORNIA",23,74468,167116,241584,"WENDY REED","KEVIN MCCARTHY","Republican",0.69175110934499,-92648,241584,-0.383502218689979
2016,"CALIFORNIA",24,166034,144780,310814,"SALUD CARBAJAL","JUSTIN DONALD FAREED","Democrat",0.534190866563282,21254,310814,0.0683817331265644
2016,"CALIFORNIA",25,122406,138755,261161,"BRYAN CAFORIO","STEPHEN KNIGHT","Republican",0.531300615329241,-16349,261161,-0.0626012306584827
2016,"CALIFORNIA",26,169248,111059,280307,"JULIA BROWNLEY","RAFAEL A DAGNESSES","Democrat",0.603795124631208,58189,280307,0.207590249262416
2016,"CALIFORNIA",27,168977,81655,250632,"JUDY CHU","JACK ORSWELL","Democrat",0.674203613265664,87322,250632,0.348407226531329
2016,"CALIFORNIA",28,210883,59526,270409,"ADAM B SCHIFF","LENORE SOLIS","Democrat",0.779866794374448,151357,270409,0.559733588748895
2016,"CALIFORNIA",30,205279,77325,282604,"BRAD SHERMAN","MARK REED","Democrat",0.726383915301977,127954,282604,0.452767830603955
2016,"CALIFORNIA",31,121070,94866,215936,"PETE AGUILAR","PAUL CHABOT","Democrat",0.560675385299348,26204,215936,0.121350770598696
2016,"CALIFORNIA",33,219397,110822,330219,"TED LIEU","KENNETH W WRIGHT","Democrat",0.664398474951472,108575,330219,0.328796949902943
2016,"CALIFORNIA",35,124044,47309,171353,"NORMA J TORRES","TYLER FISCHELLA","Democrat",0.723909123271842,76735,171353,0.447818246543685
2016,"CALIFORNIA",36,144348,88269,232617,"RAUL RUIZ","JEFF STONE","Democrat",0.620539341492668,56079,232617,0.241078682985336
2016,"CALIFORNIA",38,163590,68524,232114,"LINDA T SANCHEZ","RYAN DOWNING","Democrat",0.704782994563016,95066,232114,0.409565989126033
2016,"CALIFORNIA",39,112679,150777,263456,"BRETT MURDOCK","EDWARD R ROYCE","Republican",0.572304293696101,-38098,263456,-0.144608587392202
2016,"CALIFORNIA",41,128164,69159,197323,"MARK TAKANO","DOUG SHEPHERD","Democrat",0.649513741429028,59005,197323,0.299027482858055
2016,"CALIFORNIA",42,104689,149547,254236,"TIM SHERIDAN","KEN CALVERT","Republican",0.588221180320647,-44858,254236,-0.176442360641294
2016,"CALIFORNIA",43,167017,52499,219516,"MAXINE WATERS","OMAR NAVARRO","Democrat",0.760842034293628,114518,219516,0.521684068587256
2016,"CALIFORNIA",45,129231,182618,311849,"RON VARASTEH","MIMI WALTERS","Republican",0.585597516746887,-53387,311849,-0.171195033493774
2016,"CALIFORNIA",47,154759,88109,242868,"ALAN S LOWENTHAL","ANDY WHALLON","Democrat",0.637214453942059,66650,242868,0.274428907884118
2016,"CALIFORNIA",48,127715,178701,306416,"SUZANNE SAVARY","DANA ROHRABACHER","Republican",0.583197352618662,-50986,306416,-0.166394705237324
2016,"CALIFORNIA",49,154267,155888,310155,"DOUG APPLEGATE","DARRELL E ISSA","Republican",0.50261320952427,-1621,310155,-0.00522641904854025
2016,"CALIFORNIA",50,103646,179937,283583,"PATRICK MALLOY","DUNCAN HUNTER","Republican",0.634512647090975,-76291,283583,-0.26902529418195
2016,"CALIFORNIA",51,145162,54362,199524,"JUAN VARGAS","JUAN M HIDALGO JR","Democrat",0.727541548886349,90800,199524,0.455083097772699
2016,"CALIFORNIA",52,181253,139403,320656,"SCOTT H PETERS","DENISE GITSHAM","Democrat",0.565256848460656,41850,320656,0.130513696921311
2016,"CALIFORNIA",53,198988,97968,296956,"SUSAN A DAVIS","JAMES VELTMEYER","Democrat",0.670092538962001,101020,296956,0.340185077924002
2016,"COLORADO",1,257254,105030,379036,"DIANA DEGETTE","CHARLES ""CASPER"" STOCKHAM","Democrat",0.678705980434576,152224,362284,0.420178644378443
2016,"COLORADO",2,260175,170001,457312,"JARED POLIS","NICHOLAS MORSE","Democrat",0.568922311244839,90174,430176,0.209621178308413
2016,"COLORADO",3,150914,204220,374037,"GAIL SCHWARTZ","SCOTT R TIPTON","Republican",0.545988765817286,-53306,355134,-0.150101088603175
2016,"COLORADO",4,123642,248230,390633,"BOB SEAY","KEN BUCK","Republican",0.635455785865505,-124588,371872,-0.335029257378883
2016,"COLORADO",5,111676,225445,361993,"MISTY PLOWRIGHT","DOUG LAMBORN","Republican",0.622788285961331,-113769,337121,-0.337472302229763
2016,"COLORADO",6,160372,191626,376417,"MORGAN CARROLL","MIKE COFFMAN","Republican",0.509079026717709,-31254,351998,-0.0887902772174842
2016,"COLORADO",7,199758,144066,362010,"ED PERLMUTTER","GEORGE ATHANASOPOULOS","Democrat",0.551802436396785,55692,343824,0.161978221415608
2016,"CONNECTICUT",1,187021,105674,312925,"JOHN B LARSON","MATHHEW M COREY","Democrat",0.59765439002956,81347,292695,0.277924118963426
2016,"CONNECTICUT",2,186210,111149,330257,"JOE COURTNEY","DARIA NOVAK","Democrat",0.563833620483442,75061,297359,0.252425519321763
2016,"CONNECTICUT",3,192274,95786,309379,"ROSA L DELAURO","ANGEL CADENA","Democrat",0.621483681827144,96488,288060,0.334957994862181
2016,"CONNECTICUT",4,187811,120653,313540,"JAMES A HIMES","JOHN SHABAN","Democrat",0.599001722268291,67158,308464,0.217717464598786
2016,"CONNECTICUT",5,163499,124900,309082,"ELIZABETH H ETSY","CLAY COPE","Democrat",0.528982600086708,38599,288399,0.133838882936487
2016,"DELAWARE",0,233554,172301,420617,"LISA BLUNT ROCHESTER","HANS REIGLE","Democrat",0.55526524130028,61253,405855,0.150923359327839
2016,"FLORIDA",1,114079,255107,369186,"STEVEN SPECHT","MATT GAETZ","Republican",0.690998575243915,-141028,369186,-0.38199715048783
2016,"FLORIDA",2,102801,231163,343362,"WALTER DARTLAND","NEAL DUNN","Republican",0.673234079484626,-128362,333964,-0.384358793163335
2016,"FLORIDA",3,136338,193843,342700,"KENNETH ""KEN"" MCGURN","TED S YOHO","Republican",0.565634665888532,-57505,330181,-0.174162050511689
2016,"FLORIDA",4,113088,287509,409662,"DAVID E BRUDERLY","JOHN RUTHERFORD","Republican",0.701820037006117,-174421,400597,-0.43540266152767
2016,"FLORIDA",5,194549,108325,302874,"AL LAWSON","GLO SMITH","Democrat",0.642343020529989,86224,302874,0.284686041059979
2016,"FLORIDA",6,151051,213519,364570,"WILLIAM ""BILL"" MCCULLOUGH","RON DESANTIS","Republican",0.5856735332035,-62468,364570,-0.171347066407
2016,"FLORIDA",7,182039,171583,353655,"STEPHANIE MURPHY","JOHN L MICA","Democrat",0.51473611287837,10456,353622,0.0295682960901754
2016,"FLORIDA",8,127127,246483,390561,"CORRY WESTBROOK","BILL POSEY","Republican",0.631099879404242,-119356,373610,-0.319466823693156
2016,"FLORIDA",9,195311,144450,339761,"DARREN SOTO","WAYNE LIEBNITZKY","Democrat",0.574848202118548,50861,339761,0.149696404237096
2016,"FLORIDA",10,198491,107498,305989,"VAL DEMINGS","THUY LOWE","Democrat",0.648686717496381,90993,305989,0.297373434992761
2016,"FLORIDA",11,124713,258016,394719,"DAVE KOLLER","DANIEL WEBSTER","Republican",0.653670079220914,-133303,382729,-0.348296052820664
2016,"FLORIDA",12,116110,253559,369669,"ROBERT MATTHEW TAGER","GUS M BILIRAKIS","Republican",0.685908204366609,-137449,369669,-0.371816408733218
2016,"FLORIDA",13,184693,171149,355842,"CHARLIE CRIST","DAVID W JOLLY","Democrat",0.519030918216512,13544,355842,0.0380618364330236
2016,"FLORIDA",14,195789,121088,316877,"KATHY CASTOR","CHRISTINE QUINN","Democrat",0.617870656437671,74701,316877,0.235741312875343
2016,"FLORIDA",15,135475,182999,318474,"JIM LANGE","DENNIS A ROSS","Republican",0.57461205624321,-47524,318474,-0.14922411248642
2016,"FLORIDA",16,155262,230654,385916,"JAN SCHNEIDER","VERN BUCHANAN","Republican",0.597679287720644,-75392,385916,-0.195358575441288
2016,"FLORIDA",17,115974,209348,338675,"APRIL FREEMAN","THOMAS J ROONEY","Republican",0.618138333210305,-93374,325322,-0.2870202445577
2016,"FLORIDA",18,161918,201488,375918,"RANDY PERKINS","BRIAN MAST","Republican",0.535989231694146,-39570,363406,-0.108886479584817
2016,"FLORIDA",19,123812,239225,363166,"ROBERT M NEELD","FRANCIS ROONEY","Republican",0.658720805361735,-115413,363037,-0.317909744736762
2016,"FLORIDA",20,222914,54646,277560,"ALCEE L HASTINGS","GARY STEIN","Democrat",0.803120046116155,168268,277560,0.60624009223231
2016,"FLORIDA",21,210606,118038,335861,"LOIS FRANKEL","PAUL SPAIN","Democrat",0.627062981411953,92568,328644,0.281666484098295
2016,"FLORIDA",22,199113,138737,337850,"THEODORE E DEUTCH","ANDREA LEIGH MCGEE","Democrat",0.589353263282522,60376,337850,0.178706526565044
2016,"FLORIDA",23,183225,130818,323120,"DEBBIE WASSERMAN SCHULTZ","JOSEPH ""JOE"" KAUFMAN","Democrat",0.567049393414211,52407,314043,0.166878421107937
2016,"FLORIDA",25,95319,157921,253240,"ALINA VALDES","MARIO DIAZ-BALART","Republican",0.623602116569262,-62602,253240,-0.247204233138525
2016,"FLORIDA",26,115493,148547,280542,"JOE GARCIA","CARLOS CURBELO","Republican",0.529500039209815,-33054,264040,-0.125185577942736
2016,"FLORIDA",27,129760,157917,287677,"SCOTT FUHRMAN","ILEANA ROS-LEHTINEN","Republican",0.548938566517309,-28157,287677,-0.0978771330346187
2016,"GEORGIA",2,148543,94056,242599,"SANFORD D BISHOP JR","GREG DUKE","Democrat",0.612298484330109,54487,242599,0.224596968660217
2016,"GEORGIA",3,95969,207218,303187,"ANGELA PENDLEY","DREW FERGUSON","Republican",0.683465979741876,-111249,303187,-0.366931959483751
2016,"GEORGIA",4,220146,70593,290739,"HENRY C ""HANK"" JOHNSON JR","VICTOR ARMENDARIZ","Democrat",0.75719459721606,149553,290739,0.51438919443212
2016,"GEORGIA",5,253781,46768,300549,"JOHN LEWIS","DOUGLAS BELL","Democrat",0.844391430349128,207013,300549,0.688782860698256
2016,"GEORGIA",6,124917,201088,326005,"RODNEY STOOKSBURY","TOM PRICE","Republican",0.616824895323691,-76171,326005,-0.233649790647383
2016,"GEORGIA",7,114220,174081,288301,"RASHID MALIK","ROB WOODALL","Republican",0.603816844201026,-59861,288301,-0.207633688402052
2016,"GEORGIA",8,83225,173983,257208,"JAMES NEAL HARRIS","AUSTIN SCOTT","Republican",0.676429193493204,-90758,257208,-0.352858386986408
2016,"GEORGIA",11,105383,217935,323318,"DON WILSON","BARRY LOUDERMILK","Republican",0.674057738820604,-112552,323318,-0.348115477641208
2016,"GEORGIA",12,99420,159492,258912,"PATRICIA C MCCRACKEN","RICK W ALLEN","Republican",0.616008527994067,-60072,258912,-0.232017055988135
2016,"HAWAII",1,145417,45958,213531,"COLLEEN WAKAKO HANABUSA","SHIRLENE D ""SHIRL"" OSTROV","Democrat",0.681011188071053,99459,191375,0.519707380796865
2016,"HAWAII",2,170848,39668,224133,"TULSI GABBARD","ANGELA AULANI KAAIHUE","Democrat",0.762261692834165,131180,210516,0.623135533641148
2016,"IDAHO",1,113052,242252,355357,"JAMES PIOTROWSKI","RAUL R LABRADOR","Republican",0.68171444491033,-129200,355304,-0.363632269830905
2016,"IDAHO",2,95940,205292,326237,"JENNIFER MARTINEZ","MICHAEL K SIMPSON","Republican",0.629272584041663,-109352,301232,-0.363015881446858
2016,"ILLINOIS",1,234037,81817,315862,"BOBBY L RUSH","AUGUST ""O'NEILL"" DEUSER","Democrat",0.740946995839955,152220,315854,0.481931525324992
2016,"ILLINOIS",2,235051,59471,294522,"ROBIN L KELLY","JOHN F MORROW","Democrat",0.798076204833595,175580,294522,0.59615240966719
2016,"ILLINOIS",5,212842,86222,313724,"MIKE QUIGLEY","VINCE KOLBER","Democrat",0.678437097576214,126620,299064,0.423387636091271
2016,"ILLINOIS",6,143591,208555,352146,"AMANDA HOWLAND","PETER J ROSKAM","Republican",0.592240150392167,-64964,352146,-0.184480300784334
2016,"ILLINOIS",7,250584,46882,297466,"DANNY K DAVIS","JEFFREY A LEEF","Democrat",0.842395433427686,203702,297466,0.684790866855372
2016,"ILLINOIS",8,144954,103617,248571,"RAJA KRISHNAMOORTHI","PETER ""PETE"" DICIANNI","Democrat",0.583149281291864,41337,248571,0.166298562583729
2016,"ILLINOIS",9,217306,109550,326948,"JANICE D SCHAKOWSKY","JOAN MCCARTHY LASONDE","Democrat",0.664650036091366,107756,326856,0.329674229630174
2016,"ILLINOIS",10,150435,135535,285996,"BRAD SCHNEIDER","ROBERT J DOLD","Democrat",0.526003860193849,14900,285970,0.0521033674860999
2016,"ILLINOIS",11,166578,108995,275573,"BILL FOSTER","TONIA KHOURI","Democrat",0.604478668084319,57583,275573,0.208957336168638
2016,"ILLINOIS",12,124246,169976,313002,"CHARLES ""C J"" BARICEVIC","MIKE BOST","Republican",0.543050843125603,-45730,294222,-0.155426854552005
2016,"ILLINOIS",13,126811,187583,314394,"MARK D WICKLUND","RODNEY DAVIS","Republican",0.596649427151918,-60772,314394,-0.193298854303835
2016,"ILLINOIS",14,137589,200508,338097,"JIM WALZ","RANDY HULTGREN","Republican",0.593048740450226,-62919,338097,-0.186097480900452
2016,"ILLINOIS",17,173125,113943,287068,"CHERI BUSTOS","PATRICK HARLAN","Democrat",0.603080106455613,59182,287068,0.206160212911227
2016,"ILLINOIS",18,96770,250506,347283,"JUNIUS RODRIGUEZ","DARIN LAHOOD","Republican",0.721331018218571,-153736,347276,-0.442691115999954
2016,"INDIANA",2,102401,164355,277357,"LYNN C COLEMAN","JACKIE WALORSKI","Republican",0.592575633569731,-61954,266756,-0.232249696351722
2016,"INDIANA",3,66023,201396,287247,"TOMMY A SCHRADER","JIM BANKS","Republican",0.70112481592497,-135373,267419,-0.506220575202211
2016,"INDIANA",4,91256,193412,299434,"JOHN DALE","TODD ROKITA","Republican",0.645925312422771,-102156,284668,-0.358860145854118
2016,"INDIANA",5,123849,221957,361135,"ANGELA DEMAREE","SUSAN W BROOKS","Republican",0.614609495064173,-98108,345806,-0.283708206335344
2016,"INDIANA",6,79135,204920,296385,"BARRY WELSH","LUKE MESSER","Republican",0.691398012719942,-125785,284055,-0.442819172343384
2016,"INDIANA",7,158739,94456,264670,"ANDRE CARSON","CATHERINE ""CAT"" PING","Democrat",0.599761967733404,64283,253195,0.253887320049764
2016,"INDIANA",8,93356,187702,294713,"RON DRAKE","LARRY BUCSHON","Republican",0.636897591894487,-94346,281058,-0.335681603085484
2016,"INDIANA",9,130627,174791,322843,"SHELLI YODER","TREY HOLLINGSWORTH","Republican",0.541411769807616,-44164,305418,-0.144601824384941
2016,"IOWA",1,177403,206903,384977,"MONICA VERNON","ROD BLUM","Republican",0.53744249656473,-29500,384306,-0.076761747149407
2016,"IOWA",2,198571,170933,370032,"DAVID LOEBSACK","CHRISTOPHER PETERS","Democrat",0.536631966965019,27638,369504,0.0747975664674807
2016,"IOWA",3,155002,208598,390287,"JIM MOWRER","DAVID YOUNG","Republican",0.534473349099509,-53596,363600,-0.147403740374037
2016,"IOWA",4,142993,226719,370259,"KIM WEAVER","STEVE KING","Republican",0.612325426255675,-83726,369712,-0.226462760202536
2016,"KANSAS",2,96840,181228,297401,"BRITANI POTTER","LYNN JENKINS","Republican",0.609372530690885,-84388,278068,-0.303479724383964
2016,"KANSAS",3,139300,176022,343113,"JAY SIDIE","KEVIN YODER","Republican",0.51301466280788,-36722,315322,-0.116458731074901
2016,"KANSAS",4,81495,166998,275251,"DANIEL B GIROUX","MIKE POMPEO","Republican",0.606711692237267,-85503,248493,-0.344086151320158
2016,"KENTUCKY",1,81710,216959,299001,"SAMUEL L GASKINS","JAMES R COMER","Republican",0.725612957816195,-135249,298669,-0.452839096123133
2016,"KENTUCKY",3,212401,122093,334494,"JOHN A YARMUTH","HAROLD BRATCHER","Democrat",0.634991958002236,90308,334494,0.269983916004472
2016,"KENTUCKY",4,94065,233922,327987,"CALVIN SIDLE","THOMAS MASSIE","Republican",0.713205096543461,-139857,327987,-0.426410193086921
2016,"KENTUCKY",6,128728,202099,330827,"NANCY JO KEMPER","ANDY BARR","Republican",0.61089028404574,-73371,330827,-0.22178056809148
2016,"LOUISIANA",1,63785,243645,326788,"DANIL EZEKIEL FAUST","STEVE SCALISE","Republican",0.745575112917243,-179860,307430,-0.585043749796702
2016,"LOUISIANA",3,56215,220621,282443,"JACOB ""DORIAN PHIBIAN"" HEBERT","""GREG"" ELLISON","Republican",0.781116897922767,-164406,276836,-0.593875074051063
2016,"LOUISIANA",4,46579,216540,268761,"MARSHALL JONES","""MIKE"" JOHNSON","Republican",0.805697255182113,-169961,263119,-0.645947271006655
2016,"LOUISIANA",6,79202,241075,331098,"JERMAINE SAMPSON","GARRET GRAVES","Republican",0.728107690170282,-161873,320277,-0.505415624599956
2016,"MAINE",1,227546,164569,406942,"CHELLIE PINGREE","MARK I HOLBROOK","Democrat",0.559160764924731,62977,392115,0.160608494956837
2016,"MAINE",2,159081,192878,364886,"EMILY ANN CAIN","BRUCE POLIQUIN","Republican",0.52859797306556,-33797,351959,-0.0960253893209152
2016,"MARYLAND",1,103622,242574,362097,"JOE WERNER","ANDY HARRIS","Republican",0.669914415198138,-138952,346196,-0.401368011184416
2016,"MARYLAND",2,192183,102577,309480,"C A DUTCH RUPPERSBERGER","PAT MCDONOUGH","Democrat",0.62098681659558,89606,294760,0.303996471705795
2016,"MARYLAND",3,214640,115048,339675,"JOHN P SARBANES","MARK PLASTER","Democrat",0.631898137925959,99592,329688,0.302079541869889
2016,"MARYLAND",4,237501,68670,320650,"ANTHONY G BROWN","GEORGE E MCDERMOTT","Democrat",0.740686106346484,168831,306171,0.551427143655016
2016,"MARYLAND",5,242989,105931,360634,"STENY H HOYER","MARK ARNESS","Democrat",0.673782838001963,137058,348920,0.392806373953915
2016,"MARYLAND",6,185770,133081,331973,"JOHN K DELANEY","AMIE HOEBER","Democrat",0.559593701897444,52689,318851,0.165246463081502
2016,"MARYLAND",7,238838,69556,318912,"ELIJAH E CUMMINGS","CORROGAN R VAUGHN","Democrat",0.748915061208108,169282,308394,0.548914700026589
2016,"MARYLAND",8,220657,124651,364324,"JAMIE RASKIN","DAN COX","Democrat",0.605661444209001,96006,345308,0.278030048536379
2016,"MASSACHUSETTS",3,236713,107519,360124,"NIKI TSONGAS","ANN WOFFORD","Democrat",0.657309704435139,129194,344232,0.375310836877455
2016,"MASSACHUSETTS",4,265823,113055,395304,"JOSEPH P KENNEDY III","DAVID A ROSA","Democrat",0.672452087507336,152768,378878,0.403211587899007
2016,"MASSACHUSETTS",8,271019,102744,396009,"STEPHEN F LYNCH","WILLIAM BURKE","Democrat",0.684375860144593,168275,373763,0.450218453940064
2016,"MASSACHUSETTS",9,211790,127803,403642,"WILLIAM R KEATING","MARK C ALLIEGRO","Democrat",0.524697628096184,83987,339593,0.247316640802372
2016,"MICHIGAN",1,144334,197777,360271,"LON JOHNSON","JACK BERGMAN","Republican",0.548967305167499,-53443,342111,-0.156215380388237
2016,"MICHIGAN",2,110391,212508,339328,"DENNIS B MURPHY","BILL HUIZENGA","Republican",0.626261316484346,-102117,322899,-0.316250592290469
2016,"MICHIGAN",3,128400,203545,342365,"DOUGLAS SMITH","JUSTIN AMASH","Republican",0.594526309640296,-75145,331945,-0.226377863802738
2016,"MICHIGAN",4,101277,194572,315751,"DEBRA WIRTH","JOHN R MOOLENAAR","Republican",0.616219742771994,-93295,295849,-0.315346680232145
2016,"MICHIGAN",5,195279,112102,319291,"DANIEL T KILDEE","AL HARDWICK","Democrat",0.611601955582838,83177,307381,0.270599028567153
2016,"MICHIGAN",6,119980,193259,329565,"PAUL CLEMENTS","FRED UPTON","Republican",0.586406323487021,-73279,313239,-0.233939579681968
2016,"MICHIGAN",7,134010,184321,334807,"GRETCHEN D DRISKELL","TIM WALBERG","Republican",0.550529110801148,-50311,318331,-0.15804618463172
2016,"MICHIGAN",8,143791,205629,366968,"SUZANNA SHKRELI","MIKE BISHOP","Republican",0.560345861219507,-61838,349420,-0.17697326999027
2016,"MICHIGAN",9,199661,128937,344775,"SANDER M LEVIN","CHRISTOPHER R MORSE","Democrat",0.579105213545066,70724,328598,0.215229551001528
2016,"MICHIGAN",10,110112,215132,340983,"FRANK ACCAVITTI JR","PAUL MITCHELL","Republican",0.63091708384289,-105020,325244,-0.322896041126047
2016,"MICHIGAN",11,152461,200872,379488,"ANIL KUMAR","DAVID A TROTT","Republican",0.529323720381145,-48411,353333,-0.137012393407918
2016,"MICHIGAN",12,211378,96104,328542,"DEBBIE DINGELL","JEFF JONES","Democrat",0.643381972472317,115274,307482,0.374896741923104
2016,"MICHIGAN",13,198771,40541,257797,"JOHN CONYERS JR","JEFF GORMAN","Democrat",0.771036901127631,158230,239312,0.661187069599519
2016,"MICHIGAN",14,244135,58103,310974,"BRENDA L LAWRENCE","HOWARD KLAUSNER","Democrat",0.785065632496607,186032,302238,0.615514925323752
2016,"MINNESOTA",1,169071,166524,335873,"TIMOTHY J WALZ","JIM HAGEDORN","Democrat",0.503377764809913,2547,335595,0.00758950520716936
2016,"MINNESOTA",4,203299,121033,351945,"BETTY MCCOLLUM","GREG RYAN","Democrat",0.577644234184319,82266,324332,0.253647497009237
2016,"MINNESOTA",5,249957,80660,361875,"KEITH ELLISON","FRANK NELSON DRAKE","Democrat",0.690727461139896,169297,330617,0.512063807971157
2016,"MINNESOTA",7,173572,156944,330823,"COLLIN C PETERSON","DAVE HUGHES","Democrat",0.524667269204378,16628,330516,0.0503092134722676
2016,"MINNESOTA",8,179097,177088,356971,"RICHARD M NOLAN","STEWART MILLS","Democrat",0.501713024307297,2009,356185,0.00564032735797409
2016,"MISSISSIPPI",1,83947,206455,300423,"JACOB OWENS","TRENT KELLY","Republican",0.687214361084205,-122508,290402,-0.421856598783755
2016,"MISSISSIPPI",2,192343,83542,286626,"BENNIE G THOMPSON","JOHN BOUIE II","Democrat",0.671059150251547,108801,275885,0.394370842923682
2016,"MISSISSIPPI",3,96101,209490,316445,"DENNIS QUINN","GREGG HARPER","Republican",0.662010775964228,-113389,305591,-0.371048231132461
2016,"MISSISSIPPI",4,77505,181323,278779,"MARK GLADNEY","STEVEN M PALAZZO","Republican",0.650418431804404,-103818,258828,-0.401108071769669
2016,"MISSOURI",1,236993,62714,314024,"WM LACY CLAY","STEVEN G BAILEY","Democrat",0.754697093215805,174279,299707,0.58149792964462
2016,"MISSOURI",2,155689,241954,413296,"BILL OTTO","ANN WAGNER","Republican",0.585425457783284,-86265,397643,-0.216940823804267
2016,"MISSOURI",3,102891,249865,368333,"KEVIN MILLER","BLAINE LUETKEMEYER","Republican",0.678367129744009,-146974,352756,-0.416644933041536
2016,"MISSOURI",4,92510,225348,332234,"GORDON CHRISTENSEN","VICKY HARTZLER","Republican",0.678280970641175,-132838,317858,-0.417916176405816
2016,"MISSOURI",5,190766,123771,324270,"EMANUEL CLEAVER","JACOB TURK","Democrat",0.588293705862399,66995,314537,0.21299560941956
2016,"MISSOURI",6,99692,238388,350444,"DAVID M BLACKWELL","SAM GRAVES","Republican",0.680245631256349,-138696,338080,-0.410246095598675
2016,"MISSOURI",7,92756,228692,338607,"GENEVIEVE ""GEN"" WILLIAMS","BILLY LONG","Republican",0.6753906446116,-135936,321448,-0.42288643886414
2016,"MISSOURI",8,70009,229792,308871,"DAVE COWELL","JASON SMITH","Republican",0.743974021517073,-159783,299801,-0.532963532476543
2016,"MONTANA",0,205919,285358,507831,"DENISE JUNEAU","RYAN K ZINKE","Republican",0.561915282840157,-79439,491277,-0.161699000767388
2016,"NEBRASKA",1,83467,189771,273238,"DANIEL M WIK","JEFF FORTENBERRY","Republican",0.694526383592326,-106304,273238,-0.389052767184652
2016,"NEBRASKA",2,137602,141066,288308,"BRAD ASHFORD","DON BACON","Republican",0.489289232348738,-3464,278668,-0.0124305625331936
2016,"NEVADA",1,116537,54174,188352,"DINA TITUS","MARY PERRY","Democrat",0.618719206591913,62363,170711,0.365313307285412
2016,"NEVADA",2,115722,182676,313336,"H D ""CHIP"" EVANS","MARK E AMODEI","Republican",0.583003548905967,-66954,298398,-0.224378179478415
2016,"NEVADA",3,146869,142926,310963,"JACKY ROSEN","DANNY TARKANIAN","Democrat",0.472303778906172,3943,289795,0.0136061698787074
2016,"NEVADA",4,128985,118328,265846,"RUBEN KIHUEN","CRESENT HARDY","Democrat",0.485186912723908,10657,247313,0.0430911436115368
2016,"NEW HAMPSHIRE",1,162080,157176,365984,"CAROL SHEA-PORTER","FRANK C GUINTA","Democrat",0.442860890093556,4904,319256,0.0153607136592578
2016,"NEW HAMPSHIRE",2,174371,158825,350509,"ANN M KUSTER","JIM LAWRENCE","Democrat",0.49747937998739,15546,333196,0.0466572227757836
2016,"NEW JERSEY",1,183231,112388,305473,"DONALD NORCROSS","BOB PATTERSON","Democrat",0.599827153299964,70843,295619,0.239642918756913
2016,"NEW JERSEY",2,110838,176338,297795,"DAVID H COLE","FRANK A LOBIONDO","Republican",0.592145603519199,-65500,287176,-0.228083126723682
2016,"NEW JERSEY",3,127526,194596,328060,"FREDERICK JOHN LAVERGNE","THOMAS MACARTHUR","Republican",0.593171980735231,-67070,322122,-0.208213037296428
2016,"NEW JERSEY",4,111532,211992,332684,"LORNA PHILLIPSON","CHRISTOPHER H SMITH","Republican",0.637217299299034,-100460,323524,-0.310517921390685
2016,"NEW JERSEY",5,172587,157690,337701,"JOSHUA S GOTTHEIMER","SCOTT GARRETT","Democrat",0.511064521573818,14897,330277,0.0451045637449777
2016,"NEW JERSEY",6,167895,91908,263435,"FRANK PALLONE JR","BRENT SONNEK-SCHMELZ","Democrat",0.63732989162412,75987,259803,0.292479301624693
2016,"NEW JERSEY",7,148188,185850,343635,"PETER JACOB","LEONARD LANCE","Republican",0.540835479505871,-37662,334038,-0.112747651464803
2016,"NEW JERSEY",8,134733,32337,174889,"ALBIO SIRES","AGHA KHAN","Democrat",0.770391505469183,102396,167070,0.612892799425391
2016,"NEW JERSEY",9,162642,65376,233242,"BILL PASCRELL JR","HECTOR L CASTILLO","Democrat",0.697310089949495,97266,228018,0.426571586453701
2016,"NEW JERSEY",10,190856,26450,222771,"DONALD M PAYNE JR","DAVID H PINCKNEY","Democrat",0.856736289732506,164406,217306,0.756564475900343
2016,"NEW JERSEY",11,130162,194299,334992,"JOSEPH M WENZEL","RODNEY P FRELINGHUYSEN","Republican",0.580010865931127,-64137,324461,-0.197672447536067
2016,"NEW JERSEY",12,181430,92407,288634,"BONNIE WATSON COLEMAN","STEVEN J UCCIO","Democrat",0.628581525392019,89023,273837,0.325094855698828
2016,"NEW MEXICO",1,181088,96879,277967,"MICHELLE LUJAN GRISHAM","RICHARD GREGORY PRIEM","Democrat",0.651473016581105,84209,277967,0.30294603316221
2016,"NEW MEXICO",2,85232,143515,228817,"MERRIE LEE SOULES","STEVAN PEARCE","Republican",0.62720427240983,-58283,228747,-0.254792412578088
2016,"NEW MEXICO",3,170612,102730,273342,"BEN RAY LUJAN","MICHAEL H ROMERO","Democrat",0.624170453131974,67882,273342,0.248340906263948
2016,"NEW YORK",1,126635,158409,341554,"ANNA E THRONE-HOLST","LEE M ZELDIN","Republican",0.46378903482319,-31774,285044,-0.111470509816028
2016,"NEW YORK",2,102270,157571,317552,"DUWAYNE GREGORY","PETER T KING","Republican",0.496205345896105,-55301,259841,-0.212826305317483
2016,"NEW YORK",3,171775,133954,350966,"THOMAS R SUOZZI","JACK M MARTINS","Democrat",0.489434874033382,37821,305729,0.12370759725116
2016,"NEW YORK",4,181861,111246,343179,"KATHLEEN M RICE","DAVID H GURFEIN","Democrat",0.529930444461928,70615,293107,0.240918845336345
2016,"NEW YORK",5,197852,26791,249236,"GREGORY W MEEKS","MICHAEL A O'REILLY","Democrat",0.793833956571282,171061,224643,0.761479324973402
2016,"NEW YORK",6,131463,43770,210378,"GRACE MENG","DANNIEL S MAIO","Democrat",0.62488948464193,87693,175233,0.500436561606547
2016,"NEW YORK",7,165819,14941,206983,"NYDIA M VELAZQUEZ","ALLAN E ROMAGUERA","Democrat",0.801123763787364,150878,180760,0.834686877627794
2016,"NEW YORK",10,180117,46275,266516,"JERROLD NADLER","PHILIP ROSENTHAL","Democrat",0.675820588632577,133842,226392,0.591195801971801
2016,"NEW YORK",11,85257,122606,251718,"RICHARD A REICHARD","DANIEL M DONOVAN JR","Republican",0.487076808174227,-37349,207863,-0.179680847481274
2016,"NEW YORK",12,230153,49398,312289,"CAROLYN B MALONEY","ROBERT ARDINI","Democrat",0.736987213766735,180755,279551,0.646590425360668
2016,"NEW YORK",13,207194,13129,255239,"ADRIANO ESPAILLAT","ROBERT A EVANS JR","Democrat",0.811764659789452,194065,220323,0.880820431820554
2016,"NEW YORK",14,138367,26891,197301,"JOSEPH CROWLEY","FRANK J SPOTORNO","Democrat",0.701299030415457,111476,165258,0.674557358796548
2016,"NEW YORK",15,165688,6129,193703,"JOSE E SERRANO","ALEJANDRO VEGA","Democrat",0.855371367505924,159559,171817,0.928656652135702
2016,"NEW YORK",18,140951,111117,319123,"SEAN PATRICK MALONEY","PHIL OLIVA","Democrat",0.441682360719848,29834,252068,0.118356951298856
2016,"NEW YORK",19,125956,135905,326588,"ZEPHYR TEACHOUT","JOHN J FASO","Republican",0.416135926610898,-9949,261861,-0.0379934392673976
2016,"NEW YORK",20,188428,83328,332499,"PAUL TONKO","JOE VITOLLO","Democrat",0.566702456247989,105100,271756,0.386743990933043
2016,"NEW YORK",21,75965,152597,288611,"MIKE DERRICK","ELISE M STEFANIK","Republican",0.528728981223862,-76632,228562,-0.335278830251748
2016,"NEW YORK",22,102734,113287,296086,"KIM A MYERS","CLAUDIA TENNEY","Republican",0.382615186128355,-10553,216021,-0.0488517320075363
2016,"NEW YORK",23,106600,136964,296198,"JOHN F PLUMB","TOM REED","Republican",0.462406903490233,-30364,243564,-0.124665385689182
2016,"NEW YORK",24,110550,150330,315429,"COLLEEN DEACON","JOHN KATKO","Republican",0.476589026373605,-39780,260880,-0.152483900643974
2016,"NEW YORK",25,168660,113840,336386,"LOUISE MCINTOSH SLAUGHTER","MARK W ASSINI","Democrat",0.501388286076115,54820,282500,0.194053097345133
2016,"NEW YORK",26,195322,56930,310819,"BRIAN HIGGINS","SHELLY SCHRATZ","Democrat",0.628410747090751,138392,252252,0.548625977197406
2016,"NEW YORK",27,107832,175509,354426,"DIANA K KASTENBAUM","CHRIS COLLINS","Republican",0.495192226303939,-67677,283341,-0.238853536904296
2016,"NORTH CAROLINA",1,240661,101567,350699,"G K BUTTERFIELD","H POWELL DEW JR","Democrat",0.686232353100522,139094,342228,0.406436644576131
2016,"NORTH CAROLINA",2,169082,221485,390567,"JOHN P MCNEIL","GEORGE HOLDING","Republican",0.567085800899718,-52403,390567,-0.134171601799435
2016,"NORTH CAROLINA",3,106170,217531,323701,"ERNEST T REEVES","WALTER B JONES","Republican",0.672012134655129,-111361,323701,-0.344024269310259
2016,"NORTH CAROLINA",4,279380,130161,409541,"DAVID E PRICE","SUE GOOGE","Democrat",0.682178341118472,149219,409541,0.364356682236943
2016,"NORTH CAROLINA",5,147887,207625,355512,"JOSH BRANNON","VIRGINIA FOXX","Republican",0.584016854564684,-59738,355512,-0.168033709129368
2016,"NORTH CAROLINA",6,143167,207983,351150,"PETE GLIDEWELL","MARK WALKER","Republican",0.592291043713513,-64816,351150,-0.184582087427025
2016,"NORTH CAROLINA",7,135905,211801,347706,"J WESLEY CASTEEN","DAVID ROUZER","Republican",0.60913817995663,-75896,347706,-0.21827635991326
2016,"NORTH CAROLINA",8,133182,189863,323045,"THOMAS MILLS","RICHARD HUDSON","Republican",0.587729263724868,-56681,323045,-0.175458527449736
2016,"NORTH CAROLINA",9,139041,193452,332493,"CHRISTIAN CANO","ROBERT PITTENGER","Republican",0.58182277521632,-54411,332493,-0.163645550432641
2016,"NORTH CAROLINA",10,128919,220825,349744,"ANDY MILLARD","PATRICK T MCHENRY","Republican",0.631390388398371,-91906,349744,-0.262780776796743
2016,"NORTH CAROLINA",11,129103,230405,359508,"RICK BRYSON","MARK MEADOWS","Republican",0.64088977157671,-101302,359508,-0.281779543153421
2016,"NORTH CAROLINA",12,234115,115185,349300,"ALMA S ADAMS","LEON THREATT","Democrat",0.670240480961924,118930,349300,0.340480961923848
2016,"NORTH CAROLINA",13,156049,199443,355492,"BRUCE DAVIS","TED BUDD","Republican",0.561033722277857,-43394,355492,-0.122067444555714
2016,"NORTH DAKOTA",0,80377,233980,338459,"CHASE IRON EYES","KEVIN CRAMER","Republican",0.691309730277523,-153603,314357,-0.488625988923421
2016,"OHIO",1,144644,210014,354788,"MICHELE YOUNG","STEVE CHABOT","Republican",0.591942230289638,-65370,354658,-0.184318413795826
2016,"OHIO",2,111694,221193,340279,"WILLIAM R SMITH","BRAD R WENSTRUP","Republican",0.650034236611722,-109499,332887,-0.328937447241857
2016,"OHIO",3,199791,91560,291351,"JOYCE BEATTY","JOHN ADAMS","Democrat",0.685739880762379,108231,291351,0.371479761524759
2016,"OHIO",4,98981,210227,309208,"JANET GARRETT","JIM JORDAN","Republican",0.679888618664459,-111246,309208,-0.359777237328918
2016,"OHIO",5,100392,244599,344991,"JAMES NEU JR","ROBERT E LATTA","Republican",0.709001104376636,-144207,344991,-0.418002208753272
2016,"OHIO",6,88780,213975,302755,"MICHAEL L LORENTZ","BILL JOHNSON","Republican",0.706759591088504,-125195,302755,-0.413519182177008
2016,"OHIO",7,89638,198221,309553,"ROY RICH","BOB GIBBS","Republican",0.640345918146489,-108583,287859,-0.377208980785732
2016,"OHIO",8,87794,223833,325506,"STEVEN FOUGHT","WARREN DAVIDSON","Republican",0.687646310667084,-136039,311627,-0.436544330240961
2016,"OHIO",9,193966,88427,282398,"MARCY KAPTUR","DONALD P LARSON","Democrat",0.686853306326532,105539,282393,0.373730935256894
2016,"OHIO",10,109981,215724,336602,"ROBERT KLEPINGER","MICHAEL R TURNER","Republican",0.640887457590864,-105743,325705,-0.324658817027678
2016,"OHIO",11,242917,59769,302686,"MARCIA L FUDGE","BEVERLY A GOLDSTEIN","Democrat",0.802537943611531,183148,302686,0.605075887223063
2016,"OHIO",12,112638,251266,377534,"ED ALBERTSON","PATRICK J TIBERI","Republican",0.665545354855457,-138628,363904,-0.380946623285262
2016,"OHIO",13,208610,99377,308004,"TIM RYAN","RICHARD A MORCKEL","Democrat",0.677296398748068,109233,307987,0.354667567137574
2016,"OHIO",14,130907,219191,350269,"MICHAEL WAGER","DAVID P JOYCE","Republican",0.625779044106101,-88284,350098,-0.25216939257008
2016,"OHIO",15,113960,222847,336807,"SCOTT WHARTON","STEVE STIVERS","Republican",0.661645987167725,-108887,336807,-0.32329197433545
2016,"OHIO",16,119830,225794,345624,"KEITH MUNDY","JAMES B RENACCI","Republican",0.653293752748652,-105964,345624,-0.306587505497303
2016,"OKLAHOMA",2,62387,189839,268870,"JOSHUA HARRIS-TILL","MARKWAYNE MULLIN","Republican",0.706062409342805,-127452,252226,-0.505308731058654
2016,"OKLAHOMA",3,63090,227525,290615,"FRANKIE ROBBINS","FRANK D LUCAS","Republican",0.782908659222683,-164435,290615,-0.565817318445366
2016,"OKLAHOMA",4,76472,204143,293189,"CHRISTINA OWEN","TOM COLE","Republican",0.69628464915123,-127671,280615,-0.454968551217861
2016,"OKLAHOMA",5,103273,160184,280570,"AL MCAFFREY","STEVE RUSSELL","Republican",0.570923477207114,-56911,263457,-0.216016275900811
2016,"OREGON",1,225391,139756,378095,"SUZANNE BONAMICI","BRIAN J HEINRICH","Democrat",0.596122667583544,85635,365147,0.234521987035358
2016,"OREGON",2,106640,272952,380739,"JAMES ""JIM"" CRARY","GREG WALDEN","Republican",0.716900553922766,-166312,379592,-0.438133574996312
2016,"OREGON",4,220628,157743,397568,"PETER A DEFAZIO","ART ROBINSON","Democrat",0.554944059884095,62885,378371,0.166199312315162
2016,"OREGON",5,199505,160443,373108,"KURT SCHRADER","COLM WILLIS","Democrat",0.534711129217278,39062,359948,0.108521230844455
2016,"PENNSYLVANIA",1,245791,53219,299010,"ROBERT A BRADY","DEBORAH WILLIAMS","Democrat",0.822015986087422,192572,299010,0.644031972174844
2016,"PENNSYLVANIA",2,322514,35131,357645,"DWIGHT EVANS","JAMES A JONES","Democrat",0.901771309538788,287383,357645,0.803542619077577
2016,"PENNSYLVANIA",4,113372,220628,334000,"JOSHUA BURKHOLDER","SCOTT PERRY","Republican",0.660562874251497,-107256,334000,-0.321125748502994
2016,"PENNSYLVANIA",5,101082,206761,307843,"KERITH STRANO TAYLOR","GLENN THOMPSON","Republican",0.671644312198101,-105679,307843,-0.343288624396202
2016,"PENNSYLVANIA",6,155000,207469,362469,"MIKE PARRISH","RYAN A COSTELLO","Republican",0.572377223983292,-52469,362469,-0.144754447966585
2016,"PENNSYLVANIA",7,153824,225678,379502,"MARY ELLEN BALCHUNIS","PATRICK MEEHAN","Republican",0.594668802799458,-71854,379502,-0.189337605598916
2016,"PENNSYLVANIA",8,173555,207263,380818,"STEVE SANTARSIERO","BRIAN FITZPATRICK","Republican",0.544257361784369,-33708,380818,-0.0885147235687389
2016,"PENNSYLVANIA",9,107985,186580,294565,"ART HALVORSON","BILL SHUSTER","Republican",0.633408585541392,-78595,294565,-0.266817171082783
2016,"PENNSYLVANIA",10,89823,211282,301105,"MIKE MOLESEVICH","TOM MARINO","Republican",0.70168877966158,-121459,301105,-0.40337755932316
2016,"PENNSYLVANIA",11,113800,199421,313221,"MIKE MARSICANO","LOU BARLETTA","Republican",0.636678255927923,-85621,313221,-0.273356511855846
2016,"PENNSYLVANIA",12,137353,221851,359204,"ERIN R MCCLELLAND","KEITH J ROTHFUS","Republican",0.617618400685961,-84498,359204,-0.235236801371922
2016,"PENNSYLVANIA",14,255293,87999,343292,"MICHAEL F DOYLE","LENNY MCALLISTER","Democrat",0.743661372825466,167294,343292,0.487322745650933
2016,"PENNSYLVANIA",15,124129,190618,326474,"RICK DAUGHERTY","CHARLES W DENT","Republican",0.583868853262434,-66489,314747,-0.211245857784189
2016,"PENNSYLVANIA",16,134586,168669,313773,"CHRISTINA HARTMAN","LLOYD K SMUCKER","Republican",0.537551032115574,-34083,303255,-0.112390562397982
2016,"PENNSYLVANIA",17,157734,135430,293164,"MATT CARTWRIGHT","MATT CONNOLLY","Democrat",0.538040141354327,22304,293164,0.0760802827086545
2016,"RHODE ISLAND",1,130534,71023,202371,"DAVID N CICILLINE","HAROLD RUSSELL TAUB","Democrat",0.645023249378617,59511,201557,0.295256428702551
2016,"RHODE ISLAND",2,133108,70301,229148,"JAMES R LANGEVIN","RHUE R REIS","Democrat",0.580882224588476,62807,203409,0.30877198157407
2016,"SOUTH CAROLINA",1,110539,190410,325170,"DIMITRI CHERNY","MARK SANFORD","Republican",0.585570624596365,-79871,300949,-0.265397127087978
2016,"SOUTH CAROLINA",2,105306,183746,304996,"ARIK BJORN","JOE WILSON","Republican",0.602453802672822,-78440,289052,-0.271369857326709
2016,"SOUTH CAROLINA",3,72933,196325,269540,"HOSEA CLEVELAND","JEFF DUNCAN","Republican",0.728370557245678,-123392,269258,-0.458266792444421
2016,"SOUTH CAROLINA",4,91676,198648,295670,"CHRIS FEDALEI","TREY GOWDY","Republican",0.671857138025501,-106972,290324,-0.368457309764263
2016,"SOUTH CAROLINA",5,105772,161669,273006,"FRAN PERSON","MICK MULVANEY","Republican",0.592181124224376,-55897,267441,-0.209006846369854
2016,"SOUTH CAROLINA",6,177947,70099,253901,"JAMES E CLYBURN","LAURA STERLING","Democrat",0.700851906845582,107848,248046,0.434790321150109
2016,"SOUTH CAROLINA",7,103454,176468,289463,"MAL HYMAN","TOM RICE","Republican",0.609639228502434,-73014,279922,-0.260836947435357
2016,"SOUTH DAKOTA",0,132810,237163,369973,"PAULA HAWKS","KRISTI L NOEM","Republican",0.641027858789695,-104353,369973,-0.282055717579391
2016,"TENNESSEE",1,39024,198293,253025,"ALAN BOHMS","DAVID P ROE","Republican",0.783689358759016,-159269,237317,-0.671123434056557
2016,"TENNESSEE",2,68401,212455,280856,"STUART STARR","JOHN J DUNCAN JR","Republican",0.7564552653317,-144054,280856,-0.5129105306634
2016,"TENNESSEE",3,76727,176613,266006,"MELODY SHEKARI","CHARLES J ""CHUCK"" FLEISCHMANN","Republican",0.663943670443524,-99886,253340,-0.394276466408779
2016,"TENNESSEE",4,89141,165796,254937,"STEVEN REYNOLDS","SCOTT DESJARLAIS","Republican",0.650341064655189,-76655,254937,-0.300682129310379
2016,"TENNESSEE",5,171111,102433,273544,"JIM COOPER","STACY RIES SNYDER","Democrat",0.625533734974995,68678,273544,0.25106746994999
2016,"TENNESSEE",6,61995,202234,284490,"DAVID W KENT","DIANE BLACK","Republican",0.710865056768252,-140239,264229,-0.530747949695151
2016,"TENNESSEE",7,65226,200407,277513,"THARON CHANDLER","MARSHA BLACKBURN","Republican",0.722153556770313,-135181,265633,-0.508901378970233
2016,"TENNESSEE",8,70925,194386,282733,"RICKEY HOBSON","DAVID KUSTOFF","Republican",0.687524979397523,-123461,265311,-0.465344444821361
2016,"TENNESSEE",9,171631,41123,217957,"STEVE COHEN","WAYNE ALBERSON","Democrat",0.787453488532142,130508,212754,0.613422074320577
2016,"TEXAS",1,62847,192434,260409,"SHIRLEY J MCKELLAR","LOUIE GOHMERT","Republican",0.7389683152272,-129587,255281,-0.507624930958434
2016,"TEXAS",2,100231,168692,278236,"PAT BRYAN","TED POE","Republican",0.60629106226369,-68461,268923,-0.254574729569431
2016,"TEXAS",3,109420,193684,316467,"ADAM P BELL","SAM JOHNSON","Republican",0.61201957866065,-84264,303104,-0.278003589527027
2016,"TEXAS",6,106667,159444,273296,"RUBY FAYE WOOLRIDGE","JOE BARTON","Republican",0.583411392775599,-52777,266111,-0.198327013915246
2016,"TEXAS",7,111991,143542,255533,"JAMES CARGAS","JOHN ABNEY CULBERSON","Republican",0.561735666234889,-31551,255533,-0.123471332469779
2016,"TEXAS",9,152032,36491,188523,"AL GREEN","JEFF MARTIN","Democrat",0.8064374108199,115541,188523,0.6128748216398
2016,"TEXAS",10,120170,179221,312600,"TAWANA W CADIEN","MICHAEL T MCCAUL","Republican",0.573323736404351,-59051,299391,-0.197237057894192
2016,"TEXAS",12,76029,196482,283115,"BILL BRADSHAW","KAY GRANGER","Republican",0.694000671105381,-120453,272511,-0.442011515131499
2016,"TEXAS",14,99054,160631,259685,"MICHAEL COLE","RANDY K WEBER SR","Republican",0.618560948841866,-61577,259685,-0.237121897683732
2016,"TEXAS",15,101712,66877,177479,"VICENTE GONZALEZ","TIM WESTLEY","Democrat",0.573093154683089,34835,168589,0.206626766870911
2016,"TEXAS",17,86603,149417,245728,"WILLIAM MATTA","BILL FLORES","Republican",0.608058503711421,-62814,236020,-0.266138462842132
2016,"TEXAS",18,150157,48306,204308,"SHEILA JACKSON LEE","LORI BARTLEY","Democrat",0.734954088924565,101851,198463,0.513198933806301
2016,"TEXAS",21,129765,202967,356031,"TOM WAKELY","LAMAR SMITH","Republican",0.570082380466869,-73202,332732,-0.22000288520491
2016,"TEXAS",22,123679,181864,305543,"MARK GIBSON","PETE OLSON","Republican",0.595215730682752,-58185,305543,-0.190431461365503
2016,"TEXAS",23,107526,110577,228965,"PETE P GALLEGO","WILL HURD","Republican",0.482942807852729,-3051,218103,-0.0139888034552482
2016,"TEXAS",24,108389,154845,275635,"JAN MCDOWELL","KENNY MARCHANT","Republican",0.561775536488472,-46456,263234,-0.176481761474582
2016,"TEXAS",25,117073,180988,310196,"KATHI THOMAS","ROGER WILLIAMS","Republican",0.58346335865066,-63915,298061,-0.214435971160266
2016,"TEXAS",26,94507,211730,319080,"ERIC MAUCK","MICHAEL C BURGESS","Republican",0.663563996489908,-117223,306237,-0.382785228434187
2016,"TEXAS",27,88329,142251,230580,"RAUL ""ROY"" BARRERA","BLAKE FARENTHOLD","Republican",0.616926880041634,-53922,230580,-0.233853760083268
2016,"TEXAS",28,122086,57740,184442,"HENRY CUELLAR","ZEFFEN HARDIN","Democrat",0.661920820637382,64346,179826,0.357823673995974
2016,"TEXAS",29,95649,31646,131982,"GENE GREEN","JULIO GARZA","Democrat",0.724712460790108,64003,127295,0.502792725558742
2016,"TEXAS",30,170502,41518,218826,"EDDIE BERNICE JOHNSON","CHARLES LINGERFELT","Democrat",0.779167009404732,128984,212020,0.608357702103575
2016,"TEXAS",31,103852,166060,284588,"MIKE CLARK","JOHN R CARTER","Republican",0.583510197197352,-62208,269912,-0.230475117816177
2016,"TEXAS",33,93147,33222,126369,"MARC A VEASEY","M MARK MITCHELL","Democrat",0.737103245257935,59925,126369,0.47420649051587
2016,"TEXAS",34,104638,62323,166961,"FILEMON VELA","REY GONZALEZ JR","Democrat",0.626721210342535,42315,166961,0.25344242068507
2016,"TEXAS",35,124612,62384,197576,"LLOYD DOGGETT","SUSAN NARVAIZ","Democrat",0.630704134105357,62228,186996,0.332777171704208
2016,"UTAH",1,73380,182925,277451,"PETER C CLEMENS","ROB BISHOP","Republican",0.659305607116212,-109545,256305,-0.427400948089191
2016,"UTAH",2,93778,170524,276819,"CHARLENE ALBARRAN","CHRIS STEWART","Republican",0.616012629190915,-76746,264302,-0.290372377053522
2016,"UTAH",3,75716,209589,285305,"STEPHEN P TRYON","JASON CHAFFETZ","Republican",0.73461383431766,-133873,285305,-0.46922766863532
2016,"UTAH",4,113413,147597,274569,"DOUG OWENS","MIA B LOVE","Republican",0.537558864984758,-34184,261010,-0.130968162139382
2016,"VIRGINIA",1,140785,230213,384601,"M D ""MATT"" ROWE","ROBERT J WITTMAN","Republican",0.598576186749384,-89428,370998,-0.241047121547825
2016,"VIRGINIA",2,119440,190475,310567,"SHAUN D BROWN","SCOTT W TAYLOR","Republican",0.613313713305019,-71035,309915,-0.229208008647532
2016,"VIRGINIA",3,208337,103289,312340,"ROBERT C ""BOBBY"" SCOTT","M L ""MARTY"" WILLIAMS","Democrat",0.667019914196068,105048,311626,0.337096391186871
2016,"VIRGINIA",4,200136,145731,346656,"A DONALD MCEACHIN","MICHAEL L ""MIKE"" WADE","Democrat",0.577333148712268,54405,345867,0.157300349556332
2016,"VIRGINIA",5,148339,207758,356756,"JANE D DITTMAR","TOM A GARRETT JR","Republican",0.582353204991647,-59419,356097,-0.166861838207005
2016,"VIRGINIA",6,112170,225471,338409,"KAI E DEGNER","BOB GOODLATTE","Republican",0.666267741106176,-113301,337641,-0.335566474450674
2016,"VIRGINIA",7,160159,218057,379163,"EILEEN M BEDELL","DAVE BRAT","Republican",0.575100946031126,-57898,378216,-0.153081836833978
2016,"VIRGINIA",8,246653,98387,360676,"DONALD S BEYER JR","CHARLES A HERNICK","Democrat",0.683863079328816,148266,345040,0.429706700672386
2016,"VIRGINIA",9,87877,212838,310314,"DEREK W KITTS","H MORGAN GRIFFITH","Republican",0.68587946402676,-124961,300715,-0.415546281362752
2016,"VIRGINIA",10,187712,210791,400083,"LUANN L BENNETT","BARBARA COMSTOCK","Republican",0.526868174853718,-23079,398503,-0.0579142440583885
2016,"WASHINGTON",1,193619,155779,349398,"SUZAN K DELBENE","ROBERT J SUTHERLAND","Democrat",0.554150281341049,37840,349398,0.108300562682099
2016,"WASHINGTON",2,208314,117094,325408,"RICK LARSEN","MARC HENNEMANN","Democrat",0.640162503687678,91220,325408,0.280325007375356
2016,"WASHINGTON",3,119820,193457,313277,"JIM MOELLER","JAIME HERRERA BEUTLER","Republican",0.617526980914654,-73637,313277,-0.235053961829308
2016,"WASHINGTON",5,130575,192959,323534,"JOE PAKOOTAS","CATHY MCMORRIS RODGERS","Republican",0.596410269090729,-62384,323534,-0.192820538181459
2016,"WASHINGTON",6,201718,126116,327834,"DEREK KILMER","TODD A BLOOM","Democrat",0.615305306954129,75602,327834,0.230610613908258
2016,"WASHINGTON",8,127720,193145,320865,"TONY VENTRELLA","DAVID G REICHERT","Republican",0.601950976267278,-65425,320865,-0.203901952534555
2016,"WASHINGTON",9,205165,76317,281482,"ADAM SMITH","DOUG BASLER","Democrat",0.728874315231525,128848,281482,0.457748630463049
2016,"WASHINGTON",10,170460,120104,290564,"DENNY HECK","JIM POSTMA","Democrat",0.586652166132074,50356,290564,0.173304332264148
2016,"WEST VIRGINIA",1,73534,163469,237003,"MIKE MANYPENNY","DAVID B MCKINLEY","Republican",0.689733885225082,-89935,237003,-0.379467770450163
2016,"WEST VIRGINIA",2,101207,140807,242014,"MARK HUNT","ALEXANDER X MOONEY","Republican",0.581813448808747,-39600,242014,-0.163626897617493
2016,"WEST VIRGINIA",3,49708,140741,207332,"MATT DETCH","EVAN H JENKINS","Republican",0.678819477938765,-91033,190449,-0.477991483284239
2016,"WISCONSIN",1,107003,230072,354245,"RYAN SOLEN","PAUL D RYAN","Republican",0.64947141102909,-123069,337075,-0.365108655343766
2016,"WISCONSIN",2,273537,124044,398060,"MARK POCAN","PETER THERON","Democrat",0.687175300205999,149493,397581,0.376006398696115
2016,"WISCONSIN",5,114477,260706,390844,"KHARY PENEBAKER","F JAMES SENSENBRENNER JR","Republican",0.667033394397765,-146229,375183,-0.389753800145529
2016,"WISCONSIN",6,133072,204147,357183,"SARAH LLOYD","GLENN GROTHMAN","Republican",0.571547358076952,-71075,337219,-0.210768076531868
2016,"WISCONSIN",7,138643,223418,362271,"MARY HOEFT","SEAN P DUFFY","Republican",0.616715111063265,-84775,362061,-0.234145627394279
2016,"WISCONSIN",8,135682,227892,363780,"TOM NELSON","MIKE GALLAGHER","Republican",0.626455550057727,-92210,363574,-0.253620996000814
2016,"WYOMING",0,75466,156176,258788,"RYAN GREENE","LIZ CHENEY","Republican",0.603490115461304,-80710,231642,-0.348425587760423
2018,"ALABAMA",1,89226,153228,242617,"ROBERT KENNEDY JR","BRADLEY BYRNE","Republican",0.631563328208658,-64002,242454,-0.263975846964785
2018,"ALABAMA",2,86931,138879,226230,"TABITHA ISNER","MARTHA ROBY","Republican",0.613884100251956,-51948,225810,-0.230051813471503
2018,"ALABAMA",3,83996,147770,231915,"MALLORY HAGAN","MIKE ROGERS","Republican",0.637173102214173,-63774,231766,-0.275165468619211
2018,"ALABAMA",4,46492,184255,230969,"LEE AUMAN","ROBERT ADERHOLT","Republican",0.797747749698011,-137763,230747,-0.597030513939509
2018,"ALABAMA",5,101388,159063,260673,"PETER JOFFRION","MO BROOKS","Republican",0.610201286669505,-57675,260451,-0.221442804980591
2018,"ALABAMA",6,85644,192542,278328,"DANNER KLINE","GARY PALMER","Republican",0.691780920352965,-106898,278186,-0.384268079630176
2018,"ALASKA",0,131199,149779,282166,"ALYSE S GALVIN","DON YOUNG","Republican",0.530818737906055,-18580,280978,-0.0661261735794261
2018,"ARIZONA",1,143240,122784,266089,"TOM O'HALLERAN","WENDY ROGERS","Democrat",0.538316127310787,20456,266024,0.0768953177156948
2018,"ARIZONA",2,161000,133083,294152,"ANN KIRKPATRICK","LEA MARQUEZ PETERSON","Democrat",0.54733607114689,27917,294083,0.0949289826341543
2018,"ARIZONA",3,114650,64868,179518,"RAUL GRIJALVA","NICOLAS ""NICK"" PIERSON","Democrat",0.638654619592464,49782,179518,0.277309239184929
2018,"ARIZONA",4,84521,188842,277035,"DAVID BRILL","PAUL GOSAR","Republican",0.681653942642626,-104321,273363,-0.381620775306095
2018,"ARIZONA",5,127027,186037,313064,"JOAN GREENE","ANDY BIGGS","Republican",0.594245904990673,-59010,313064,-0.188491809981346
2018,"ARIZONA",6,140559,173140,313699,"ANITA MALIK","DAVID SCHWEIKERT","Republican",0.551930353619234,-32581,313699,-0.103860707238467
2018,"ARIZONA",8,135569,168835,304417,"HIRAL TIPIRNENI","DEBBIE LESKO","Republican",0.554617514790567,-33266,304404,-0.109282401019698
2018,"ARIZONA",9,159583,101662,261245,"GREG STANTON","STEPHEN L FERRARA","Democrat",0.610855710157132,57921,261245,0.221711420314264
2018,"ARKANSAS",1,57907,138757,201245,"CHINTAN DESAI","RICK CRAWFORD","Republican",0.689492906656066,-80850,196664,-0.411107269251108
2018,"ARKANSAS",2,116135,132125,253453,"CLARKE TUCKER","FRENCH HILL","Republican",0.521299807064821,-15990,248260,-0.0644082816402159
2018,"ARKANSAS",3,74952,148717,229708,"JOSH MAHONY","STEVE WOMACK","Republican",0.64741759102861,-73765,223669,-0.329795367261444
2018,"ARKANSAS",4,63984,136740,204892,"HAYDEN CATHERINE SHAMEL","BRUCE WESTERMAN","Republican",0.667375983444937,-72756,200724,-0.362467866323907
2018,"CALIFORNIA",1,131548,160046,291594,"AUDREY DENNEY","DOUG LA MALFA","Republican",0.548865888872885,-28498,291594,-0.0977317777457698
2018,"CALIFORNIA",2,243081,72576,315657,"JARED HUFFMAN","DALE K MENSING","Democrat",0.770079548370541,170505,315657,0.540159096741083
2018,"CALIFORNIA",3,134875,97376,232251,"JOHN GARAMENDI","CHARLIE SCHAUPP","Democrat",0.58072946941025,37499,232251,0.1614589388205
2018,"CALIFORNIA",4,156253,184401,340654,"JESSICA MORSE","TOM MCCLINTOCK","Republican",0.541314647707058,-28148,340654,-0.0826292954141152
2018,"CALIFORNIA",7,155016,126601,281617,"AMI BERA","ANDREW GRANT","Democrat",0.550449724270907,28415,281617,0.100899448541814
2018,"CALIFORNIA",9,113414,87349,200763,"JERRY MCNERNEY","MARLA LIVENGOOD","Democrat",0.564914849847831,26065,200763,0.129829699695661
2018,"CALIFORNIA",10,115945,105955,221900,"JOSH HARDER","JEFF DENHAM","Democrat",0.522510139702569,9990,221900,0.0450202794051374
2018,"CALIFORNIA",11,204369,71312,275681,"MARK DESAULNIER","JOHN FITZGERALD","Democrat",0.741324211679441,133057,275681,0.482648423358882
2018,"CALIFORNIA",12,275292,41780,317072,"NANCY PELOSI","LISA REMMER","Democrat",0.868231821163647,233512,317072,0.736463642327295
2018,"CALIFORNIA",14,211384,55439,266823,"JACKIE SPEIER","CRISTINA OSMENA","Democrat",0.792225557766759,155945,266823,0.584451115533518
2018,"CALIFORNIA",15,177989,65940,243929,"ERIC SWALWELL","RUDY L PETERS JR","Democrat",0.729675438344764,112049,243929,0.459350876689529
2018,"CALIFORNIA",16,82266,60693,142959,"JIM COSTA","ELIZABETH HENG","Democrat",0.575451702935807,21573,142959,0.150903405871614
2018,"CALIFORNIA",17,159105,52057,211162,"RO KHANNA","RON COHEN","Democrat",0.753473636355026,107048,211162,0.506947272710052
2018,"CALIFORNIA",18,225142,77096,302238,"ANNA G ESHOO","CHRISTINE RUSSELL","Democrat",0.744916258048293,148046,302238,0.489832516096586
2018,"CALIFORNIA",19,162496,57823,220319,"ZOE LOFGREN","JUSTIN JAMES AGUILERA","Democrat",0.737548736150763,104673,220319,0.475097472301526
2018,"CALIFORNIA",21,57239,56377,113616,"TJ COX","DAVID G VALADAO","Democrat",0.503793479791579,862,113616,0.0075869595831573
2018,"CALIFORNIA",22,105136,117243,222379,"ANDREW JANZ","DEVIN G NUNES","Republican",0.527221545199862,-12107,222379,-0.054443090399723
2018,"CALIFORNIA",23,74661,131113,205774,"TATIANA MATTA","KEVIN MCCARTHY","Republican",0.637169904847065,-56452,205774,-0.27433980969413
2018,"CALIFORNIA",24,166550,117881,284431,"SALUD CARBAJAL","JUSTIN FAREED","Democrat",0.58555502037401,48669,284431,0.17111004074802
2018,"CALIFORNIA",25,133209,111813,245022,"KATIE HILL","STEVE KNIGHT","Democrat",0.54366138550824,21396,245022,0.0873227710164802
2018,"CALIFORNIA",26,158216,97210,255426,"JULIA BROWNLEY","ANTONIO SABATO JR","Democrat",0.619420106018964,61006,255426,0.238840212037929
2018,"CALIFORNIA",28,196662,54272,250934,"ADAM B SCHIFF","JOHNNY J NALBANDIAN","Democrat",0.783720021997816,142390,250934,0.567440043995632
2018,"CALIFORNIA",29,124697,29995,154692,"TONY CARDENAS","BENITO BENNY BERNAL","Democrat",0.8060985700618,94702,154692,0.6121971401236
2018,"CALIFORNIA",30,191573,69420,260993,"BRAD SHERMAN","MARK S REED","Democrat",0.734015854831356,122153,260993,0.468031709662711
2018,"CALIFORNIA",31,110143,77352,187495,"PETE AGUILAR","SEAN FLYNN","Democrat",0.587444998533294,32791,187495,0.174889997066588
2018,"CALIFORNIA",32,121759,55272,177031,"GRACE FLORES NAPOLITANO","JOSHUA M SCOTT","Democrat",0.687783495545978,66487,177031,0.375566991091956
2018,"CALIFORNIA",33,219091,93769,312860,"TED W LIEU","KENNETH WESTON WRIGHT","Democrat",0.700284472287924,125322,312860,0.400568944575849
2018,"CALIFORNIA",35,103420,45604,149024,"NORMA J TORRES","CHRISTIAN LEONEL VALIENTE","Democrat",0.693982177367404,57816,149024,0.387964354734808
2018,"CALIFORNIA",36,122169,84839,207008,"RAUL RUIZ","KIMBERLIN BROWN PELZER","Democrat",0.590165597464832,37330,207008,0.180331194929665
2018,"CALIFORNIA",37,210555,25823,236378,"KAREN BASS","RON J BASSILIAN","Democrat",0.890755484858997,184732,236378,0.781510969717994
2018,"CALIFORNIA",38,139188,62968,202156,"LINDA T SANCHEZ","RYAN DOWNING","Democrat",0.688517778349394,76220,202156,0.377035556698787
2018,"CALIFORNIA",39,126002,118391,244393,"GIL CISNEROS","YOUNG KIM","Democrat",0.515571231581919,7611,244393,0.0311424631638386
2018,"CALIFORNIA",41,108227,58021,166248,"MARK TAKANO","AJA SMITH","Democrat",0.65099730523074,50206,166248,0.301994610461479
2018,"CALIFORNIA",42,100892,131040,231932,"JULIA C PEACOCK","KEN CALVERT","Republican",0.564993187658452,-30148,231932,-0.129986375316903
2018,"CALIFORNIA",43,152272,43780,196052,"MAXINE WATERS","OMAR NAVARRO","Democrat",0.77669189806786,108492,196052,0.553383796135719
2018,"CALIFORNIA",45,158906,146383,305289,"KATIE PORTER","MIMI WALTERS","Democrat",0.520510074060972,12523,305289,0.0410201481219435
2018,"CALIFORNIA",46,102278,45638,147916,"LOU CORREA","RUSSELL RENE LAMBERT","Democrat",0.691460017847968,56640,147916,0.382920035695936
2018,"CALIFORNIA",47,143354,77682,221036,"ALAN LOWENTHAL","JOHN BRISCOE","Democrat",0.648554986518033,65672,221036,0.297109973036067
2018,"CALIFORNIA",48,157837,136899,294736,"HARLEY ROUDA","DANA ROHRABACHER","Democrat",0.535519922914065,20938,294736,0.0710398458281309
2018,"CALIFORNIA",49,166453,128577,295030,"MIKE LEVIN","DIANE L HARKEY","Democrat",0.564190082364505,37876,295030,0.128380164729011
2018,"CALIFORNIA",50,125448,134362,259810,"AMMAR CAMPA-NAJJAR","DUNCAN HUNTER","Republican",0.517154843924406,-8914,259810,-0.0343096878488126
2018,"CALIFORNIA",51,109527,44301,153828,"JUAN VARGAS","JUAN M HIDALGO JR","Democrat",0.712009517123021,65226,153828,0.424019034246041
2018,"CALIFORNIA",52,188992,107015,296007,"SCOTT PETERS","OMAR QUDRAT","Democrat",0.638471387500971,81977,296007,0.276942775001943
2018,"CALIFORNIA",53,185667,83127,268794,"SUSAN A DAVIS","MORGAN MURTAUGH","Democrat",0.690740864751445,102540,268794,0.381481729502891
2018,"COLORADO",1,272886,85207,369693,"DIANA DEGETTE","CHARLES CASPER STOCKHAM","Democrat",0.738142188248087,187679,358093,0.524106866093445
2018,"COLORADO",2,259608,144901,430614,"JOE NEGUSE","PETER YU","Democrat",0.602878680210119,114707,404509,0.283570946505517
2018,"COLORADO",3,146426,173205,336189,"DIANE MITSCH BUSH","SCOTT R TIPTON","Republican",0.515201270713795,-26779,319631,-0.0837809849482685
2018,"COLORADO",4,145544,224038,369582,"KAREN MCCORMICK","KEN BUCK","Republican",0.606192942296973,-78494,369582,-0.212385884593947
2018,"COLORADO",5,126848,184002,322645,"STEPHANY ROSE SPAULDING","DOUG LAMBORN","Republican",0.570292426660881,-57154,310850,-0.183863599806981
2018,"COLORADO",6,187639,148685,346817,"JASON CROW","MIKE COFFMAN","Democrat",0.54103172566512,38954,336324,0.115822837501933
2018,"COLORADO",7,204260,119734,338006,"ED PERLMUTTER","MARK BARRINGTON","Democrat",0.604308799252084,84526,323994,0.260887547300259
2018,"CONNECTICUT",1,166155,96024,274140,"JOHN B LARSON","JENNIFER T NYE","Democrat",0.6060954256949,70131,262179,0.267492819791059
2018,"CONNECTICUT",2,167659,102483,289114,"JOE COURTNEY","DANNY POSTEMSKI JR","Democrat",0.579906196171752,65176,270142,0.241265704703452
2018,"CONNECTICUT",3,163211,95667,270239,"ROSA L DELAURO","ANGEL CADENA","Democrat",0.603950577081768,67544,258878,0.260910544735358
2018,"CONNECTICUT",4,168726,103175,275651,"JIM HIMES","HARRY ARORA","Democrat",0.612100083076064,65551,271901,0.241084071040563
2018,"CONNECTICUT",5,142901,115146,270664,"JAHANA HAYES","MANNY SANTOS","Democrat",0.527964561227204,27755,258047,0.107557925494193
2018,"DELAWARE",0,227353,125384,352737,"LISA BLUNT ROCHESTER","SCOTT WALKER","Democrat",0.644539699549523,101969,352737,0.289079399099045
2018,"FLORIDA",1,106199,216189,322388,"JENNIFER M ZIMMERMAN","MATT GAETZ","Republican",0.670586374182662,-109990,322388,-0.341172748365324
2018,"FLORIDA",2,96233,199335,295568,"BOB RACKLEFF","NEAL DUNN","Republican",0.674413332972446,-103102,295568,-0.348826665944893
2018,"FLORIDA",3,129880,176616,306496,"YVONNE HAYES HINSON","TED YOHO","Republican",0.576242430570056,-46736,306496,-0.152484861140113
2018,"FLORIDA",4,123351,248420,381249,"GEORGE ""GES"" SELMONT","JOHN H RUTHERFORD","Republican",0.651595151724988,-125069,371771,-0.336414082862838
2018,"FLORIDA",5,180527,89799,270326,"AL LAWSON","VIRGINIA FULLER","Democrat",0.667812197124953,90728,270326,0.335624394249906
2018,"FLORIDA",6,145758,187891,333649,"NANCY SODERBERG","MICHAEL WALTZ","Republican",0.563139706697757,-42133,333649,-0.126279413395514
2018,"FLORIDA",7,183113,134285,317398,"STEPHANIE MURPHY","MIKE MILLER","Democrat",0.576919199238811,48828,317398,0.153838398477621
2018,"FLORIDA",8,142415,218112,360527,"SANJAY PATEL","BILL POSEY","Republican",0.604981041641819,-75697,360527,-0.209962083283638
2018,"FLORIDA",9,172172,124565,296737,"DARREN SOTO","WAYNE LIEBNITZKY","Democrat",0.580217498997429,47607,296737,0.160434997994857
2018,"FLORIDA",11,128053,239395,367506,"DANA COTTRELL","DANIEL WEBSTER","Republican",0.651404330813647,-111342,367448,-0.303014304064793
2018,"FLORIDA",12,132844,194564,334918,"CHRIS HUNTER","GUS MICHAEL BILIRAKIS","Republican",0.580930257555581,-61720,327408,-0.188510971020867
2018,"FLORIDA",13,182717,134254,316971,"CHARLIE CRIST","GEORGE BUCK","Democrat",0.5764470566708,48463,316971,0.152894113341599
2018,"FLORIDA",15,134132,151380,285532,"KRISTEN CARLSON","ROSS SPANO","Republican",0.530168247341804,-17248,285512,-0.0604107708257446
2018,"FLORIDA",16,164463,197483,361946,"DAVID SHAPIRO","VERN BUCHANAN","Republican",0.545614539185403,-33020,361946,-0.0912290783708067
2018,"FLORIDA",17,117194,193326,310520,"ALLEN ELLISON","GREG STEUBE","Republican",0.62258791704238,-76132,310520,-0.245175834084761
2018,"FLORIDA",18,156454,185905,342359,"LAUREN BAER","BRIAN MAST","Republican",0.543011867659387,-29451,342359,-0.0860237353187736
2018,"FLORIDA",19,128106,211465,339607,"DAVID HOLDEN","FRANCIS ROONEY","Republican",0.622675622116152,-83359,339571,-0.245483271539678
2018,"FLORIDA",22,184634,113049,297683,"TED DEUTCH","NICOLAS KIMAZ","Democrat",0.620236963481287,71585,297683,0.240473926962574
2018,"FLORIDA",23,161611,99446,276366,"DEBBIE WASSERMAN SCHULTZ","JOSEPH ""JOE"" KAUFMAN","Democrat",0.584771643400418,62165,261057,0.238128071647188
2018,"FLORIDA",25,84173,128672,212845,"MARY BARZEE FLORES","MARIO DIAZ-BALART","Republican",0.604533815687472,-44499,212845,-0.209067631374944
2018,"FLORIDA",26,119797,115678,235475,"DEBBIE MUCARSEL-POWELL","CARLOS CURBELO","Democrat",0.508746151396114,4119,235475,0.0174923027922285
2018,"FLORIDA",27,130743,115588,252586,"DONNA SHALALA","MARIA ELVIRA SALAZAR","Democrat",0.517617761871204,15155,246331,0.0615229102305435
2018,"GEORGIA",1,105942,144741,250683,"LISA M RING","EARL L ""BUDDY"" CARTER","Republican",0.577386579863812,-38799,250683,-0.154773159727624
2018,"GEORGIA",2,136699,92472,229171,"SANFORD BISHOP","HERMAN WEST JR","Democrat",0.59649344812389,44227,229171,0.19298689624778
2018,"GEORGIA",3,101010,191996,293006,"CHUCK ENDERLIN","DREW FERGUSON","Republican",0.655263032156338,-90986,293006,-0.310526064312676
2018,"GEORGIA",4,227717,61092,288809,"HENRY C ""HANK"" JOHNSON JR","JOE PROFIT","Democrat",0.78846919590456,166625,288809,0.57693839180912
2018,"GEORGIA",6,160139,156875,317014,"LUCY MCBATH","KAREN HANDEL","Democrat",0.505148037626099,3264,317014,0.0102960752521971
2018,"GEORGIA",7,140011,140430,280441,"CAROLYN BOURDEAUX","ROB WOODALL","Republican",0.500747037701335,-419,280441,-0.00149407540266937
2018,"GEORGIA",9,57912,224661,282573,"JOSH MCCALL","DOUG COLLINS","Republican",0.795054729220414,-166749,282573,-0.590109458440828
2018,"GEORGIA",10,112339,190396,302735,"TABITHA A JOHNSON-GREEN","JODY HICE","Republican",0.628919682230333,-78057,302735,-0.257839364460667
2018,"GEORGIA",11,118653,191887,310540,"FLYNN D BROADY JR","BARRY LOUDERMILK","Republican",0.617913956334128,-73234,310540,-0.235827912668255
2018,"GEORGIA",12,101503,148986,250489,"FRANCYS JOHNSON","RICK W ALLEN","Republican",0.594780609128545,-47483,250489,-0.189561218257089
2018,"GEORGIA",13,223157,69760,292917,"DAVID SCOTT","DAVID CALLAHAN","Democrat",0.761843798755279,153397,292917,0.523687597510558
2018,"GEORGIA",14,53981,175743,229724,"STEVEN LAMAR FOSTER","TOM GRAVES","Republican",0.765018021625951,-121762,229724,-0.530036043251902
2018,"HAWAII",1,134650,42498,184211,"ED CASE","CAM CAVASSO","Democrat",0.730955263257895,92152,177148,0.520197800709012
2018,"HAWAII",2,153271,44850,198121,"TULSI GABBARD","BRIAN EVANS","Democrat",0.773623189868818,108421,198121,0.547246379737635
2018,"IDAHO",1,96922,197719,315069,"CRISTINA MCNEIL","RUSS FULCHER","Republican",0.627541903519547,-100797,294641,-0.342101065364291
2018,"IDAHO",2,110381,170274,280655,"AARON SWISHER","MIKE SIMPSON","Republican",0.606702178831662,-59893,280655,-0.213404357663323
2018,"ILLINOIS",1,189560,50960,257885,"BOBBY L RUSH","JIMMY LEE TILLMAN II","Democrat",0.735056323555073,138600,240520,0.576251455180442
2018,"ILLINOIS",2,190684,44567,235251,"ROBIN KELLY","DAVID MERKLE","Democrat",0.810555534301661,146117,235251,0.621111068603322
2018,"ILLINOIS",3,163053,57885,223334,"DANIEL WILLIAM LIPINSKI","ARTHUR J JONES","Democrat",0.730085880340656,105168,220938,0.476006843548869
2018,"ILLINOIS",4,143895,22294,166189,"JESUS ""CHUY"" GARCIA","MARK WAYNE LORCH","Democrat",0.865851530486374,121601,166189,0.731703060972748
2018,"ILLINOIS",5,213992,65134,279131,"MIKE QUIGLEY","TOM HANSON","Democrat",0.766636453851417,148858,279126,0.533300373308112
2018,"ILLINOIS",6,169001,146445,315446,"SEAN CASTEN","PETER J ROSKAM","Democrat",0.535752553527387,22556,315446,0.0715051070547732
2018,"ILLINOIS",7,215746,30497,246243,"DANNY K DAVIS","CRAIG CAMERON","Democrat",0.876150794134249,185249,246243,0.752301588268499
2018,"ILLINOIS",8,130054,67073,197127,"RAJA KRISHNAMOORTHI","JITENDRA ""JD"" DIGANVKER","Democrat",0.659747269526752,62981,197127,0.319494539053504
2018,"ILLINOIS",9,213368,76983,290351,"JANICE D SCHAKOWSKY","JOHN D ELLESON","Democrat",0.734862287369425,136385,290351,0.469724574738851
2018,"ILLINOIS",10,156540,82124,238664,"BRAD SCHNEIDER","DOUGLAS R BENNETT","Democrat",0.655901183253444,74416,238664,0.311802366506888
2018,"ILLINOIS",11,145407,82358,227765,"BILL FOSTER","NICK STELLA","Democrat",0.638408008254122,63049,227765,0.276816016508243
2018,"ILLINOIS",12,118724,134884,261543,"BRENDAN KELLY","MIKE BOST","Republican",0.515723991848377,-16160,253608,-0.0637203873694836
2018,"ILLINOIS",13,134458,136516,270981,"BETSY DIRKSEN LONDRIGAN","RODNEY DAVIS","Republican",0.503784398168137,-2058,270974,-0.00759482459571767
2018,"ILLINOIS",14,156035,141164,297199,"LAUREN UNDERWOOD","RANDALL M ""RANDY"" HULTGREN","Democrat",0.525018590237518,14871,297199,0.0500371804750352
2018,"ILLINOIS",15,74309,181294,255608,"KEVIN GAITHER","JOHN M SHIMKUS","Republican",0.70926575068073,-106985,255603,-0.418559250087049
2018,"ILLINOIS",16,104569,151254,255825,"SARA DADY","ADAM KINZINGER","Republican",0.591240105540897,-46685,255823,-0.182489455600161
2018,"ILLINOIS",17,142659,87090,229749,"CHERI BUSTOS","WILLIAM W ""BILL"" FAWELL","Democrat",0.620934149876604,55569,229749,0.241868299753209
2018,"ILLINOIS",18,95486,195927,291413,"JUNIUS RODRIGUEZ","DARIN LAHOOD","Republican",0.672334453164409,-100441,291413,-0.344668906328819
2018,"INDIANA",1,159611,85594,245209,"PETER J VISCLOSKY","MARK LEYVA","Democrat",0.650918196314165,74017,245205,0.30185762933056
2018,"INDIANA",2,103363,125499,228889,"MEL HALL","JACKIE WALORSKI","Republican",0.548296335778478,-22136,228862,-0.0967220421039753
2018,"INDIANA",3,86610,158927,245537,"COURTNEY TRITCH","JIM BANKS","Republican",0.647262937968616,-72317,245537,-0.294525875937231
2018,"INDIANA",4,87824,156539,244363,"TOBI BECK","JIM BAIRD","Republican",0.640600254539353,-68715,244363,-0.281200509078707
2018,"INDIANA",5,137142,180035,317177,"DEE THORNTON","SUSAN W BROOKS","Republican",0.567616819630679,-42893,317177,-0.135233639261359
2018,"INDIANA",6,79430,154260,241726,"JEANNINE LEE LAKE","GREG PENCE","Republican",0.638160561958581,-74830,233690,-0.320210535324575
2018,"INDIANA",7,141139,76457,217596,"ANDRE D CARSON","WAYNE ""GUNNY"" HARMON","Democrat",0.648628651261972,64682,217596,0.297257302523943
2018,"INDIANA",8,86895,157396,244291,"WILLIAM TANOOS","LARRY D BUCSHON","Republican",0.644297170178189,-70501,244291,-0.288594340356378
2018,"INDIANA",9,118090,153271,271361,"LIZ WATSON","TREY HOLLINGSWORTH","Republican",0.564823242838875,-35181,271361,-0.12964648567775
2018,"IOWA",1,170342,153442,334243,"ABBY FINKENAUER","ROD BLUM","Democrat",0.509635205524125,16900,323784,0.0521952906876189
2018,"IOWA",2,171446,133287,312913,"DAVE LOEBSACK","CHRISTOPHER PETERS","Democrat",0.547903091274571,38159,304733,0.125221095188247
2018,"IOWA",3,175642,167933,356241,"CINDY AXNE","DAVID YOUNG","Democrat",0.493042631252439,7709,343575,0.0224376045987048
2018,"IOWA",4,147246,157676,313251,"JD SCHOLTEN","STEVE KING","Republican",0.50335354077082,-10430,304922,-0.0342054689395977
2018,"KANSAS",1,71558,153082,224640,"ALAN LAPOLICE","ROGER MARSHALL","Republican",0.681454772079772,-81524,224640,-0.362909544159544
2018,"KANSAS",2,123859,126098,264688,"PAUL DAVIS","STEVE WATKINS","Republican",0.476402405851418,-2239,249957,-0.00895754069699988
2018,"KANSAS",3,170518,139762,318301,"SHARICE DAVIDS","KEVIN YODER","Democrat",0.535713051482716,30756,310280,0.0991233724377981
2018,"KANSAS",4,98445,144248,242693,"JAMES A THOMPSON","RON ESTES","Republican",0.594364073129427,-45803,242693,-0.188728146258854
2018,"KENTUCKY",1,78849,172167,251016,"PAUL WALKER","JAMES R COMER","Republican",0.685880581317526,-93318,251016,-0.371761162635051
2018,"KENTUCKY",2,79964,171700,257345,"HANK LINDERMAN","S BRETT GUTHRIE","Republican",0.667197730672832,-91736,251664,-0.364517769724712
2018,"KENTUCKY",3,173002,101930,278720,"JOHN A YARMUTH","VICKIE YATES B GLISSON","Democrat",0.62070177956372,71072,274932,0.258507558232581
2018,"KENTUCKY",4,90536,162946,261812,"SETH HALL","THOMAS MASSIE","Republican",0.622377889477946,-72410,253482,-0.285661309284288
2018,"KENTUCKY",5,45890,172093,218017,"KENNETH S STEPP","HAROLD ""HAL"" ROGERS","Republican",0.789355875917933,-126203,217983,-0.578957992137001
2018,"KENTUCKY",6,144736,154468,302888,"AMY MCGRATH","ANDY BARR","Republican",0.509983888434009,-9732,299204,-0.0325263031242898
2018,"LOUISIANA",1,71521,192555,269325,"""JIM"" FRANCIS","STEVE SCALISE","Republican",0.714954051796157,-121034,264076,-0.458330177676124
2018,"LOUISIANA",3,74713,168263,245943,"""ROB"" ANDERSON","""JOSH"" GUILLORY","Republican",0.684154458553405,-93550,242976,-0.385017450283156
2018,"LOUISIANA",4,72934,139326,216872,"RYAN TRUNDLE","""MIKE"" JOHNSON","Republican",0.642434246929064,-66392,212260,-0.312786205596909
2018,"LOUISIANA",5,67118,149018,223946,"JESSEE CARLTON FLEENOR","RALPH ABRAHAM","Republican",0.665419342162843,-81900,216136,-0.37892808231854
2018,"LOUISIANA",6,76716,186553,268525,"""ANDIE"" SAIZAN","GARRET GRAVES","Republican",0.694732334047109,-109837,263269,-0.417204456278559
2018,"MAINE",1,201195,111188,342053,"CHELLIE PINGREE","MARK I HOLBROOK","Democrat",0.58819832014337,90007,312383,0.288130275975325
2018,"MAINE",2,139231,136326,281371,"JARED F GOLDEN","BRUCE POLIQUIN","Democrat",0.49483066840577,2905,275557,0.0105422834477077
2018,"MARYLAND",1,116631,183662,306132,"JESSE COLVIN","ANDY HARRIS","Republican",0.599943815086303,-67031,300293,-0.223218656445538
2018,"MARYLAND",2,167201,77782,253302,"CA DUTCH RUPPERSBERGER","LIZ MATORY","Democrat",0.660085589533442,89419,244983,0.365000836792757
2018,"MARYLAND",3,202407,82774,292880,"JOHN SARBANES","CHARLES ANTHONY","Democrat",0.691091914777383,119633,285181,0.419498493938937
2018,"MARYLAND",4,209642,53327,268583,"ANTHONY G BROWN","GEORGE MCDERMOTT","Democrat",0.780548284887726,156315,262969,0.594423677315577
2018,"MARYLAND",5,213796,82361,304209,"STENY H HOYER","WILLIAM A DEVINE III","Democrat",0.702793145501941,131435,296157,0.443801767305855
2018,"MARYLAND",6,163346,105209,276974,"DAVID TRONE","AMIE HOEBER","Democrat",0.589752106695935,58137,268555,0.216480795367802
2018,"MARYLAND",7,202345,56266,264710,"ELIJAH CUMMINGS","RICHMOND DAVIS","Democrat",0.764402553738053,146079,258611,0.564859963419963
2018,"MARYLAND",8,217679,96525,319330,"JAMIE RASKIN","JOHN WALSH","Democrat",0.681674130210127,121154,314204,0.385590253465901
2018,"MASSACHUSETTS",2,191332,93391,284893,"JAMES P MCGOVERN","TRACY LYN LOVVORN","Democrat",0.671592492620036,97941,284723,0.343986962767321
2018,"MASSACHUSETTS",3,173175,93445,279327,"LORI LOUREIRO TRAHAN","RICK GREEN","Democrat",0.619972290541194,79730,266620,0.299039831970595
2018,"MASSACHUSETTS",5,236243,74856,311324,"KATHERINE M CLARK","JOHN HUGO","Democrat",0.758833241253485,161387,311099,0.518764123317658
2018,"MASSACHUSETTS",6,217703,104798,333975,"SETH W MOULTON","JOSEPH S SCHNEIDER","Democrat",0.651854180702148,112905,322501,0.350091937699418
2018,"MASSACHUSETTS",9,192347,131463,323928,"BILL KEATING","PETER D TEDESCHI","Democrat",0.593795534810205,60884,323810,0.18802384114141
2018,"MICHIGAN",1,145246,187251,332497,"MATTHEW W MORGAN","JACK BERGMAN","Republican",0.563165983452482,-42005,332497,-0.126331966904965
2018,"MICHIGAN",2,131254,168970,305463,"ROB DAVIDSON","BILL HUIZENGA","Republican",0.553160284551648,-37716,300224,-0.125626199104669
2018,"MICHIGAN",3,134185,169107,310740,"CATHY ALBRO","JUSTIN AMASH","Republican",0.544207375941301,-34922,303292,-0.115143162364982
2018,"MICHIGAN",4,106540,178510,285050,"JERRY HILLIARD","JOHN MOOLENAAR","Republican",0.626241010349062,-71970,285050,-0.252482020698123
2018,"MICHIGAN",5,164502,99265,276413,"DANIEL T KILDEE","TRAVIS WINES","Democrat",0.595131198604986,65237,263767,0.247328134300348
2018,"MICHIGAN",6,134082,147436,293438,"MATT LONGJOHN","FRED UPTON","Republican",0.502443446315746,-13354,281518,-0.0474356879489056
2018,"MICHIGAN",7,136330,158730,295060,"GRETCHEN DRISKELL","TIM WALBERG","Republican",0.537958381346167,-22400,295060,-0.0759167626923338
2018,"MICHIGAN",8,172880,159782,341593,"ELISSA SLOTKIN","MIKE BISHOP","Democrat",0.506099363862843,13098,332662,0.0393732978218131
2018,"MICHIGAN",9,181734,112123,304563,"ANDY LEVIN","CANDIUS STEARNS","Democrat",0.596704130179963,69611,293857,0.236887329551449
2018,"MICHIGAN",10,106061,182808,303064,"KIMBERLY BIZON","PAUL MITCHELL","Republican",0.603199324235145,-76747,288869,-0.265680983421551
2018,"MICHIGAN",11,181912,158463,350901,"HALEY STEVENS","LENA EPSTEIN","Democrat",0.518414025608362,23449,340375,0.0688916636063166
2018,"MICHIGAN",12,200588,85115,294628,"DEBBIE DINGELL","JEFF JONES","Democrat",0.680817844875572,115473,285703,0.404171464772859
2018,"MICHIGAN",14,214334,45899,264994,"BRENDA LAWRENCE","MARC S HERSCHFUS","Democrat",0.808825860208156,168435,260233,0.647246890286782
2018,"MISSISSIPPI",1,76601,158245,236521,"RANDY MACK WADKINS","TRENT KELLY","Republican",0.669052642260095,-81644,234846,-0.347649097706582
2018,"MISSISSIPPI",3,94461,160284,257271,"MICHAEL TED EVANS","MICHAEL GUEST","Republican",0.623016196928531,-65823,254745,-0.25838779956427
2018,"MISSISSIPPI",4,68787,152633,223732,"JERAMEY ANDERSON","STEVEN PALAZZO","Republican",0.68221354120108,-83846,221420,-0.378674013187607
2018,"MISSOURI",1,219781,45867,274375,"LACY CLAY","ROBERT VROMAN","Democrat",0.801024145785877,173914,265648,0.654678371378666
2018,"MISSOURI",2,177611,192477,376066,"CORT VANOSTRAN","ANN WAGNER","Republican",0.511817074662426,-14866,370088,-0.0401688247119604
2018,"MISSOURI",3,106589,211243,324608,"KATY GEPPERT","BLAINE LUETKEMEYER","Republican",0.650763382294953,-104654,317832,-0.329274585315513
2018,"MISSOURI",4,95968,190138,293316,"RENEE HOAGENSON","VICKY HARTZLER","Republican",0.648236032129171,-94170,286106,-0.329143743927076
2018,"MISSOURI",5,175019,101069,283785,"EMANUEL CLEAVER II","JACOB TURK","Democrat",0.616730975914865,73950,276088,0.267849381356669
2018,"MISSOURI",6,97660,199796,305409,"HENRY ROBERT MARTIN","SAM GRAVES","Republican",0.65419159225825,-102136,297456,-0.343365069119466
2018,"MISSOURI",7,89190,196343,296455,"JAMIE DANIEL SCHOOLCRAFT","BILLY LONG","Republican",0.662302879020425,-107153,285533,-0.375273611106247
2018,"MISSOURI",8,66151,194042,264399,"KATHY ELLIS","JASON SMITH","Republican",0.733898388420531,-127891,260193,-0.491523599789387
2018,"MONTANA",0,233284,256661,504421,"KATHLEEN WILLIAMS","GREG GIANFORTE","Republican",0.508822987147641,-23377,489945,-0.0477135188643623
2018,"NEBRASKA",1,93069,141712,234781,"JESSICA MCCLURE","JEFF FORTENBERRY","Republican",0.603592283873056,-48643,234781,-0.207184567746112
2018,"NEBRASKA",2,121770,126715,248485,"KARA EASTMAN","DON BACON","Republican",0.509950298810793,-4945,248485,-0.0199005976215868
2018,"NEBRASKA",3,49654,163650,213304,"PAUL THEOBALD","ADRIAN SMITH","Republican",0.767214867044219,-113996,213304,-0.534429734088437
2018,"NEVADA",1,100707,46978,152201,"DINA TITUS","JOYCE BENTLEY","Democrat",0.661671079690672,53729,147685,0.363808105088533
2018,"NEVADA",2,120102,167435,287537,"CLINT KOBLE","MARK E AMODEI","Republican",0.582307668230523,-47333,287537,-0.164615336461047
2018,"NEVADA",3,148501,122566,286168,"SUSIE LEE","DANNY TARKANIAN","Democrat",0.518929440049202,25935,271067,0.0956774524379581
2018,"NEVADA",4,121962,102748,234868,"STEVEN A HORSFORD","CRESENT HARDY","Democrat",0.519278914113459,19214,224710,0.0855057629834008
2018,"NEW HAMPSHIRE",1,155884,130996,291039,"CHRIS PAPPAS","EDDIE EDWARDS","Democrat",0.535612065736894,24888,286880,0.0867540435025098
2018,"NEW HAMPSHIRE",2,155358,117990,279705,"ANNE MCLANE KUSTER","STEVEN NEGRON","Democrat",0.555435190647289,37368,273348,0.136704859739233
2018,"NEW JERSEY",1,169628,87617,263418,"DONALD W NORCROSS","PAUL E DILKS","Democrat",0.643949919899172,82011,257245,0.318805030224105
2018,"NEW JERSEY",2,136685,116866,258363,"JEFF VAN DREW","SETH GROSSMAN","Democrat",0.529042471251688,19819,253551,0.0781657339154647
2018,"NEW JERSEY",3,153473,149500,306875,"ANDY KIM","TOM MACARTHUR","Democrat",0.500115682281059,3973,302973,0.0131133797401089
2018,"NEW JERSEY",4,126766,163065,294348,"JOSHUA WELLE","CHRISTOPHER H SMITH","Republican",0.553987117289739,-36299,289831,-0.125241951344059
2018,"NEW JERSEY",5,169546,128255,301823,"JOSH GOTTHEIMER","JOHN J MCCANN JR","Democrat",0.56173982764733,41291,297801,0.138652993106135
2018,"NEW JERSEY",6,140752,80443,221195,"FRANK PALLONE JR","RICHARD J PEZZULLO","Democrat",0.636325414227266,60309,221195,0.272650828454531
2018,"NEW JERSEY",7,166985,150785,322742,"TOM MALINOWSKI","LEONARD LANCE","Democrat",0.517394699171474,16200,317770,0.0509802687478365
2018,"NEW JERSEY",8,119881,28725,153455,"ALBIO SIRES","JOHN R MUNIZ","Democrat",0.781212733374605,91156,148606,0.613407264847987
2018,"NEW JERSEY",9,140832,57854,200416,"BILL PASCRELL JR","ERIC P FISHER","Democrat",0.702698387354303,82978,198686,0.417633854423563
2018,"NEW JERSEY",10,175253,20191,200159,"DONALD M PAYNE JR","AGHA KHAN","Democrat",0.875568922706448,155062,195444,0.793383270911361
2018,"NEW JERSEY",11,183684,136322,323574,"MIKIE SHERRILL","JAY WEBBER","Democrat",0.567672309888928,47362,320006,0.148003474934845
2018,"NEW JERSEY",12,173334,79041,252375,"BONNIE WATSON COLEMAN","DARYL KIPNIS","Democrat",0.686811292719168,94293,252375,0.373622585438336
2018,"NEW MEXICO",1,147336,90507,249162,"DEBRA A HAALAND","JANICE E ARNOLD-JONES","Democrat",0.591326125171575,56829,237843,0.238934927662366
2018,"NEW MEXICO",2,101489,97767,199256,"XOCHITL TORRES SMALL","YVETTE HERRELL","Democrat",0.509339743847111,3722,199256,0.0186794876942225
2018,"NEW MEXICO",3,155201,76427,244893,"BEN R LUJAN","JERALD STEVE MCFALL","Democrat",0.633750250109231,78774,231628,0.340088417635174
2018,"NEW YORK",1,124213,121562,270053,"PERRY GERSHON","LEE M ZELDIN","Democrat",0.459957860123754,2651,245775,0.0107862882717933
2018,"NEW YORK",2,108803,112565,241217,"LIUBA GRECHEN SHIRLEY","PETER T KING","Republican",0.466654506108608,-3762,221368,-0.0169943261898739
2018,"NEW YORK",3,149937,98716,267062,"THOMAS R SUOZZI","DAN P DEBONO","Democrat",0.561431427908126,51221,248653,0.205993895106836
2018,"NEW YORK",4,156728,90306,260206,"KATHLEEN M RICE","AMEER N BENNO","Democrat",0.60232277503209,66422,247034,0.268877968214902
2018,"NEW YORK",9,167269,18702,203423,"YVETTE D CLARKE","LUTCHI GAYOT","Democrat",0.822271817837708,148567,185971,0.798871867119067
2018,"NEW YORK",10,162131,33692,210958,"JERROLD L NADLER","NAOMI LEVIN","Democrat",0.768546345718105,128439,195823,0.655893332243914
2018,"NEW YORK",11,96850,80440,192173,"MAX N ROSE","DAN DONOVAN","Democrat",0.503972982677067,16410,177290,0.0925602120818997
2018,"NEW YORK",12,205858,30446,251877,"CAROLYN B MALONEY","ELIOT RABIN","Democrat",0.817295743557371,175412,236304,0.742314984088293
2018,"NEW YORK",13,171341,9535,190688,"ADRIANO ESPAILLAT","JINEEA BUTLER","Democrat",0.898541072327572,161806,180876,0.894568654769013
2018,"NEW YORK",14,110318,19202,141204,"ALEXANDRIA OCASIO-CORTEZ","ANTHONY PAPPAS","Democrat",0.781266819636838,91116,129520,0.70348980852378
2018,"NEW YORK",15,122007,4566,129751,"JOSE E SERRANO","JASON D GONZALEZ","Democrat",0.940316452281678,117441,126573,0.927851911545116
2018,"NEW YORK",18,126368,96345,251690,"SEAN PATRICK MALONEY","JAMES O'DONNELL","Democrat",0.502077953037467,30023,222713,0.134805781431708
2018,"NEW YORK",19,135582,112304,287986,"ANTONIO DELGADO","JOHN J FASO","Democrat",0.470793719139125,23278,247886,0.0939060697255997
2018,"NEW YORK",20,161330,89058,266014,"PAUL D TONKO","JOE VITOLLO","Democrat",0.606471839827979,72272,250388,0.288640030672396
2018,"NEW YORK",21,93394,116433,235267,"TEDRA L COBB","ELISE M STEFANIK","Republican",0.494897286912317,-23039,209827,-0.109799978077178
2018,"NEW YORK",22,116001,110125,251212,"ANTHONY J BRINDISI","CLAUDIA TENNEY","Democrat",0.461765361527316,5876,226126,0.0259855125018795
2018,"NEW YORK",23,100914,114722,240374,"TRACY MITRANO","THOMAS W REED II","Republican",0.47726459600456,-13808,215636,-0.0640338347956742
2018,"NEW YORK",24,115902,113538,260477,"DANA BALTER","JOHN M KATKO","Democrat",0.444960591530154,2364,229440,0.0103033472803347
2018,"NEW YORK",25,147979,91342,270120,"JOSEPH D MORELLE","JIM MAXWELL","Democrat",0.547826891751814,56637,239321,0.236657042215267
2018,"NEW YORK",26,156968,61488,230663,"BRIAN HIGGINS","RENEE M ZENO","Democrat",0.680507927149131,95480,218456,0.437067418610613
2018,"NEW YORK",27,128167,114506,285300,"NATHAN D MCMURRAY","CHRIS COLLINS","Democrat",0.449235892043463,13661,242673,0.056293860462433
2018,"NORTH CAROLINA",1,190457,82218,272675,"G K BUTTERFIELD","ROGER W ALLISON","Democrat",0.698476207939855,108239,272675,0.39695241587971
2018,"NORTH CAROLINA",2,151977,170072,331704,"LINDA COLEMAN","GEORGE HOLDING","Republican",0.51272218604539,-18095,322049,-0.0561871019627448
2018,"NORTH CAROLINA",4,247067,82052,341403,"DAVID PRICE","STEVE A ""VON"" LOOR","Democrat",0.723681397058608,165015,329119,0.501383997885263
2018,"NORTH CAROLINA",5,120468,159917,280385,"DD ADAMS","VIRGINIA FOXX","Republican",0.57034791447474,-39449,280385,-0.14069582894948
2018,"NORTH CAROLINA",6,123651,160709,284360,"RYAN WATTS","B MARK WALKER","Republican",0.565160360106907,-37058,284360,-0.130320720213813
2018,"NORTH CAROLINA",7,120838,156809,282312,"KYLE HORTON","DAVID ROUZER","Republican",0.555445747966788,-35971,277647,-0.129556595245041
2018,"NORTH CAROLINA",8,114119,141402,255521,"FRANK MCNEILL","RICHARD HUDSON","Republican",0.553387001459763,-27283,255521,-0.106774002919525
2018,"NORTH CAROLINA",9,138341,139246,282717,"DAN MCCREADY","MARK HARRIS","Republican",0.492527863552599,-905,277587,-0.00326023913223602
2018,"NORTH CAROLINA",10,113259,164969,278228,"DAVID WILSON BROWN","PATRICK MCHENRY","Republican",0.592927383297152,-51710,278228,-0.185854766594304
2018,"NORTH CAROLINA",11,116508,178012,300666,"PHILLIP G PRICE","MARK MEADOWS","Republican",0.592058962436724,-61504,294520,-0.208827923400788
2018,"NORTH CAROLINA",12,203974,75164,279138,"ALMA ADAMS","PAUL WRIGHT","Democrat",0.730728170295696,128810,279138,0.461456340591392
2018,"NORTH CAROLINA",13,130402,147570,286316,"KATHY MANNING","TED BUDD","Republican",0.51540954749298,-17168,277972,-0.0617616162778985
2018,"OHIO",1,141118,154409,300871,"AFTAB PUREVAL","STEVE CHABOT","Republican",0.513206656673458,-13291,295527,-0.044973894094279
2018,"OHIO",2,119333,166714,289661,"JILL SCHILLER","BRAD WENSTRUP","Republican",0.575548658604369,-47381,286047,-0.165640611507899
2018,"OHIO",3,181575,65040,246677,"JOYCE BEATTY","JIM BURGESS","Democrat",0.736084028912302,116535,246615,0.472538166778177
2018,"OHIO",4,89412,167993,257405,"JANET GARRETT","JIM JORDAN","Republican",0.652640780093627,-78581,257405,-0.305281560187254
2018,"OHIO",5,99655,176569,283617,"J MICHAEL GALBRAITH","BOB LATTA","Republican",0.622561412045117,-76914,276224,-0.278447926320667
2018,"OHIO",6,76716,172774,249490,"SHAWNA ROBERTS","BILL JOHNSON","Republican",0.69250871778428,-96058,249490,-0.38501743556856
2018,"OHIO",7,107536,153117,260653,"KEN HARBAUGH","BOB GIBBS","Republican",0.587436169927068,-45581,260653,-0.174872339854136
2018,"OHIO",8,87281,173852,261133,"VANESSA ENOCH","WARREN DAVIDSON","Republican",0.665760359663466,-86571,261133,-0.331520719326933
2018,"OHIO",9,157219,74670,231937,"MARCY KAPTUR","STEVEN W KRAUS","Democrat",0.67785217537521,82549,231889,0.355984975570208
2018,"OHIO",10,118785,157554,281726,"THERESA A GASPER","MIKE TURNER","Republican",0.559245508046826,-38769,276339,-0.140295072356779
2018,"OHIO",11,206138,44486,250660,"MARCIA L FUDGE","BEVERLY A GOLDSTEIN","Democrat",0.822380914386021,161652,250624,0.644998084780388
2018,"OHIO",12,161251,175677,341647,"DANNY O'CONNOR","TROY BALDERSON","Republican",0.514206183575445,-14426,336928,-0.0428162693513154
2018,"OHIO",13,153323,98047,251370,"TIM RYAN","CHRIS DEPIZZO","Democrat",0.60994947686677,55276,251370,0.21989895373354
2018,"OHIO",14,137549,169809,307358,"BETSY RADER","DAVID P JOYCE","Republican",0.552479518997391,-32260,307358,-0.104959037994781
2018,"OHIO",15,116112,170593,292443,"RICK NEAL","STEVE STIVERS","Republican",0.583337607670555,-54481,286705,-0.190024589735094
2018,"OHIO",16,129681,170029,299710,"SUSAN MORAN PALMER","ANTHONY GONZALEZ","Republican",0.567311734676854,-40348,299710,-0.134623469353709
2018,"OKLAHOMA",1,103042,150129,253171,"TIM GILPIN","KEVIN HERN","Republican",0.592994458291036,-47087,253171,-0.185988916582073
2018,"OKLAHOMA",2,65021,140451,216002,"JASON NICHOLS","MARKWAYNE MULLIN","Republican",0.650230090462125,-75430,205472,-0.367105980376888
2018,"OKLAHOMA",3,61152,172913,234065,"FRANKIE ROBBINS","FRANK D LUCAS","Republican",0.73873923910025,-111761,234065,-0.4774784782005
2018,"OKLAHOMA",4,78088,149227,236638,"MARY BRANNON","TOM COLE","Republican",0.630613003828633,-71139,227315,-0.312953390669336
2018,"OKLAHOMA",5,121149,117811,238960,"KENDRA HORN","STEVE RUSSELL","Democrat",0.506984432541011,3338,238960,0.0139688650820221
2018,"OREGON",1,231198,116446,363249,"SUZANNE BONAMICI","JOHN VERBEEK","Democrat",0.63647250233311,114752,347644,0.330084799392482
2018,"OREGON",2,145298,207597,368709,"JAMIE MCLEOD-SKINNER","GREG WALDEN","Republican",0.563037517391764,-62299,352895,-0.176536930248374
2018,"OREGON",3,279019,76187,384326,"EARL BLUMENAUER","TOM HARRISON","Democrat",0.725995639118873,202832,355206,0.571026390319983
2018,"OREGON",4,208710,152414,372893,"PETER DEFAZIO","ART ROBINSON","Democrat",0.559704794673003,56296,361124,0.155891051273247
2018,"OREGON",5,197187,149887,358469,"KURT SCHRADER","MARK CALLAHAN","Democrat",0.550081039085667,47300,347074,0.136282176135349
2018,"PENNSYLVANIA",1,160745,169053,329798,"HENRY SCOTT WALLACE","BRIAN K FITZPATRICK","Republican",0.512595588814972,-8308,329798,-0.0251911776299432
2018,"PENNSYLVANIA",2,159600,42382,201982,"BRENDAN F BOYLE","DAVID TORRES","Democrat",0.790169421037518,117218,201982,0.580338842075036
2018,"PENNSYLVANIA",3,287610,20387,307997,"DWIGHT EVANS","BRYAN E LEIB","Democrat",0.93380779682919,267223,307997,0.86761559365838
2018,"PENNSYLVANIA",4,211524,121467,332991,"MADELEINE DEAN CUNNANE","DANIEL DAVID","Democrat",0.63522437543357,90057,332991,0.270448750867141
2018,"PENNSYLVANIA",5,198639,106075,304714,"MARY GAY SCANLON","PEARL KIM","Democrat",0.651886687188643,92564,304714,0.303773374377285
2018,"PENNSYLVANIA",6,177704,124124,301828,"CHRISTINA JAMPOLER HOULAHAN","GREGORY MICHAEL MCCAULEY SR","Democrat",0.588759160846575,53580,301828,0.17751832169315
2018,"PENNSYLVANIA",7,140813,114437,263261,"SUSAN ELLIS WILD","MARTIN W NOTHSTEIN","Democrat",0.534879834081007,26376,255250,0.103333986287953
2018,"PENNSYLVANIA",8,135603,112563,248166,"MATTHEW ALTON CARTWRIGHT","JOHN ROBERT CHRIN","Democrat",0.546420541089432,23040,248166,0.0928410821788642
2018,"PENNSYLVANIA",9,100204,148723,248927,"DENNIS WOLFF","DANIEL MEUSER","Republican",0.597456282363906,-48519,248927,-0.194912564727812
2018,"PENNSYLVANIA",10,141668,149365,291033,"GEORGE B SCOTT","SCOTT G PERRY","Republican",0.513223586328698,-7697,291033,-0.0264471726573962
2018,"PENNSYLVANIA",11,113876,163708,277584,"JESSICA KING","LLOYD K SMUCKER","Republican",0.589760216727189,-49832,277584,-0.179520433454378
2018,"PENNSYLVANIA",12,82825,161047,243872,"MARC FRIEDENBERG","THOMAS A MARINO","Republican",0.660375114814329,-78222,243872,-0.320750229628658
2018,"PENNSYLVANIA",13,74733,178533,253266,"BRENT M OTTAWAY","JOHN JOYCE","Republican",0.704922887399019,-103800,253266,-0.409845774798038
2018,"PENNSYLVANIA",14,110051,151386,261437,"BIBIANA BOERIO","GUY L RESCHENTHALER","Republican",0.579053462210781,-41335,261437,-0.158106924421562
2018,"PENNSYLVANIA",15,78327,165245,243572,"SUSAN BOSER","GLENN WILLIAM THOMPSON JR","Republican",0.678423628331664,-86918,243572,-0.356847256663327
2018,"PENNSYLVANIA",16,124109,135348,262396,"RONALD A DINICOLA","GEORGE J KELLY JR","Republican",0.515815789874846,-11239,259457,-0.043317389779424
2018,"PENNSYLVANIA",17,183162,142417,325579,"CONOR JAMES LAMB","KEITH ROTHFUS","Democrat",0.562573138930951,40745,325579,0.125146277861901
2018,"RHODE ISLAND",1,116099,57567,174083,"DAVID N CICILLINE","PATRICK J DONOVAN","Democrat",0.666917504868367,58532,173666,0.337037762141121
2018,"RHODE ISLAND",2,126476,72271,199197,"JAMES R LANGEVIN","SALVATORE G CAIOZZO","Democrat",0.634929240902222,54205,198747,0.272733676483167
2018,"SOUTH CAROLINA",1,145455,141473,287433,"JOE CUNNINGHAM","KATIE ARRINGTON","Democrat",0.506048366054002,3982,286928,0.0138780460603357
2018,"SOUTH CAROLINA",2,109199,144642,257139,"SEAN CARRIGAN","JOE WILSON","Republican",0.56250510424323,-35443,253841,-0.139626774240568
2018,"SOUTH CAROLINA",3,70046,153338,226204,"MARY GEREN","JEFF DUNCAN","Republican",0.677874838641227,-83292,223384,-0.372864663539018
2018,"SOUTH CAROLINA",4,89182,145321,243950,"BRANDON P BROWN","WILLIAM TIMMONS","Republican",0.59569993851199,-56139,234503,-0.239395658051283
2018,"SOUTH CAROLINA",5,103129,141757,248579,"ARCHIE PARNELL","RALPH W NORMAN","Republican",0.570269411334023,-38628,244886,-0.157738702906659
2018,"SOUTH CAROLINA",6,144765,58282,206433,"JAMES E JIM CLYBURN","GERHARD R GRESSMANN","Democrat",0.701268692505559,86483,203047,0.425926017129039
2018,"SOUTH CAROLINA",7,96564,142681,239554,"ROBERT WILLIAMS","TOM RICE","Republican",0.595611010461107,-46117,239245,-0.192760559259337
2018,"SOUTH DAKOTA",0,120816,202446,335471,"TIM BJORKMAN","DUSTIN ""DUSTY"" JOHNSON","Republican",0.603467959972695,-81630,323262,-0.25251962804165
2018,"TENNESSEE",1,47138,172835,224282,"MARTY OLSEN","PHIL ROE","Republican",0.770614672599674,-125697,219973,-0.571420128833993
2018,"TENNESSEE",2,86668,172856,262134,"RENEE HOYOS","TIM BURCHETT","Republican",0.659418465365042,-86188,259524,-0.332100306715371
2018,"TENNESSEE",3,84731,156512,245765,"DANIELLE MITCHELL","CHUCK FLEISCHMANN","Republican",0.636836001871707,-71781,241243,-0.297546457306533
2018,"TENNESSEE",4,78065,147323,232451,"MARIAH PHILLIPS","SCOTT DESJARLAIS","Republican",0.63378088285273,-69258,225388,-0.307283440112162
2018,"TENNESSEE",5,177923,84317,262248,"JIM COOPER","JODY M BALL","Democrat",0.678453219852964,93606,262240,0.356947834045149
2018,"TENNESSEE",6,70370,172810,248740,"DAWN BARLOW","JOHN ROSE","Republican",0.694741497145614,-102440,243180,-0.421251747676618
2018,"TENNESSEE",7,81661,170071,254384,"JUSTIN KANEW","MARK E GREEN","Republican",0.668560129567897,-88410,251732,-0.351206839019274
2018,"TENNESSEE",8,74755,168030,248345,"ERIKA STOTTS PEARSON","DAVID KUSTOFF","Republican",0.676599085948982,-93275,242785,-0.384187655744795
2018,"TENNESSEE",9,145139,34901,181476,"STEVE COHEN","CHARLOTTE BERGMANN","Democrat",0.799769666512376,110238,180040,0.612297267273939
2018,"TEXAS",1,61263,168165,232720,"SHIRLEY J MCKELLAR","LOUIE GOHMERT","Republican",0.722606565830182,-106902,229428,-0.465950101992782
2018,"TEXAS",2,119992,139188,263392,"TODD LITTON","DAN CRENSHAW","Republican",0.528444295954319,-19196,259180,-0.0740643568176557
2018,"TEXAS",3,138234,169520,312511,"LORIE BURCH","VAN TAYLOR","Republican",0.542444905939311,-31286,307754,-0.101659117346972
2018,"TEXAS",4,57400,188667,249245,"CATHERINE KRANTZ","JOHN RATCLIFFE","Republican",0.756954001083271,-131267,246067,-0.533460398997021
2018,"TEXAS",5,78666,130617,209507,"DAN WOOD","LANCE GOODEN","Republican",0.623449335821715,-51951,209283,-0.248233253537077
2018,"TEXAS",6,116350,135961,256042,"JANA LYNNE SANCHEZ","RON WRIGHT","Republican",0.531010537333719,-19611,252311,-0.0777255054278252
2018,"TEXAS",7,127959,115642,243601,"LIZZIE PANNILL FLETCHER","JOHN CULBERSON","Democrat",0.525281094905193,12317,243601,0.0505621898103867
2018,"TEXAS",8,67930,200619,273170,"STEVEN DAVID","KEVIN BRADY","Republican",0.734410806457517,-132689,268549,-0.494096049510518
2018,"TEXAS",10,144034,157166,307827,"MIKE SIEGEL","MICHAEL T MCCAUL","Republican",0.510565999733617,-13132,301200,-0.0435989375830013
2018,"TEXAS",11,40631,176603,220377,"JENNIE LOU LEEDER","MIKE CONAWAY","Republican",0.801367656334372,-135972,217234,-0.625924118692286
2018,"TEXAS",12,90994,172557,268491,"VANESSA ADIA","KAY GRANGER","Republican",0.642691933807837,-81563,263551,-0.309477103103384
2018,"TEXAS",13,35083,169027,207285,"GREG SAGAN","MAC THORNBERRY","Republican",0.815432858142171,-133944,204110,-0.656234383420705
2018,"TEXAS",14,92212,138942,234528,"ADRIENNE BELL","RANDY WEBER","Republican",0.592432460090053,-46730,231154,-0.20215959922822
2018,"TEXAS",15,98333,63862,164802,"VICENTE GONZALEZ","TIM WESTLEY","Democrat",0.596673584058446,34471,162195,0.212528129720398
2018,"TEXAS",16,124437,49127,181754,"VERONICA ESCOBAR","RICK SEEBERGER","Democrat",0.684645179748451,75310,173564,0.433903344011431
2018,"TEXAS",17,98070,134841,237351,"RICK KENNEDY","BILL FLORES","Republican",0.568107991961273,-36771,232911,-0.157875755116761
2018,"TEXAS",18,138704,38368,184332,"SHEILA JACKSON LEE","AVA REYNERO PATE","Democrat",0.75246837228479,100336,177072,0.566639559049426
2018,"TEXAS",19,50039,151946,201985,"MIGUEL LEVARIO","JODEY ARRINGTON","Republican",0.752263781964007,-101907,201985,-0.504527563928014
2018,"TEXAS",21,168421,177654,353617,"JOSEPH KOPSER","CHIP ROY","Republican",0.502391004957341,-9233,346075,-0.0266791880372752
2018,"TEXAS",22,138153,152750,297405,"SRI PRESTON KULKARNI","PETE OLSON","Republican",0.513609387871757,-14597,290903,-0.0501782381068604
2018,"TEXAS",23,102359,103285,210069,"GINA ORTIZ JONES","WILL HURD","Republican",0.491671784032865,-926,205644,-0.00450292738908016
2018,"TEXAS",24,125231,133317,263418,"JAN MCDOWELL","KENNY E MARCHANT","Republican",0.506104366444207,-8086,258548,-0.0312746569302412
2018,"TEXAS",25,136385,163023,304553,"JULIE OLIVER","ROGER WILLIAMS","Republican",0.535286140671739,-26638,299408,-0.0889688986266232
2018,"TEXAS",26,121938,185551,312505,"LINSEY FAGAN","MICHAEL C BURGESS","Republican",0.593753699940801,-63613,307489,-0.206878945263083
2018,"TEXAS",27,75929,125118,207421,"ERIC HOLGUIN","MICHAEL CLOUD","Republican",0.603207968334932,-49189,201047,-0.244664183001985
2018,"TEXAS",29,88188,28098,117494,"SYLVIA R GARCIA","PHILLIP ARONOFF","Democrat",0.750574497421145,60090,116286,0.516743202105155
2018,"TEXAS",31,136362,144680,286007,"MARY JENNINGS ""MJ"" HEGAR","JOHN CARTER","Republican",0.505861744642614,-8318,281042,-0.0295969997366942
2018,"TEXAS",32,144067,126101,275620,"COLIN ALLRED","PETE SESSIONS","Democrat",0.522701545606269,17966,270168,0.0664993633590951
2018,"TEXAS",33,90805,26120,119224,"MARC VEASEY","WILLIE BILLUPS","Democrat",0.761633563712004,64685,116925,0.553217874706008
2018,"TEXAS",34,85825,57243,143068,"FILEMON B VELA","REY GONZALEZ","Democrat",0.599889563005005,28582,143068,0.199779126010009
2018,"TEXAS",35,138278,50553,194067,"LLOYD DOGGETT","DAVID SMALLING","Democrat",0.712527116923537,87725,188831,0.464568847276136
2018,"TEXAS",36,60908,161048,221956,"DAYNA STEELE","BRIAN BABIN","Republican",0.725585251130855,-100140,221956,-0.45117050226171
2018,"UTAH",1,63308,156692,254333,"LEE CASTILLO","ROB BISHOP","Republican",0.616089929344599,-93384,220000,-0.424472727272727
2018,"UTAH",2,105051,151489,270044,"SHIREEN GHORBANI","CHRIS STEWART","Republican",0.560978951578261,-46438,256540,-0.181016605597568
2018,"UTAH",3,70686,174856,258858,"JAMES COURAGE SINGER","JOHN CURTIS","Republican",0.675490037008707,-104170,245542,-0.424245139324433
2018,"UTAH",4,134964,134270,269271,"BEN MCADAMS","MIA B LOVE","Democrat",0.501219960560179,694,269234,0.00257768335351404
2018,"VERMONT",0,188547,70705,272451,"PETER WELCH","ANYA TYNIO","Democrat",0.692040036557032,117842,259252,0.454546155863793
2018,"VIRGINIA",1,148464,183250,332101,"VANGIE A WILLIAMS","ROBERT J ""ROB"" WITTMAN","Republican",0.551789967509884,-34786,331714,-0.104867446052925
2018,"VIRGINIA",2,139571,133458,273400,"ELAINE G LURIA","SCOTT W TAYLOR","Democrat",0.510501097293343,6113,273029,0.0223895630134528
2018,"VIRGINIA",4,187642,107706,299854,"A DONALD MCEACHIN","RYAN A MCADAMS","Democrat",0.62577787856757,79936,295348,0.27065021601636
2018,"VIRGINIA",5,145040,165339,310926,"LESLIE C COCKBURN","DENVER L RIGGLEMAN III","Republican",0.531763184809247,-20299,310379,-0.0654006875465157
2018,"VIRGINIA",6,113133,167957,281377,"JENNIFER LYNN LEWIS","BEN L CLINE","Republican",0.596910906008664,-54824,281090,-0.195040734284393
2018,"VIRGINIA",7,176079,169295,349803,"ABIGAIL A SPANBERGER","DAVE A BRAT","Democrat",0.503366180392964,6784,345374,0.0196424745348521
2018,"VIRGINIA",8,247137,76899,324748,"DONALD S BEYER JR","THOMAS S OH","Democrat",0.761011615160063,170238,324036,0.525367551753509
2018,"VIRGINIA",9,85833,160933,246980,"ANTHONY J FLACCAVENTO","H MORGAN GRIFFITH","Republican",0.651603368693821,-75100,246766,-0.304336902166425
2018,"VIRGINIA",10,206356,160841,367795,"JENNIFER T WEXTON","BARBARA J COMSTOCK","Democrat",0.561062548430512,45515,367197,0.123952537738598
2018,"VIRGINIA",11,219191,83023,308250,"GERALD EDWARD CONNOLLY","JEFF A DOVE JR","Democrat",0.711081914030819,136168,302214,0.450568140456762
2018,"WASHINGTON",1,197209,135534,332743,"SUZAN DELBENE","JEFFREY BEELER","Democrat",0.592676630312283,61675,332743,0.185353260624566
2018,"WASHINGTON",3,145407,161819,307226,"CAROLYN LONG","JAIME HERRERA BEUTLER","Republican",0.526709978973134,-16412,307226,-0.0534199579462676
2018,"WASHINGTON",4,83785,141551,225336,"CHRISTINE BROWN","DAN NEWHOUSE","Republican",0.628177477189619,-57766,225336,-0.256354954379238
2018,"WASHINGTON",5,144925,175422,320347,"LISA BROWN","CATHY MCMORRIS RODGERS","Republican",0.547599946308222,-30497,320347,-0.095199892616444
2018,"WASHINGTON",6,206409,116677,323086,"DEREK KILMER","DOUGLAS DIGHTMAN","Democrat",0.638867050878094,89732,323086,0.277734101756189
2018,"WASHINGTON",7,329800,64881,394681,"PRAMILA JAYAPAL","CRAIG KELLER","Democrat",0.835611544513164,264919,394681,0.671223089026328
2018,"WASHINGTON",8,164089,148968,313057,"KIM SCHRIER","DINO ROSSI","Democrat",0.524150554052457,15121,313057,0.0483011081049138
2018,"WASHINGTON",10,166215,103860,270075,"DENNY HECK","JOSEPH BRUMBLES","Democrat",0.615440155512358,62355,270075,0.230880311024715
2018,"WEST VIRGINIA",1,70217,127997,198214,"KENDRA FERSHEE","DAVID B MCKINLEY","Republican",0.645751561443692,-57780,198214,-0.291503122887384
2018,"WEST VIRGINIA",2,88011,110504,204792,"TALLEY SERGENT","ALEX X MOONEY","Republican",0.539591390288683,-22493,198515,-0.113306299272095
2018,"WEST VIRGINIA",3,76340,98645,174985,"RICHARD OJEDA II","CAROL MILLER","Republican",0.563734034345801,-22305,174985,-0.127468068691602
2018,"WISCONSIN",1,137508,177492,325317,"RANDY BRYCE","BRYAN STEIL","Republican",0.545597063787014,-39984,315000,-0.126933333333333
2018,"WISCONSIN",3,187888,126980,314989,"RON KIND","STEVE TOFT","Democrat",0.5964906711028,60908,314868,0.193439790642428
2018,"WISCONSIN",4,206487,59091,273087,"GWEN S MOORE","TIM ROGERS","Democrat",0.756121675510002,147396,265578,0.555000790728148
2018,"WISCONSIN",5,138385,225619,364288,"TOM PALZEWICZ","F JAMES SENSENBRENNER JR","Republican",0.619342388439916,-87234,364004,-0.239651212624037
2018,"WISCONSIN",6,144536,180311,325065,"DAN KOHL","GLENN GROTHMAN","Republican",0.554692138495378,-35775,324847,-0.110128768312467
2018,"WISCONSIN",7,124307,194061,322840,"MARGARET ENGEBRETSON","SEAN P DUFFY","Republican",0.601105810928014,-69754,318368,-0.219098653130968
2018,"WISCONSIN",8,119265,209410,328774,"BEAU LIEGEOIS","MIKE GALLAGHER","Republican",0.636942093961201,-90145,328675,-0.27426789381608
2018,"WYOMING",0,59903,127963,201245,"GREG HUNTER","LIZ CHENEY","Republican",0.63585679147308,-68060,187866,-0.36227949708835
2020,"ALABAMA",1,116949,211825,329075,"JAMES AVERHART","JERRY CARL","Republican",0.643698245080909,-94876,328774,-0.288575130636851
2020,"ALABAMA",2,105286,197996,303569,"PHYLLIS HARVEY-HALL","BARRY MOORE","Republican",0.652227335465743,-92710,303282,-0.305689094637994
2020,"ALABAMA",3,104595,217384,322234,"ADIA WINFREY","MIKE ROGERS","Republican",0.674615341646133,-112789,321979,-0.35029924311834
2020,"ALABAMA",4,56237,261553,318029,"RICK NEIGHBORS","ROBERT B ADERHOLT","Republican",0.822418710243406,-205316,317790,-0.646074451681928
2020,"ALASKA",0,159856,192126,353165,"ALYSE S GALVIN","DON YOUNG","Republican",0.544012005719706,-32270,351982,-0.091680824587621
2020,"ARIZONA",1,188469,176709,365178,"TOM O'HALLERAN","TIFFANY SHEDD","Democrat",0.516101736687314,11760,365178,0.0322034733746283
2020,"ARIZONA",2,209945,170975,381054,"ANN KIRKPATRICK","BRANDON MARTIN","Democrat",0.550958656778304,38970,380920,0.102304945920403
2020,"ARIZONA",3,174243,95594,269837,"RAUL M GRIJALVA","DANIEL WOOD","Democrat",0.645734276618848,78649,269837,0.291468553237695
2020,"ARIZONA",4,120484,278002,398623,"DELINA DISANTO","PAUL A GOSAR","Republican",0.697405819533745,-157518,398486,-0.395291177105344
2020,"ARIZONA",5,183171,262414,445657,"JOAN GREENE","ANDY BIGGS","Republican",0.588825038089831,-79243,445585,-0.177840367157781
2020,"ARIZONA",6,199644,217783,417427,"HIRAL TIPIRNENI","DAVID SCHWEIKERT","Republican",0.521727152292497,-18139,417427,-0.0434543045849933
2020,"ARIZONA",7,165452,50226,215732,"RUBEN GALLEGO","JOSHUA BARNETT","Democrat",0.766933046557766,115226,215678,0.534250132141433
2020,"ARIZONA",8,170816,251633,422467,"MICHAEL MUSCATO","DEBBIE LESKO","Republican",0.595627587480206,-80817,422449,-0.191305932787153
2020,"ARIZONA",9,217094,135180,352274,"GREG STANTON","DAVE GILES","Democrat",0.616264612205272,81914,352274,0.232529224410544
2020,"ARKANSAS",2,148410,184093,332503,"JOYCE ELLIOTT","J FRENCH HILL","Republican",0.553658162482744,-35683,332503,-0.107316324965489
2020,"ARKANSAS",3,106325,214960,334262,"CELESTE WILLIAMS","STEVE WOMACK","Republican",0.643088355840628,-108635,321285,-0.338126585430381
2020,"ARKANSAS",4,75750,191617,275035,"WILLIAM H HANSON","BRUCE WESTERMAN","Republican",0.696700419946552,-115867,267367,-0.433363130079628
2020,"CALIFORNIA",1,154073,204190,358263,"AUDREY DENNEY","DOUG LAMALFA","Republican",0.569944426301348,-50117,358263,-0.139888852602697
2020,"CALIFORNIA",2,294435,94320,388755,"JARED HUFFMAN","DALE K MENSING","Democrat",0.757379326310916,200115,388755,0.514758652621831
2020,"CALIFORNIA",3,176043,145945,321988,"JOHN GARAMENDI","TAMIKA HAMILTON","Democrat",0.546737766624843,30098,321988,0.0934755332496863
2020,"CALIFORNIA",4,194731,247291,442022,"BRYNNE S KENNEDY","TOM MCCLINTOCK","Republican",0.559454054323088,-52560,442022,-0.118908108646176
2020,"CALIFORNIA",5,271233,85227,356460,"MIKE THOMPSON","SCOTT GIBLIN","Democrat",0.760907254670931,186006,356460,0.521814509341862
2020,"CALIFORNIA",6,229648,83466,313114,"DORIS O MATSUI","CHRIS BISH","Democrat",0.733432551722376,146182,313114,0.466865103444752
2020,"CALIFORNIA",7,217416,166549,383965,"AMI BERA","BUZZ PATTERSON","Democrat",0.566239110335578,50867,383965,0.132478220671155
2020,"CALIFORNIA",8,124400,158711,283111,"CHRISTINE BUBSER","JAY OBERNOLTE","Republican",0.560596373860429,-34311,283111,-0.121192747720859
2020,"CALIFORNIA",9,174252,128358,302610,"JERRY MCNERNEY","ANTONIO C ""TONY"" AMADOR","Democrat",0.575830276593635,45894,302610,0.151660553187271
2020,"CALIFORNIA",10,166865,135629,302494,"JOSH HARDER","TED HOWZE","Democrat",0.551630776147626,31236,302494,0.103261552295252
2020,"CALIFORNIA",11,271063,100293,371356,"MARK DESAULNIER","NISHA SHARMA","Democrat",0.729927616626633,170770,371356,0.459855233253266
2020,"CALIFORNIA",13,327863,34955,362818,"BARBARA LEE","NIKKA PITERMAN","Democrat",0.903656929920787,292908,362818,0.807313859841573
2020,"CALIFORNIA",14,278300,72705,351005,"JACKIE SPEIER","RAN S PETEL","Democrat",0.792866198487201,205595,351005,0.585732396974402
2020,"CALIFORNIA",15,242991,99710,342701,"ERIC SWALWELL","ALISON HAYDEN","Democrat",0.709046661667168,143281,342701,0.418093323334335
2020,"CALIFORNIA",16,128690,88039,216729,"JIM COSTA","KEVIN COOKINGHAM","Democrat",0.593783019346742,40651,216729,0.187566038693484
2020,"CALIFORNIA",17,212137,85199,297336,"RO KHANNA","RITESH TANDON","Democrat",0.713458847902709,126938,297336,0.426917695805419
2020,"CALIFORNIA",19,224385,88642,313027,"ZOE LOFGREN","JUSTIN JAMES AGUILERA","Democrat",0.716823149440783,135743,313027,0.433646298881566
2020,"CALIFORNIA",20,236896,71658,308554,"JIMMY PANETTA","JEFF GORMAN","Democrat",0.767761882847087,165238,308554,0.535523765694173
2020,"CALIFORNIA",21,84406,85928,170334,"TJ COX","DAVID G VALADAO","Republican",0.504467692885742,-1522,170334,-0.00893538577148426
2020,"CALIFORNIA",22,144251,170888,315139,"PHIL ARBALLO","DEVIN NUNES","Republican",0.542262303301083,-26637,315139,-0.084524606602166
2020,"CALIFORNIA",23,115896,190222,306118,"KIM MANGONE","KEVIN MCCARTHY","Republican",0.621400897693047,-74326,306118,-0.242801795386093
2020,"CALIFORNIA",24,212564,149781,362345,"SALUD O CARBAJAL","ANDY CALDWELL","Democrat",0.586634285004623,62783,362345,0.173268570009245
2020,"CALIFORNIA",25,169305,169638,338943,"CHRISTY SMITH","MIKE GARCIA","Republican",0.500491233039184,-333,338943,-0.000982466078367159
2020,"CALIFORNIA",26,208856,135877,344733,"JULIA BROWNLEY","RONDA BALDWIN-KENNEDY","Democrat",0.605848584266664,72979,344733,0.211697168533329
2020,"CALIFORNIA",27,221411,95907,317318,"JUDY CHU","JOHNNY J NALBANDIAN","Democrat",0.697757454666927,125504,317318,0.395514909333854
2020,"CALIFORNIA",28,244271,91928,336199,"ADAM B SCHIFF","ERIC EARLY","Democrat",0.726566706028275,152343,336199,0.45313341205655
2020,"CALIFORNIA",30,240038,105426,345464,"BRAD SHERMAN","MARK S REED","Democrat",0.694827825764769,134612,345464,0.389655651529537
2020,"CALIFORNIA",31,175315,110735,286050,"PETE AGUILAR","AGNES GIBBONEY","Democrat",0.612882363223213,64580,286050,0.225764726446425
2020,"CALIFORNIA",32,172942,86818,259760,"GRACE F NAPOLITANO","JOSHUA M SCOTT","Democrat",0.665776101016323,86124,259760,0.331552202032646
2020,"CALIFORNIA",33,257094,123334,380428,"TED LIEU","JAMES P BRADLEY","Democrat",0.675801991441219,133760,380428,0.351603982882438
2020,"CALIFORNIA",35,169405,74941,244346,"NORMA J TORRES","MIKE CARGILE","Democrat",0.693299665228815,94464,244346,0.38659933045763
2020,"CALIFORNIA",36,185151,121698,306849,"RAUL RUIZ","ERIN CRUZ","Democrat",0.603394503485428,63453,306849,0.206789006970855
2020,"CALIFORNIA",37,254916,41705,296621,"KAREN BASS","ERROL WEBBER","Democrat",0.859399705347902,213211,296621,0.718799410695804
2020,"CALIFORNIA",39,169837,173946,343783,"GILBERT RAY CISNEROS JR","YOUNG KIM","Republican",0.505976153561985,-4109,343783,-0.0119523071239706
2020,"CALIFORNIA",40,135572,50809,186381,"LUCILLE ROYBAL-ALLARD","C ANTONIO DELGADO","Democrat",0.727391740574415,84763,186381,0.45478348114883
2020,"CALIFORNIA",41,168126,94447,262573,"MARK TAKANO","AJA SMITH","Democrat",0.640301935080911,73679,262573,0.280603870161822
2020,"CALIFORNIA",42,157773,210274,368047,"WILLIAM ""LIAM"" O'MARA","KEN CALVERT","Republican",0.571323771148794,-52501,368047,-0.142647542297587
2020,"CALIFORNIA",43,199210,78688,277898,"MAXINE WATERS","JOE E COLLINS III","Democrat",0.716845749159764,120522,277898,0.433691498319527
2020,"CALIFORNIA",45,221843,193096,414939,"KATIE PORTER","GREG RATHS","Democrat",0.534640031426306,28747,414939,0.0692800628526121
2020,"CALIFORNIA",46,157803,71716,229519,"J LUIS CORREA","JAMES S WATERS","Democrat",0.687537850896876,86087,229519,0.375075701793751
2020,"CALIFORNIA",47,197028,114371,311399,"ALAN S LOWENTHAL","JOHN BRISCOE","Democrat",0.632718794858044,82657,311399,0.265437589716088
2020,"CALIFORNIA",48,193362,201738,395100,"HARLEY ROUDA","MICHELLE STEEL","Republican",0.510599848139711,-8376,395100,-0.0211996962794229
2020,"CALIFORNIA",49,205349,181157,386506,"MIKE LEVIN","BRIAN MARYOTT","Democrat",0.531295762549611,24192,386506,0.0625915250992223
2020,"CALIFORNIA",50,166869,195521,362390,"AMMAR CAMPA-NAJJAR","DARRELL ISSA","Republican",0.539531995916002,-28652,362390,-0.0790639918320042
2020,"CALIFORNIA",51,165596,76841,242437,"JUAN VARGAS","JUAN M HIDALGO JR","Democrat",0.683047554622438,88755,242437,0.366095109244876
2020,"CALIFORNIA",52,244145,152350,396495,"SCOTT H PETERS","JIM DEBELLO","Democrat",0.615758080177556,91795,396495,0.231516160355112
2020,"COLORADO",1,331621,105955,450290,"DIANA DEGETTE","SHANE BOLLING","Democrat",0.73646094738946,225666,437576,0.51571841234437
2020,"COLORADO",2,316925,182547,515663,"JOE NEGUSE","CHARLIE WINN","Democrat",0.614597130296337,134378,499472,0.269040106352308
2020,"COLORADO",3,194122,220634,429319,"DIANE E MITSCH BUSH","LAUREN BOEBERT","Republican",0.513916225464049,-26512,414756,-0.0639219203579936
2020,"COLORADO",4,173945,285606,475107,"IKE MCCORKLE","KEN BUCK","Republican",0.601140374694543,-111661,459551,-0.242978472465515
2020,"COLORADO",5,161600,249013,432407,"JILLIAN FREELAND","DOUG LAMBORN","Republican",0.575876431232612,-87413,410613,-0.21288415125678
2020,"COLORADO",6,250314,175192,438473,"JASON CROW","STEVE HOUSE","Democrat",0.570876656031272,75122,425506,0.176547451739811
2020,"COLORADO",7,250525,159301,423691,"ED PERLMUTTER","CHARLES ""CASPER"" STOCKHAM","Democrat",0.591291766877276,91224,409826,0.22259202686018
2020,"CONNECTICUT",1,213001,122111,349237,"JOHN B LARSON","MARY FAY","Democrat",0.609903876164324,90890,335112,0.271222755377307
2020,"CONNECTICUT",2,207303,140356,367347,"JOE COURTNEY","JUSTIN ANDERSON","Democrat",0.56432473927921,66947,347659,0.192565128473591
2020,"CONNECTICUT",3,194259,131568,346103,"ROSA L DELAURO","MARGARET STREICKER","Democrat",0.561275111744192,62691,325827,0.192405785892514
2020,"CONNECTICUT",4,224432,130627,360716,"JAMES A HIMES","JONATHAN RIDDLE","Democrat",0.622184765854578,93805,355059,0.264195528067166
2020,"CONNECTICUT",5,183797,151988,349524,"JAHANA HAYES","DAVID X SULLIVAN","Democrat",0.525849440953983,31809,335785,0.0947302589454562
2020,"DELAWARE",0,281382,196392,488270,"LISA BLUNT ROCHESTER","LEE MURPHY","Democrat",0.576283613574457,84990,477774,0.177887453063582
2020,"FLORIDA",1,149172,283352,438562,"PHIL EHR","MATT GAETZ","Republican",0.646093368782521,-134180,432524,-0.310225559737726
2020,"FLORIDA",3,167326,223075,390401,"ADAM CHRISTENSEN","KAT CAMMACK","Republican",0.571399663422993,-55749,390401,-0.142799326845987
2020,"FLORIDA",4,196423,308497,504940,"DONNA DEEGAN","JOHN H RUTHERFORD","Republican",0.610957737552977,-112074,504920,-0.22196387546542
2020,"FLORIDA",5,219463,117510,336973,"AL LAWSON JR","GARY ADLER","Democrat",0.651277698806729,101953,336973,0.302555397613459
2020,"FLORIDA",6,172305,265393,437856,"CLINT CURTIS","MICHAEL WALTZ","Republican",0.606119363443689,-93088,437698,-0.212676320202514
2020,"FLORIDA",7,224946,175750,406449,"STEPHANIE N MURPHY","LEO VALENTIN","Democrat",0.553442129270831,49196,400696,0.122776369117735
2020,"FLORIDA",8,177695,282093,459788,"JIM KENNEDY","BILL POSEY","Republican",0.6135284087449,-104398,459788,-0.2270568174898
2020,"FLORIDA",9,240724,188889,429638,"DARREN SOTO","WILLIAM P ""BILL"" OLSON","Democrat",0.560294945977777,51835,429613,0.120655101219004
2020,"FLORIDA",10,239434,136889,376397,"VAL BUTLER DEMINGS","VENNIA FRANCOIS","Democrat",0.636120904258004,102545,376323,0.27249198162217
2020,"FLORIDA",11,158094,316979,475073,"DANA MARIE COTTRELL","DANIEL WEBSTER","Republican",0.667221669090856,-158885,475073,-0.334443338181711
2020,"FLORIDA",12,168194,284941,453135,"KIMBERLY WALKER","GUS M BILIRAKIS","Republican",0.628821432906308,-116747,453135,-0.257642865812617
2020,"FLORIDA",13,215405,190713,406125,"CHARLIE CRIST","ANNA PAULINA LUNA","Democrat",0.530390889504463,24692,406118,0.0608000630358664
2020,"FLORIDA",14,224240,147896,372136,"KATHY CASTOR","CHRISTINE Y QUINN","Democrat",0.602575402541006,76344,372136,0.205150805082013
2020,"FLORIDA",15,174297,216374,390671,"ALAN COHN","SCOTT FRANKLIN","Republican",0.553852218362766,-42077,390671,-0.107704436725531
2020,"FLORIDA",16,215683,269001,484684,"MARGARET GOOD","VERN BUCHANAN","Republican",0.555002847215918,-53318,484684,-0.110005694431836
2020,"FLORIDA",17,140487,266514,412397,"ALLEN ELLISON","W GREGORY STEUBE","Republican",0.64625591359782,-126027,407001,-0.309647887843027
2020,"FLORIDA",18,186674,253286,449720,"PAM KEITH","BRIAN J MAST","Republican",0.563208218447034,-66612,439960,-0.151404673152105
2020,"FLORIDA",19,172146,272440,444589,"CINDY LYN BANYAI","BYRON DONALDS","Republican",0.612790689828133,-100294,444586,-0.225589649696572
2020,"FLORIDA",20,253661,68748,322409,"ALCEE L HASTINGS","GREG MUSSELWHITE","Democrat",0.786767739113983,184913,322409,0.573535478227965
2020,"FLORIDA",21,237925,157612,403093,"LOIS FRANKEL","LAURA LOOMER","Democrat",0.590248404214412,80313,395537,0.203048008150944
2020,"FLORIDA",22,235764,166553,402317,"THEODORE E DEUTCH","JAMES ""JIM"" PRUDEN","Democrat",0.586015505186209,69211,402317,0.172031010372418
2020,"FLORIDA",23,221239,158874,380196,"DEBBIE WASSERMAN SCHULTZ","CARLA SPALDING","Democrat",0.58190775284327,62365,380113,0.164069631925243
2020,"FLORIDA",24,218825,59084,289638,"FREDERICA S WILSON","LAVERN SPICER","Democrat",0.755512052976474,159741,277909,0.574796066338262
2020,"FLORIDA",26,165407,177223,342630,"DEBBIE MUCARSEL-POWELL","CARLOS GIMENEZ","Republican",0.517243090213933,-11816,342630,-0.0344861804278668
2020,"FLORIDA",27,166758,176141,342975,"DONNA E SHALALA","MARIA ELVIRA SALAZAR","Republican",0.513568044318099,-9383,342899,-0.0273637426764149
2020,"GEORGIA",1,135238,189457,324695,"JOYCE MARIE GRIGGS","EARL L ""BUDDY"" CARTER","Republican",0.583492200372657,-54219,324695,-0.166984400745315
2020,"GEORGIA",2,161397,111620,273034,"SANFORD D BISHOP JR","DON COLE","Democrat",0.591124182336266,49777,273017,0.182321979949966
2020,"GEORGIA",3,129792,241526,371318,"VAL ALMONORD","A DREW FERGUSON IV","Republican",0.650455943423157,-111734,371318,-0.300911886846315
2020,"GEORGIA",4,278906,69393,348299,"HENRY C ""HANK"" JOHNSON JR","JOHSIE CRUZ EZAMMUDEEN","Democrat",0.800766008515672,209513,348299,0.601532017031344
2020,"GEORGIA",5,301857,52646,354503,"NIKEMA WILLIAMS","ANGELA STANTON-KING","Democrat",0.851493499349794,249211,354503,0.702986998699588
2020,"GEORGIA",6,216775,180329,397104,"LUCY MCBATH","KAREN HANDEL","Democrat",0.545889741730126,36446,397104,0.0917794834602522
2020,"GEORGIA",7,190900,180564,371464,"CAROLYN BOURDEAUX","RICH MCCORMICK","Democrat",0.513912519113562,10336,371464,0.027825038227123
2020,"GEORGIA",8,109264,198701,308013,"LINDSAY HOLLIDAY","AUSTIN SCOTT","Republican",0.645105888387828,-89437,307965,-0.290412871592551
2020,"GEORGIA",9,79797,292750,372547,"DEVIN PANDY","ANDREW CLYDE","Republican",0.785806891479464,-212953,372547,-0.571613782958929
2020,"GEORGIA",10,142636,235810,378446,"TABITHA JOHNSON-GREEN","JODY B HICE","Republican",0.623100785845273,-93174,378446,-0.246201571690545
2020,"GEORGIA",11,160623,245259,405882,"DANA BARRETT","BARRY LOUDERMILK","Republican",0.604261829792895,-84636,405882,-0.208523659585791
2020,"GEORGIA",12,129061,181038,310099,"LIZ JOHNSON","RICK W ALLEN","Republican",0.583807106762679,-51977,310099,-0.167614213525358
2020,"GEORGIA",13,279045,81476,360582,"DAVID SCOTT","BECKY E HITES","Democrat",0.773873903855434,197569,360521,0.548009685982231
2020,"GEORGIA",14,77798,229827,307625,"KEVIN VAN AUSDAL","MARJORIE TAYLOR GREENE","Republican",0.747101178382771,-152029,307625,-0.494202356765542
2020,"HAWAII",1,183245,71188,283408,"ED CASE","RON CURTIS","Democrat",0.646576666854852,112057,254433,0.44041849917267
2020,"HAWAII",2,171517,84027,296376,"KAIALII ""KAI"" KAHELE","JOE AKANA","Democrat",0.578714200879963,87490,255544,0.342367654885264
2020,"IDAHO",1,131380,310736,458576,"RUDY SOTO","RUSS FULCHER","Republican",0.677610690485329,-179356,442116,-0.405676338336545
2020,"IDAHO",2,124151,250669,391333,"C AARON SWISHER","MICHAEL K SIMPSON","Republican",0.640551652940079,-126518,374820,-0.337543354143322
2020,"ILLINOIS",1,239943,85027,325123,"BOBBY L RUSH","PHILANISE WHITE","Democrat",0.738006846639579,154916,324970,0.476708619257162
2020,"ILLINOIS",2,234896,63142,298038,"ROBIN L KELLY","THERESA J RABORN","Democrat",0.788141109522947,171754,298038,0.576282219045893
2020,"ILLINOIS",3,172997,133851,306848,"MARIE NEWMAN","MIKE FRICILONE","Democrat",0.563787282302638,39146,306848,0.127574564605277
2020,"ILLINOIS",4,187219,35518,222737,"JESUS G ""CHUY"" GARCIA","JESUS SOLORIO","Democrat",0.840538392813049,151701,222737,0.681076785626097
2020,"ILLINOIS",5,255661,96200,361271,"MIKE QUIGLEY","TOMMY HANSON","Democrat",0.707670972760061,159461,351861,0.453193164346148
2020,"ILLINOIS",6,213777,183891,404747,"SEAN CASTEN","JEANNE IVES","Democrat",0.528174390421671,29886,397668,0.0751531428226561
2020,"ILLINOIS",7,249383,41390,310128,"DANNY K DAVIS","CRAIG CAMERON","Democrat",0.804129262756023,207993,290773,0.715310568725432
2020,"ILLINOIS",9,262045,107125,369170,"JANICE D SCHAKOWSKY","SARGIS SANGARI","Democrat",0.709822033209632,154920,369170,0.419644066419265
2020,"ILLINOIS",10,202402,114442,316874,"BRADLEY SCOTT SCHNEIDER","VALERIE RAMIREZ MUKHERJEE","Democrat",0.638745999987377,87960,316844,0.277612957796266
2020,"ILLINOIS",11,194557,112807,307377,"BILL FOSTER","RICK LAIB","Democrat",0.632958874606753,81750,307364,0.26597129136789
2020,"ILLINOIS",12,127577,194839,322416,"RAYMOND C LENZI","MIKE BOST","Republican",0.604309339486874,-67262,322416,-0.208618678973748
2020,"ILLINOIS",13,151648,181373,333021,"BETSY DIRKSEN LONDRIGAN","RODNEY DAVIS","Republican",0.544629317670657,-29725,333021,-0.0892586353413148
2020,"ILLINOIS",14,203209,197835,401052,"LAUREN UNDERWOOD","JIM OBERWEIS","Democrat",0.506689905548408,5374,401044,0.0134000259323167
2020,"ILLINOIS",15,88559,244947,333506,"ERIKA C WEAVER","MARY MILLER","Republican",0.734460549435393,-156388,333506,-0.468921098870785
2020,"ILLINOIS",16,119313,218839,338159,"DANI BRZOZOWSKI","ADAM KINZINGER","Republican",0.647148235001878,-99526,338152,-0.294323262911353
2020,"ILLINOIS",17,156011,143863,299895,"CHERI BUSTOS","ESTHER JOY KING","Democrat",0.520218743226796,12148,299874,0.0405103476793587
2020,"ILLINOIS",18,110039,261840,371879,"GEORGE PETRILLI","DARIN LAHOOD","Republican",0.704099989512718,-151801,371879,-0.408199979025436
2020,"INDIANA",1,185180,132247,326948,"FRANK J MRVAN","MARK LEYVA","Democrat",0.566389762286358,52933,317427,0.166756451089542
2020,"INDIANA",2,114967,183601,298568,"PATRICIA ""PAT"" HACKETT","JACKIE WALORSKI","Republican",0.614938640443718,-68634,298568,-0.229877280887436
2020,"INDIANA",3,104762,220989,325751,"CHIP COLDIRON","JIM BANKS","Republican",0.678398531393611,-116227,325751,-0.356797062787221
2020,"INDIANA",4,112984,225531,338515,"JOE MACKEY","JAMES R BAIRD","Republican",0.666236355848338,-112547,338515,-0.332472711696675
2020,"INDIANA",5,191226,208212,416226,"CHRISTINA HALE","VICTORIA SPARTZ","Republican",0.500237851551801,-16986,399438,-0.0425247472699142
2020,"INDIANA",6,91103,225319,328213,"JEANNINE LEE LAKE","GREG PENCE","Republican",0.686502362794892,-134216,316422,-0.424167725379398
2020,"INDIANA",7,176422,106146,282568,"ANDRE CARSON","SUSAN MARIE SMITH","Democrat",0.624352368279494,70276,282568,0.248704736558988
2020,"INDIANA",8,95691,214643,320617,"E THOMASINA MARSILI","LARRY BUCSHON","Republican",0.669468555940577,-118952,310334,-0.383303150798817
2020,"INDIANA",9,122566,222057,359038,"ANDY RUFF","TREY HOLLINGSWORTH","Republican",0.618477709880291,-99491,344623,-0.288695182851986
2020,"IOWA",1,201347,212088,423971,"ABBY FINKENAUER","ASHLEY HINSON","Republican",0.500241761818615,-10741,413435,-0.0259799001052161
2020,"IOWA",2,196958,196964,413989,"RITA R HART","MARIANNETTE MILLER-MEEKS","Republican",0.475771095367268,-6,393922,-1.52314417575053e-05
2020,"IOWA",3,219205,212997,460813,"CYNTHIA AXNE","DAVID YOUNG","Democrat",0.475691875012207,6208,432202,0.0143636540321424
2020,"IOWA",4,144761,237369,401495,"J D SCHOLTEN","RANDY FEENSTRA","Republican",0.591212842003014,-92608,382130,-0.242346845314422
2020,"KANSAS",1,84393,208229,292622,"KALI BARNETT","TRACEY MANN","Republican",0.711597214153413,-123836,292622,-0.423194428306826
2020,"KANSAS",2,136650,185464,336315,"MICHELLE DE LA ISLA","JAKE LATURNER","Republican",0.551459197478554,-48814,322114,-0.151542621556343
2020,"KANSAS",3,220049,178773,410418,"SHARICE DAVIDS","AMANDA L ADKINS","Democrat",0.536158258166065,41276,398822,0.10349479216292
2020,"KANSAS",4,116166,203432,319598,"LAURA LOMBARD","RON ESTES","Republican",0.636524634071552,-87266,319598,-0.273049268143105
2020,"KENTUCKY",1,82141,246329,328470,"JAMES RHODES","JAMES COMER","Republican",0.749928456175602,-164188,328470,-0.499856912351204
2020,"KENTUCKY",2,94643,255735,360399,"HANK LINDERMAN","BRETT GUTHRIE","Republican",0.709588539368866,-161092,350378,-0.459766309528566
2020,"KENTUCKY",3,230672,137425,368097,"JOHN A YARMUTH","RHONDA PALAZZO","Democrat",0.626660907315191,93247,368097,0.253321814630383
2020,"KENTUCKY",4,125896,256613,382509,"ALEXANDRA OWENSBY","THOMAS MASSIE","Republican",0.670867875004248,-130717,382509,-0.341735750008497
2020,"KENTUCKY",5,47056,250914,297970,"MATTHEW RYAN BEST","HAROLD ROGERS","Republican",0.84207806154982,-203858,297970,-0.684156123099641
2020,"KENTUCKY",6,155011,216948,378450,"JOSH HICKS","ANDY BARR","Republican",0.57325406262386,-61937,371959,-0.166515664360857
2020,"LOUISIANA",1,94730,270330,374369,"LEE ANN DUGAS","STEVE SCALISE","Republican",0.722095045262829,-175600,365060,-0.481016819153016
2020,"LOUISIANA",2,235320,63140,316982,"CEDRIC L RICHMOND","DAVID M SCHILLING","Democrat",0.742376538730906,172180,298460,0.576894726261476
2020,"LOUISIANA",3,100275,230480,340120,"""ROB"" ANDERSON","CLAY HIGGINS","Republican",0.677643184758321,-130205,330755,-0.393659959788968
2020,"LOUISIANA",4,101970,204608,306578,"KENNY HOUSTON","BEN GIBSON","Republican",0.667392963617742,-102638,306578,-0.334785927235483
2020,"LOUISIANA",5,99566,335524,435090,"JESSE P LAGARDE","""MATT"" HASTY","Republican",0.77115998988715,-235958,435090,-0.5423199797743
2020,"LOUISIANA",6,95541,265706,373996,"DARTANYON ""DAW"" WILLIAMS","GARRET GRAVES","Republican",0.710451448678595,-170165,361247,-0.471048894523692
2020,"MAINE",1,271004,165008,447981,"CHELLIE PINGREE","JAY T ALLEN","Democrat",0.604945299019378,105996,436012,0.243103400823831
2020,"MAINE",2,197974,175228,380324,"JARED F GOLDEN","DALE JOHN CRAFTS","Democrat",0.520540381359052,22746,373202,0.0609482264296547
2020,"MARYLAND",1,143877,250901,395524,"MIA MASON","ANDY HARRIS","Republican",0.634350886419029,-107024,394778,-0.271099200056741
2020,"MARYLAND",2,224836,106355,332026,"C A DUTCH RUPPERSBERGER","JOHNNY RAY SALLING","Democrat",0.677163836567016,118481,331191,0.35774220917839
2020,"MARYLAND",3,260358,112117,373206,"JOHN P SARBANES","CHARLES ANTHONY","Democrat",0.697625440105465,148241,372475,0.397989126787033
2020,"MARYLAND",4,282119,71671,354529,"ANTHONY G BROWN","GEORGE E MCDERMOTT","Democrat",0.795757187705378,210448,353790,0.594838746148845
2020,"MARYLAND",5,274210,123525,398839,"STENY H HOYER","CHRIS PALOMBI","Democrat",0.687520528333488,150685,397735,0.37885778219166
2020,"MARYLAND",6,215540,143599,366434,"DAVID J TRONE","NEIL C PARROTT","Democrat",0.58820960937031,71941,359139,0.200315198293697
2020,"MARYLAND",7,237084,92825,330998,"KWEISI MFUME","KIMBERLY KLACIK","Democrat",0.71627018894374,144259,329909,0.437269065105832
2020,"MARYLAND",8,274716,127157,402614,"JAMIE RASKIN","GREGORY THOMAS COLL","Democrat",0.682330967129807,147559,401873,0.367178188134062
2020,"MASSACHUSETTS",2,249854,132220,394084,"JAMES P MCGOVERN","TRACY LYN LOVVORN","Democrat",0.634012038042651,117634,382074,0.307882766165717
2020,"MASSACHUSETTS",4,251102,160474,434533,"JAKE AUCHINCLOSS","JULIE A HALL","Democrat",0.577866353073299,90628,411576,0.220197484790172
2020,"MASSACHUSETTS",5,294427,101351,413371,"KATHERINE M CLARK","CAROLINE COLARUSSO","Democrat",0.712258479670804,193076,395778,0.487839142145344
2020,"MASSACHUSETTS",6,286377,150695,452574,"SETH MOULTON","JOHN PAUL MORAN","Democrat",0.632773866815151,135682,437072,0.310433978841015
2020,"MASSACHUSETTS",9,260262,154261,442135,"WILLIAM R KEATING","HELEN BRADY","Democrat",0.588648263539417,106001,414523,0.255718018059312
2020,"MICHIGAN",1,153328,256581,416219,"DANA FERGUSON","JACK BERGMAN","Republican",0.616456721101151,-103253,409909,-0.251892493211908
2020,"MICHIGAN",2,154122,238711,403247,"BRYAN BERGHOEF","BILL HUIZENGA","Republican",0.591972165942958,-84589,392833,-0.215330687594983
2020,"MICHIGAN",3,189769,213649,403419,"HILLARY SCHOLTEN","PETER MEIJER","Republican",0.529595780069853,-23880,403418,-0.0591941856833359
2020,"MICHIGAN",4,120802,242621,373245,"JERRY HILLIARD","JOHN R MOOLENAAR","Republican",0.650031480662835,-121819,363423,-0.335198927970987
2020,"MICHIGAN",5,196599,150772,361032,"DANIEL T KILDEE","TIM KELLY","Democrat",0.54454729774646,45827,347371,0.131925232676303
2020,"MICHIGAN",6,152085,211496,378980,"JON HOADLEY","FRED UPTON","Republican",0.558066388727637,-59411,363581,-0.163405128430804
2020,"MICHIGAN",7,159743,227524,387267,"GRETCHEN D DRISKELL","TIM WALBERG","Republican",0.587511974942352,-67781,387267,-0.175023949884705
2020,"MICHIGAN",8,217922,202525,428344,"ELISSA SLOTKIN","PAUL JUNGE","Democrat",0.508754645798704,15397,420447,0.0366205490822862
2020,"MICHIGAN",9,230318,153296,399117,"ANDY LEVIN","CHARLES J LANGWORTHY","Democrat",0.57706887955161,77022,383614,0.200779950679589
2020,"MICHIGAN",10,138179,271607,409786,"KIMBERLY BIZON","LISA MCCLAIN","Republican",0.662802047898171,-133428,409786,-0.325604095796342
2020,"MICHIGAN",11,226128,215405,450473,"HALEY M STEVENS","ERIC S ESSHAKI","Democrat",0.501979030929712,10723,441533,0.0242858404694553
2020,"MICHIGAN",12,254957,117719,383823,"DEBBIE DINGELL","JEFF JONES","Democrat",0.664256701656753,137238,372676,0.368250169047645
2020,"MICHIGAN",13,223205,53311,285885,"RASHIDA TLAIB","DAVID DUDENHOEFER","Democrat",0.780751001276737,169894,276516,0.614409292771485
2020,"MICHIGAN",14,271370,62664,342303,"BRENDA L LAWRENCE","ROBERT VANCE PATRICK","Democrat",0.792777159417241,208706,334034,0.624804660603412
2020,"MINNESOTA",2,204534,194954,424512,"ANGIE CRAIG","TYLER KISTNER","Democrat",0.481809701492537,9580,399488,0.0239806952899712
2020,"MINNESOTA",3,246666,196625,443603,"DEAN PHILLIPS","KENDALL QUALLS","Democrat",0.556051244017737,50041,443291,0.11288521535515
2020,"MINNESOTA",4,245813,112730,389114,"BETTY MCCOLLUM","GENE RECHTZIGEL","Democrat",0.63172489296196,133083,358543,0.371177236761002
2020,"MINNESOTA",5,255924,102878,398229,"ILHAN OMAR","LACY JOHNSON","Democrat",0.642655356591308,153046,358802,0.426547232178193
2020,"MINNESOTA",7,144840,194066,363477,"COLLIN C PETERSON","MICHELLE FISCHBACH","Republican",0.533915488462819,-49226,338906,-0.145249715260279
2020,"MISSISSIPPI",1,104008,228787,332795,"ANTONIA ELIASON","TRENT KELLY","Republican",0.687471266094743,-124779,332795,-0.374942532189486
2020,"MISSISSIPPI",2,196224,101010,297234,"BENNIE G THOMPSON","BRIAN FLOWERS","Democrat",0.660166737318073,95214,297234,0.320333474636145
2020,"MISSISSIPPI",3,120782,221064,341846,"DOROTHY ""DOT"" BENFORD","MICHAEL GUEST","Republican",0.646677158720594,-100282,341846,-0.293354317441187
2020,"MISSOURI",1,249087,59940,316171,"CORI BUSH","ANTHONY ROGERS","Democrat",0.7878236776934,189147,309027,0.612072731508897
2020,"MISSOURI",2,204540,233157,449348,"JILL SCHUPP","ANN WAGNER","Republican",0.518878463907706,-28617,437697,-0.0653808456535
2020,"MISSOURI",3,116095,282866,407348,"MEGAN REZABEK","BLAINE LUETKEMEYER","Republican",0.694408711961271,-166771,398961,-0.418013289519527
2020,"MISSOURI",4,107635,245247,362836,"LINDSEY SIMMONS","VICKY HARTZLER","Republican",0.675916943191965,-137612,352882,-0.389966050974547
2020,"MISSOURI",5,207180,135934,352430,"EMANUEL CLEAVER","RYAN DERKS","Democrat",0.587861419288937,71246,343114,0.207645272416748
2020,"MISSOURI",6,118926,258709,385779,"GENA L ROSS","SAM GRAVES","Republican",0.670614522822652,-139783,377635,-0.370153719861771
2020,"MISSOURI",7,98111,254318,369283,"TERESA MONTSENY","BILLY LONG","Republican",0.688680497071352,-156207,352429,-0.443229700166558
2020,"MISSOURI",8,70561,253811,330226,"KATHY ELLIS","JASON SMITH","Republican",0.768597869337969,-183250,324372,-0.564937787478574
2020,"MONTANA",0,262340,339169,601509,"KATHLEEN WILLIAMS","MATT ROSENDALE","Republican",0.563863549838822,-76829,601509,-0.127727099677644
2020,"NEBRASKA",1,119622,189006,317566,"KATE BOLZ","JEFF FORTENBERRY","Republican",0.595170767651449,-69384,308628,-0.224814339593297
2020,"NEBRASKA",2,155706,171071,336962,"KARA EASTMAN","DON BACON","Republican",0.507686326648109,-15365,326777,-0.0470198330971886
2020,"NEBRASKA",3,50690,225157,286770,"MARK ELWORTH JR","ADRIAN SMITH","Republican",0.785148376747916,-174467,275847,-0.63247742407929
2020,"NEVADA",1,137868,74490,223213,"DINA TITUS","JOYCE BENTLEY","Democrat",0.617652197676659,63378,212358,0.298448845816969
2020,"NEVADA",2,155780,216078,382673,"PATRICIA ACKERMAN","MARK E AMODEI","Republican",0.564654417740473,-60298,371858,-0.162153295075002
2020,"NEVADA",3,203421,190975,417252,"SUSIE LEE","DAN ""BIG DAN"" RODIMER","Democrat",0.487525524143683,12446,394396,0.031557115183724
2020,"NEVADA",4,168457,152284,332469,"STEVEN HORSFORD","JIM MARCHANT","Democrat",0.506684833773976,16173,320741,0.0504238622439913
2020,"NEW HAMPSHIRE",1,205606,185159,400661,"CHRIS PAPPAS","MATT MOWERS","Democrat",0.513166991546469,20447,390765,0.0523255665169603
2020,"NEW HAMPSHIRE",2,208289,168886,386441,"ANN M KUSTER","STEVEN NEGRON","Democrat",0.538993015751434,39403,377175,0.10446874792868
2020,"NEW JERSEY",1,240567,144463,385030,"DONALD NORCROSS","CLAIRE H GUSTAFSON","Democrat",0.624800664883256,96104,385030,0.249601329766512
2020,"NEW JERSEY",2,173849,195526,376547,"AMY KENNEDY","JEFFERSON VAN DREW","Republican",0.519260543836493,-21677,369375,-0.0586856175972927
2020,"NEW JERSEY",3,229840,196327,431762,"ANDY KIM","DAVID RICHTER","Democrat",0.532330311606858,33513,426167,0.0786381864386496
2020,"NEW JERSEY",4,162420,254103,424368,"STEPHANIE SCHMID","CHRISTOPHER H SMITH","Republican",0.598779832598122,-91683,416523,-0.220115095684992
2020,"NEW JERSEY",5,225175,193333,423636,"JOSH GOTTHEIMER","FRANK T PALLOTTA","Democrat",0.531529426205516,31842,418508,0.076084567081155
2020,"NEW JERSEY",6,199648,126760,326408,"FRANK PALLONE JR","CHRISTIAN ONUOHA","Democrat",0.611651675204039,72888,326408,0.223303350408078
2020,"NEW JERSEY",7,219629,214318,433947,"TOM MALINOWSKI","THOMAS H KEAN JR","Democrat",0.506119410895801,5311,433947,0.0122388217916013
2020,"NEW JERSEY",8,176758,58686,238773,"ALBIO SIRES","JASON TODD MUSHNICK","Democrat",0.740276329400728,118072,235444,0.501486553065697
2020,"NEW JERSEY",9,203674,98629,309542,"BILL PASCRELL JR","BILLY PREMPEH","Democrat",0.657985023034031,105045,302303,0.347482492730803
2020,"NEW JERSEY",10,241522,40298,290009,"DONALD M PAYNE JR","JENNIFER ZINONE","Democrat",0.832808636973335,201224,281820,0.714016038606203
2020,"NEW JERSEY",11,235163,206013,441176,"MIKIE SHERRILL","ROSEMARY BECCHI","Democrat",0.533036701905815,29150,441176,0.0660734038116307
2020,"NEW JERSEY",12,230883,114591,351725,"BONNIE WATSON COLEMAN","MARK RAZZOLI","Democrat",0.656430449925368,116292,345474,0.336615780058702
2020,"NEW MEXICO",1,186953,134337,321290,"DEBRA A HAALAND","MICHELLE GARCIA HOLMES","Democrat",0.581882411528526,52616,321290,0.163764823057051
2020,"NEW MEXICO",2,122546,142283,264946,"XOCHITL TORRES SMALL","YVETTE HERRELL","Republican",0.537026412929427,-19737,264829,-0.0745273365077087
2020,"NEW MEXICO",3,186282,131166,317448,"TERESA LEGER FERNANDEZ","ALEXIS M JOHNSON","Democrat",0.586811068269449,55116,317448,0.173622136538898
2020,"NEW YORK",1,160978,180855,389014,"NANCY S GOROFF","LEE M ZELDIN","Republican",0.4649061473366,-19877,341833,-0.058148277082669
2020,"NEW YORK",2,144849,158151,358617,"JACKIE GORDON","ANDREW R GARBARINO","Republican",0.441002518006676,-13302,303000,-0.0439009900990099
2020,"NEW YORK",3,196056,147461,398887,"THOMAS R SUOZZI","GEORGE AD SANTOS","Democrat",0.491507619952518,48595,343517,0.14146315902852
2020,"NEW YORK",4,199762,139559,385015,"KATHLEEN M RICE","DOUGLAS L TUMAN","Democrat",0.518842123034168,60203,339321,0.177421969167838
2020,"NEW YORK",6,144149,67735,249493,"GRACE MENG","THOMAS J ZMICH","Democrat",0.577767712921805,76414,211884,0.36064072794548
2020,"NEW YORK",7,156889,29404,235169,"NYDIA M VELAZQUEZ","BRIAN W KELLY","Democrat",0.667132997971671,127485,186293,0.684325229611419
2020,"NEW YORK",8,207111,39124,285735,"HAKEEM S JEFFRIES","GARFIELD H WALLACE","Democrat",0.724835949393669,167987,246235,0.682222267346234
2020,"NEW YORK",9,195758,40110,287412,"YVETTE D CLARKE","CONSTANTINE JEAN-PIERRE","Democrat",0.681105868926837,155648,235868,0.659894517272373
2020,"NEW YORK",10,181215,61045,289130,"JERROLD L NADLER","CATHY A BERNSTEIN","Democrat",0.626759589112164,120170,242260,0.496037315281103
2020,"NEW YORK",11,134625,143420,301351,"MAX N ROSE","NICOLE MALLIOTAKIS","Republican",0.475923424843455,-8795,278045,-0.0316315704292471
2020,"NEW YORK",12,265172,49157,336079,"CAROLYN B MALONEY","CARLOS SANTIAGO-CANO","Democrat",0.789016868057808,216015,314329,0.68722580480961
2020,"NEW YORK",13,202916,19829,267236,"ADRIANO ESPAILLAT","LOVELYNN GWINN","Democrat",0.759313864898442,183087,222745,0.821957844171586
2020,"NEW YORK",14,152661,52477,223611,"ALEXANDRIA OCASIO-CORTEZ","JOHN C CUMMINGS","Democrat",0.682707916873499,100184,205138,0.488373680156773
2020,"NEW YORK",15,169533,18984,200205,"RITCHIE TORRES","PATRICK DELICES","Democrat",0.846797033041133,150549,188517,0.798596413055586
2020,"NEW YORK",17,183976,117309,359958,"MONDAIRE JONES","MAUREEN MCARDLE SCHULMAN","Democrat",0.511104073252991,66667,301285,0.221275536452196
2020,"NEW YORK",18,171161,128611,358738,"SEAN PATRICK MALONEY","CHELE C FARLEY","Democrat",0.477119792160295,42550,299772,0.141941208651909
2020,"NEW YORK",19,168281,151475,370433,"ANTONIO DELGADO","KYLE VAN DE WATER","Democrat",0.454281880933934,16806,319756,0.052558826104905
2020,"NEW YORK",20,194071,120839,369372,"PAUL D TONKO","ELIZABETH L JOY","Democrat",0.525407989777244,73232,314910,0.232548982248897
2020,"NEW YORK",21,122422,169684,325798,"TEDRA L COBB","ELISE M STEFANIK","Republican",0.520825787758059,-47262,292106,-0.161797429700177
2020,"NEW YORK",22,138898,143291,326568,"ANTHONY J BRINDISI","CLAUDIA TENNEY","Republican",0.438778447367776,-4393,282189,-0.0155675805931486
2020,"NEW YORK",23,116025,161800,323865,"TRACY MITRANO","TOM REED","Republican",0.499590878915598,-45775,277825,-0.164761990461622
2020,"NEW YORK",24,147877,156236,352683,"DANA BALTER","JOHN M KATKO","Republican",0.442992715838302,-8359,304113,-0.0274864935073476
2020,"NEW YORK",25,187503,115940,367377,"JOSEPH D MORELLE","GEORGE MITRIS","Democrat",0.510383066985685,71563,303443,0.235836713979232
2020,"NEW YORK",26,202400,91706,337867,"BRIAN HIGGINS","RICKY T DONOVAN SR","Democrat",0.599052289806344,110694,294106,0.376374504430375
2020,"NEW YORK",27,136686,192619,397802,"NATHAN D MCMURRAY","CHRIS JACOBS","Republican",0.484208224191935,-55933,329305,-0.169851657278207
2020,"NORTH CAROLINA",1,188870,159748,348618,"G K BUTTERFIELD","SANDY SMITH","Democrat",0.541767780206415,29122,348618,0.0835355604128301
2020,"NORTH CAROLINA",2,311887,172544,495345,"DEBORAH K ROSS","ALAN D SWAIN","Democrat",0.629635910325127,139343,484431,0.287642615769841
2020,"NORTH CAROLINA",3,132752,229800,362552,"DARYL FARROW","GREGORY F MURPHY","Republican",0.633840111211633,-97048,362552,-0.267680222423266
2020,"NORTH CAROLINA",4,332421,161298,493719,"DAVID E PRICE","ROBERT THOMAS","Democrat",0.673299994531302,171123,493719,0.346599989062604
2020,"NORTH CAROLINA",5,119846,257843,385244,"DAVID WILSON BROWN","VIRGINIA FOXX","Republican",0.669297899513036,-137997,377689,-0.36537203889973
2020,"NORTH CAROLINA",6,253531,153598,407129,"KATHY MANNING","LEE HAYWOOD","Democrat",0.622728913931457,99933,407129,0.245457827862913
2020,"NORTH CAROLINA",7,179045,272443,452208,"CHRISTOPHER M WARD","DAVID ROUZER","Republican",0.60247275589994,-93398,451488,-0.206867070664115
2020,"NORTH CAROLINA",8,177781,202774,380555,"PATRICIA TIMMONS-GOODSON","RICHARD HUDSON","Republican",0.532837566186228,-24993,380555,-0.065675132372456
2020,"NORTH CAROLINA",9,179463,224661,404124,"CYNTHIA L WALLACE","DAN BISHOP","Republican",0.55592095495442,-45198,404124,-0.11184190990884
2020,"NORTH CAROLINA",10,128189,284095,412284,"DAVID PARKER","PATRICK T MCHENRY","Republican",0.689075976753888,-155906,412284,-0.378151953507776
2020,"NORTH CAROLINA",11,190609,245351,450145,"MOE DAVIS","MADISON CAWTHORN","Republican",0.545048817603217,-54742,435960,-0.125566565739976
2020,"NORTH CAROLINA",13,124684,267181,391865,"SCOTT HUFFMAN","TED BUDD","Republican",0.681818993786125,-142497,391865,-0.363637987572251
2020,"OHIO",1,172022,199560,385285,"KATE SCHRODER","STEVE CHABOT","Republican",0.517954241665261,-27538,371582,-0.0741101560355453
2020,"OHIO",2,146781,230430,377248,"JAIME M CASTLE","BRAD R WENSTRUP","Republican",0.610818347612181,-83649,377211,-0.221756523537225
2020,"OHIO",3,227420,93569,321092,"JOYCE BEATTY","MARK F RICHARDSON","Democrat",0.708270526827202,133851,320989,0.416995597979993
2020,"OHIO",4,101897,235875,347626,"SHANNON M FRESHOUR","JIM JORDAN","Republican",0.678530949928947,-133978,337772,-0.396652179576756
2020,"OHIO",5,120962,257019,377981,"NICK RUBANDO","ROBERT E LATTA","Republican",0.679978623264132,-136057,377981,-0.359957246528265
2020,"OHIO",6,85661,249130,334791,"SHAWNA ROBERTS","BILL JOHNSON","Republican",0.744135893736689,-163469,334791,-0.488271787473379
2020,"OHIO",7,102271,236607,350549,"QUENTIN POTTER","BOB GIBBS","Republican",0.674961275028598,-134336,338878,-0.396414048713696
2020,"OHIO",8,110766,246277,357157,"VANESSA ENOCH","WARREN DAVIDSON","Republican",0.689548293887562,-135511,357043,-0.379536918522419
2020,"OHIO",9,190328,111385,301752,"MARCY KAPTUR","ROB WEBER","Democrat",0.630743126806119,78943,301713,0.261649315740455
2020,"OHIO",10,151976,212972,364948,"DESIREE TIMS","MICHAEL R TURNER","Republican",0.583568069971612,-60996,364948,-0.167136139943225
2020,"OHIO",11,242098,60323,302421,"MARCIA L FUDGE","LAVERNE GORE","Democrat",0.800533031766974,181775,302421,0.601066063533948
2020,"OHIO",12,182847,241790,437672,"ALAINA SHEARER","TROY BALDERSON","Republican",0.552445667074887,-58943,424637,-0.138807970101522
2020,"OHIO",13,173631,148648,330801,"TIM RYAN","CHRISTINA M HAGAN","Democrat",0.524880517289851,24983,322279,0.0775197887544643
2020,"OHIO",14,158586,238864,397450,"HILLARY O'CONNOR MUERI","DAVID P JOYCE","Republican",0.600991319662851,-80278,397450,-0.201982639325701
2020,"OHIO",15,140183,243103,383361,"JOEL NEWBY","STEVE STIVERS","Republican",0.634135971056002,-102920,383286,-0.268520112918291
2020,"OHIO",16,144071,247335,391406,"AARON PAUL GODFREY","ANTHONY GONZALEZ","Republican",0.631914176072927,-103264,391406,-0.263828352145854
2020,"OKLAHOMA",1,109641,213700,335471,"KOJO ASAMOA-CAESAR","KEVIN HERN","Republican",0.637014823934111,-104059,323341,-0.321824327876762
2020,"OKLAHOMA",2,63472,216511,288527,"DANYELL LANIER","MARKWAYNE MULLIN","Republican",0.750401175626545,-153039,279983,-0.546601043634792
2020,"OKLAHOMA",3,66501,242677,309178,"ZOE MIDYETT","FRANK D LUCAS","Republican",0.784910310565435,-176176,309178,-0.56982062113087
2020,"OKLAHOMA",4,90459,213096,314358,"MARY BRANNON","TOM COLE","Republican",0.677876815605138,-122637,303555,-0.404002569550823
2020,"OKLAHOMA",5,145658,158191,303849,"KENDRA S HORN","STEPHANIE BICE","Republican",0.520623730866318,-12533,303849,-0.0412474617326369
2020,"OREGON",1,297071,161928,459899,"SUZANNE BONAMICI","CHRISTOPHER C CHRISTENSEN","Democrat",0.645948349528918,135143,458999,0.294429835359118
2020,"OREGON",2,168881,273835,457433,"ALEX SPENSER","CLIFF BENTZ","Republican",0.598634116908924,-104954,442716,-0.237068459237976
2020,"OREGON",3,343574,110570,470506,"EARL BLUMENAUER","JOANNA HARBOUR","Democrat",0.730222356356773,233004,454144,0.513061936302142
2020,"OREGON",4,240950,216081,467705,"PETER A DEFAZIO","ALEK SKARLATOS","Democrat",0.515175163831903,24869,457031,0.0544142519872831
2020,"OREGON",5,234863,204372,452646,"KURT SCHRADER","AMY RYAN COURSER","Democrat",0.518866840754143,30491,439235,0.0694184206631985
2020,"PENNSYLVANIA",1,191875,249804,441679,"CHRISTINA FINELLO","BRIAN K FITZPATRICK","Republican",0.56557816876057,-57929,441679,-0.131156337521141
2020,"PENNSYLVANIA",2,198140,75022,273162,"BRENDAN F BOYLE","DAVID TORRES","Democrat",0.725357114093468,123118,273162,0.450714228186937
2020,"PENNSYLVANIA",3,341708,33671,375379,"DWIGHT EVANS","MICHAEL HARVEY","Democrat",0.910301322130433,308037,375379,0.820602644260867
2020,"PENNSYLVANIA",4,264637,179926,444563,"MADELEINE DEAN CUNNANE","KATHY BARNETTE","Democrat",0.595274460537652,84711,444563,0.190548921075303
2020,"PENNSYLVANIA",5,255743,139552,395295,"MARY GAY SCANLON","DASHA PRUETT","Democrat",0.646967454685741,116191,395295,0.293934909371482
2020,"PENNSYLVANIA",6,226440,177526,403966,"CHRISSY J HOULAHAN","JOHN WILLIAM EMMONS","Democrat",0.560542223850522,48914,403966,0.121084447701044
2020,"PENNSYLVANIA",7,195475,181407,376882,"SUSAN ELLIS WILD","LISA SCHELLER","Democrat",0.518663666611831,14068,376882,0.0373273332236615
2020,"PENNSYLVANIA",8,178004,165783,343787,"MATTHEW ALTON CARTWRIGHT","JAMES ROCCO BOGNET","Democrat",0.517774086861923,12221,343787,0.0355481737238465
2020,"PENNSYLVANIA",9,118266,232988,351254,"GARY STEVEN WEGMAN","DANIEL PHILIP MEUSER","Republican",0.663303478394552,-114722,351254,-0.326606956789104
2020,"PENNSYLVANIA",10,182938,208896,391834,"EUGENE A DEPASQUALE","SCOTT G PERRY","Republican",0.533123720759301,-25958,391834,-0.0662474415186023
2020,"PENNSYLVANIA",11,141325,241915,383240,"SARAH E HAMMOND","LLOYD K SMUCKER","Republican",0.63123630101242,-100590,383240,-0.262472602024841
2020,"PENNSYLVANIA",12,99199,241035,340234,"LEE GRIFFIN","FREDERICK B KELLER","Republican",0.708438897934951,-141836,340234,-0.416877795869901
2020,"PENNSYLVANIA",13,96612,267789,364401,"RAYMOND TODD ROWLEY","JOHN JOYCE","Republican",0.734874492660558,-171177,364401,-0.469748985321116
2020,"PENNSYLVANIA",14,131895,241688,373583,"WILLIAM A MARX","GUY RESCHENTHALER","Republican",0.646945926340331,-109793,373583,-0.293891852680663
2020,"PENNSYLVANIA",15,92156,255058,347214,"ROBERT M WILLIAMS","GLENN W THOMPSON JR","Republican",0.73458443495942,-162902,347214,-0.46916886991884
2020,"PENNSYLVANIA",16,143962,210088,354050,"KRISTY MARIE GNIBUS","GEORGE J KELLY JR","Republican",0.593385115096738,-66126,354050,-0.186770230193475
2020,"PENNSYLVANIA",17,222253,212284,434537,"CONOR J LAMB","RICHARD SEAN PARNELL","Democrat",0.511470829871795,9969,434537,0.0229416597435892
2020,"PENNSYLVANIA",18,266084,118163,384247,"MICHAEL F DOYLE JR","LUKE EDISON NEGRON","Democrat",0.692481658932926,147921,384247,0.384963317865852
2020,"RHODE ISLAND",2,154086,109894,264557,"JAMES R LANGEVIN","ROBERT B LANCIA","Democrat",0.582430251325801,44192,263980,0.167406621713766
2020,"SOUTH CAROLINA",1,210627,216042,427111,"JOE CUNNINGHAM","NANCY MACE","Republican",0.505821671649758,-5415,426669,-0.0126913368442516
2020,"SOUTH CAROLINA",2,155118,202715,364215,"ADAIR FORD BOROUGHS","JOE WILSON","Republican",0.556580591134357,-47597,357833,-0.133014562659118
2020,"SOUTH CAROLINA",3,95712,237544,333564,"HOSEA CLEVELAND","JEFF DUNCAN","Republican",0.712139199673826,-141832,333256,-0.425594737979211
2020,"SOUTH CAROLINA",4,133023,222126,360550,"KIM NELSON","WILLIAM R TIMMONS IV","Republican",0.616075440299542,-89103,355149,-0.250889063463504
2020,"SOUTH CAROLINA",5,145979,220006,366258,"MOE BROWN","RALPH NORMAN","Republican",0.600685855326027,-74027,365985,-0.202267852507616
2020,"SOUTH CAROLINA",6,197477,89258,289653,"JAMES E CLYBURN","JOHN MCCOLLUM","Democrat",0.681770946615433,108219,286735,0.377418173574904
2020,"SOUTH CAROLINA",7,138863,224993,364091,"MELISSA WARD WATSON","TOM RICE","Republican",0.617958147825681,-86130,363856,-0.236714524427246
2020,"TENNESSEE",1,68617,228181,305423,"BLAIR WALSINGHAM","DIANA HARSHBARGER","Republican",0.747098286638531,-159564,296798,-0.537618178020068
2020,"TENNESSEE",2,109684,238907,353197,"RENEE HOYOS","TIM BURCHETT","Republican",0.6764128800641,-129223,348591,-0.370700907367086
2020,"TENNESSEE",3,97687,215571,320299,"MEG GORMAN","CHARLES J ""CHUCK"" FLEISCHMANN","Republican",0.673030512115242,-117884,313258,-0.376316007891259
2020,"TENNESSEE",4,111908,223802,335710,"CHRISTOPHER J HALE","SCOTT DESJARLAIS","Republican",0.666652765779989,-111894,335710,-0.333305531559977
2020,"TENNESSEE",6,83852,257572,349578,"CHRISTOPHER MARTIN FINLEY","JOHN W ROSE","Republican",0.73680838039007,-173720,341424,-0.508810159801303
2020,"TENNESSEE",7,95839,245188,350635,"KIRAN SREEPADA","MARK E GREEN","Republican",0.69926847006146,-149349,341027,-0.437938931521551
2020,"TENNESSEE",8,97890,227216,331853,"ERIKA STOTTS PEARSON","DAVID KUSTOFF","Republican",0.684688702527927,-129326,325106,-0.397796411016715
2020,"TENNESSEE",9,187905,48818,242880,"STEVE COHEN","CHARLOTTE BERGMANN","Democrat",0.773653656126482,139087,236723,0.587551695441508
2020,"TEXAS",1,83016,219726,302742,"HANK GILBERT","LOUIE GOHMERT","Republican",0.725786313098282,-136710,302742,-0.451572626196563
2020,"TEXAS",2,148374,192828,346726,"SIMA LADJEVARDIAN","DAN CRENSHAW","Republican",0.556139429982176,-44454,341202,-0.130286457875393
2020,"TEXAS",3,179458,230512,418591,"LULU SEIKALY","VAN TAYLOR","Republican",0.550685514022041,-51054,409970,-0.12453106324853
2020,"TEXAS",4,76326,253837,337803,"RUSSELL FOSTER","PAT FALLON","Republican",0.751435007978023,-177511,330163,-0.5376465563979
2020,"TEXAS",5,100743,173836,280413,"CAROLYN SALTER","LANCE GOODEN","Republican",0.619928462660433,-73093,274579,-0.266200255664126
2020,"TEXAS",6,149530,179507,339992,"STEPHEN DANIEL","RON WRIGHT","Republican",0.527974187627944,-29977,329037,-0.0911052556399432
2020,"TEXAS",7,159529,149054,314125,"LIZZIE FLETCHER","WESLEY HUNT","Democrat",0.507851969757262,10475,308583,0.0339454863035229
2020,"TEXAS",8,97409,277327,382471,"ELIZABETH HERNANDEZ","KEVIN BRADY","Republican",0.725092882859093,-179918,374736,-0.480119337346825
2020,"TEXAS",9,172938,49575,229107,"AL GREEN","JOHNNY TEAGUE","Democrat",0.754835077060064,123363,222513,0.55440805705734
2020,"TEXAS",10,187686,217216,413894,"MIKE SIEGEL","MICHAEL T MCCAUL","Republican",0.524810700324238,-29530,404902,-0.0729312278032709
2020,"TEXAS",11,53394,232568,291773,"JON MARK HOGG","AUGUST PFLUGER","Republican",0.797085405435047,-179174,285962,-0.626565767479595
2020,"TEXAS",12,121250,233853,367021,"LISA WELCH","KAY GRANGER","Republican",0.637165175834625,-112603,355103,-0.317099545765595
2020,"TEXAS",13,50477,217124,273508,"GUS TRUJILLO","RONNY JACKSON","Republican",0.79384880880998,-166647,267601,-0.622744309625151
2020,"TEXAS",14,118574,190541,309115,"ADRIENNE BELL","RANDY K WEBER SR","Republican",0.616408132895524,-71967,309115,-0.232816265791049
2020,"TEXAS",15,115605,109017,228917,"VICENTE GONZALEZ","MONICA DE LA CRUZ-HERNANDEZ","Democrat",0.505008365477444,6588,224622,0.0293292731789406
2020,"TEXAS",16,154108,84006,238114,"VERONICA ESCOBAR","IRENE ARMENDARIZ-JACKSON","Democrat",0.647202600435086,70102,238114,0.294405200870171
2020,"TEXAS",17,125565,171390,306873,"RICK KENNEDY","PETE SESSIONS","Republican",0.558504658278832,-45825,296955,-0.154316310552104
2020,"TEXAS",18,180952,58033,246895,"SHEILA JACKSON LEE","WENDELL CHAMPION","Democrat",0.732910751534053,122919,238985,0.514337719940582
2020,"TEXAS",19,60583,198198,265052,"TOM WATSON","JODEY C ARRINGTON","Republican",0.747770248856828,-137615,258781,-0.531781699583818
2020,"TEXAS",20,175078,89628,270723,"JOAQUIN CASTRO","MAURO GARZA","Democrat",0.646705303945361,85450,264706,0.32281096763957
2020,"TEXAS",21,205780,235740,453750,"WENDY R DAVIS","CHIP ROY","Republican",0.519537190082645,-29960,441520,-0.0678564957419822
2020,"TEXAS",22,181998,210259,408048,"SRI PRESTON KULKARNI","TROY NEHLS","Republican",0.515280065090381,-28261,392257,-0.0720471527595428
2020,"TEXAS",23,137693,149395,295457,"GINA ORTIZ JONES","TONY GONZALES","Republican",0.505640414679632,-11702,287088,-0.0407610210109792
2020,"TEXAS",24,163326,167910,344021,"CANDACE VALENZUELA","BETH VAN DUYNE","Republican",0.488080669494013,-4584,331236,-0.013839075462812
2020,"TEXAS",25,165697,220088,393523,"JULIE OLIVER","ROGER WILLIAMS","Republican",0.559276077891254,-54391,385785,-0.140987855930117
2020,"TEXAS",26,161009,261963,432215,"CAROL H IANNUZZI","MICHAEL C BURGESS","Republican",0.606094189234525,-100954,422972,-0.238677737533454
2020,"TEXAS",27,95466,172305,273253,"RICARDO ""RICK"" DE LA FUENTE","MICHAEL CLOUD","Republican",0.630569472247331,-76839,267771,-0.286957885656027
2020,"TEXAS",28,137494,91925,235844,"HENRY CUELLAR","SANDRA WHITTEN","Democrat",0.58298705924255,45569,229419,0.198627838147669
2020,"TEXAS",29,111305,42840,156473,"SYLVIA R GARCIA","JAIMY Z BLANCO","Democrat",0.711336780147374,68465,154145,0.444159719744396
2020,"TEXAS",30,204928,48685,264464,"EDDIE BERNICE JOHNSON","TRE PENNIE","Democrat",0.774880513037691,156243,253613,0.616068576926262
2020,"TEXAS",31,176293,212695,398057,"DONNA IMAM","JOHN R CARTER","Republican",0.534333022657559,-36402,388988,-0.093581292996185
2020,"TEXAS",32,178542,157867,343687,"COLIN Z ALLRED","GENEVIEVE COLLINS","Democrat",0.519490117461528,20675,336409,0.0614579277011019
2020,"TEXAS",33,105317,39638,157606,"MARC A VEASEY","FABIAN CORDOVA VASQUEZ","Democrat",0.668229635927566,65679,144955,0.453099237694457
2020,"TEXAS",34,111439,84119,201027,"FILEMON VELA","REY GONZALEZ","Democrat",0.55434842085889,27320,195558,0.139702799169556
2020,"TEXAS",35,176373,80795,269797,"LLOYD DOGGETT","JENNY GARCIA SHARON","Democrat",0.653724837563057,95578,257168,0.37165588253593
2020,"TEXAS",36,73418,222712,302549,"RASHAD LEWIS","BRIAN BABIN","Republican",0.736118777454231,-149294,296130,-0.504150204302165
2020,"UTAH",1,104194,237988,342351,"DARREN PARRY","BLAKE DAVID MOORE","Republican",0.695157893506956,-133794,342182,-0.391002448989134
2020,"UTAH",2,129762,208997,354224,"KAEL WESTON","CHRIS STEWART","Republican",0.590013663670446,-79235,338759,-0.233897844780508
2020,"UTAH",3,96067,246674,358927,"DEVIN D THORPE","JOHN R CURTIS","Republican",0.687253954146665,-150607,342741,-0.43941926994436
2020,"UTAH",4,175923,179688,376730,"BEN MCADAMS","BURGESS OWENS","Republican",0.476967589520346,-3765,355611,-0.0105874115255152
2020,"VERMONT",0,238827,95830,370968,"PETER WELCH","MIRIAM BERRY","Democrat",0.643794073882383,142997,334657,0.427294214673531
2020,"VIRGINIA",1,186923,260614,448178,"QASIM RASHID","ROBERT J WITTMAN","Republican",0.581496637496709,-73691,447537,-0.164659011433692
2020,"VIRGINIA",2,185733,165031,360277,"ELAINE G LURIA","SCOTT W TAYLOR","Democrat",0.515528329590843,20702,350764,0.0590197397680492
2020,"VIRGINIA",3,233326,107299,341361,"ROBERT C ""BOBBY"" SCOTT","JOHN W COLLICK JR","Democrat",0.683516863379238,126027,340625,0.36998752293578
2020,"VIRGINIA",4,241142,149625,391345,"A DONALD MCEACHIN","LEON BENJAMIN SR","Democrat",0.616187762715762,91517,390767,0.234198384203374
2020,"VIRGINIA",5,190315,210988,402317,"B CAMERON WEBB","ROBERT G ""BOB"" GOOD","Republican",0.524432226328989,-20673,401303,-0.0515146908944115
2020,"VIRGINIA",6,134729,246606,381813,"NICHOLAS A BETTS","BEN CLINE","Republican",0.645881622679165,-111877,381335,-0.293382458992749
2020,"VIRGINIA",7,230893,222623,454339,"ABIGAIL DAVIS SPANBERGER","NICK J FREITAS","Democrat",0.508195422360836,8270,453516,0.0182352993058679
2020,"VIRGINIA",8,301454,95365,397745,"DONALD S BEYER JR","JEFF A JORDAN","Democrat",0.757907704685163,206089,396819,0.51935265196475
2020,"VIRGINIA",10,268734,206253,475546,"JENNIFER WEXTON","ALISCIA N ANDREWS","Democrat",0.565106214751044,62481,474987,0.131542547480247
2020,"VIRGINIA",11,280725,111380,393241,"GERALD E CONNOLLY","MANGA A ANANTATMULA","Democrat",0.713875206298428,169345,392105,0.431886867038166
2020,"WASHINGTON",1,249944,176407,426862,"SUZAN K DELBENE","JEFFREY BEELER SR","Democrat",0.585538183300458,73537,426351,0.172479951964461
2020,"WASHINGTON",2,255252,148384,404598,"RICK LARSEN","TIMOTHY S HAZELO","Democrat",0.630878056737799,106868,403636,0.26476330158856
2020,"WASHINGTON",3,181347,235579,417903,"CAROLYN LONG","JAIME HERRERA BEUTLER","Republican",0.563716939098308,-54232,416926,-0.130075840796688
2020,"WASHINGTON",4,102667,202108,305263,"DOUGLAS E MCKINLEY","DAN NEWHOUSE","Republican",0.662078273488762,-99441,304775,-0.326276761545402
2020,"WASHINGTON",5,155737,247815,404360,"DAVE WILSON","CATHY MCMORRIS RODGERS","Republican",0.612857354832328,-92078,403552,-0.228168860518595
2020,"WASHINGTON",6,247429,168783,417216,"DEREK KILMER","ELIZABETH KREISELMAIER","Democrat",0.593047725878202,78646,416212,0.188956589430386
2020,"WASHINGTON",7,387109,78240,466462,"PRAMILA JAYAPAL","CRAIG KELLER","Democrat",0.829883248796258,308869,465349,0.663736249567529
2020,"WASHINGTON",8,213123,198423,412112,"KIM SCHRIER","JESSE JENSEN","Democrat",0.517148250960904,14700,411546,0.0357189718767768
2020,"WASHINGTON",9,258771,89697,349050,"ADAM SMITH","DOUG BASLER","Democrat",0.741357971637301,169074,348468,0.485192327559489
2020,"WEST VIRGINIA",1,81177,180488,261723,"NATALIE CLINE","DAVID B MCKINLEY","Republican",0.689614592527214,-99311,261665,-0.379534901496188
2020,"WEST VIRGINIA",2,100799,172195,272994,"CATHY KUNKEL","ALEXANDER X MOONEY","Republican",0.630764778713085,-71396,272994,-0.261529557426171
2020,"WEST VIRGINIA",3,64927,161585,226668,"HILARY TURNER","CAROL D MILLER","Republican",0.712870806642314,-96658,226512,-0.426723528996256
2020,"WISCONSIN",1,163170,238271,401754,"ROGER POLACK","BRYAN STEIL","Republican",0.593076857977767,-75101,401441,-0.187078549525335
2020,"WISCONSIN",2,318523,138306,457205,"MARK POCAN","PETER THERON","Democrat",0.696674358329415,180217,456829,0.394495533339608
2020,"WISCONSIN",3,199870,189524,389618,"RON KIND","DERRICK VAN ORDEN","Democrat",0.51298964626891,10346,389394,0.0265694900280949
2020,"WISCONSIN",4,232668,70769,311697,"GWEN MOORE","TIM ROGERS","Democrat",0.74645569254757,161899,303437,0.533550621710602
2020,"WISCONSIN",5,175902,265434,441599,"TOM PALZEWICZ","SCOTT FITZGERALD","Republican",0.601074730694589,-89532,441336,-0.202865843710914
2020,"WISCONSIN",6,164239,238874,403333,"JESSICA J KING","GLENN GROTHMAN","Republican",0.592250076239732,-74635,403113,-0.185146596611868
2020,"WISCONSIN",7,162741,252048,415007,"TRICIA ZUNKER","THOMAS P TIFFANY","Republican",0.607334334119665,-89307,414789,-0.215307059733985
2020,"WISCONSIN",8,149558,268173,417838,"AMANDA STUCK","MIKE GALLAGHER","Republican",0.641810941082429,-118615,417731,-0.283950676392224
2020,"WYOMING",0,66576,185732,278503,"LYNNETTE GREY BULL","LIZ CHENEY","Republican",0.666894072954331,-119156,252308,-0.472264058214563
2022,"ALABAMA",2,58014,137460,198961,"PHYLLIS HARVEY-HALL","BARRY MOORE","Republican",0.690889169234172,-79446,195474,-0.406427453267442
2022,"ALABAMA",3,47859,135602,190406,"LIN VEASEY","MIKE ROGERS","Republican",0.712172935726815,-87743,183461,-0.47826513536937
2022,"ALABAMA",4,26694,164655,195733,"RICK NEIGHBORS","ROBERT B ADERHOLT","Republican",0.841222481645916,-137961,191349,-0.720991486759795
2022,"ALABAMA",5,62740,142435,212317,"KATHY WARNER-STANTON","DALE STRONG","Republican",0.67086008185873,-79695,205175,-0.388424515657366
2022,"ALABAMA",7,123233,67416,193940,"TERRI A SEWELL","BEATRICE NICHOLS","Democrat",0.635418170568217,55817,190649,0.292773631123164
2022,"ALASKA",0,128553,129379,263610,"MARY SATTLER PELTOLA","SARAH PALIN","Republican",0.490797010735556,-826,257932,-0.00320239442953957
2022,"ARIZONA",1,179141,182336,361477,"JEVIN HODGE","DAVID SCHWEIKERT","Republican",0.50441936831389,-3195,361477,-0.00883873662777991
2022,"ARIZONA",2,149151,174169,323396,"TOM O’HALLERAN","ELI CRANE","Republican",0.53856262909869,-25018,323320,-0.0773784485958184
2022,"ARIZONA",3,108599,32475,141074,"RUBEN GALLEGO","JEFF ZINK","Democrat",0.769801664374725,76124,141074,0.539603328749451
2022,"ARIZONA",4,148941,116521,265498,"GREG STANTON","KELLY COOPER","Democrat",0.560987276740314,32420,265462,0.122126707400683
2022,"ARIZONA",5,120243,182464,321590,"JAVIER RAMOS","ANDY BIGGS","Republican",0.567380826518238,-62221,302707,-0.205548599801128
2022,"ARIZONA",6,171969,177201,349283,"KIRSTEN ENGEL","JUAN CISCOMANI","Republican",0.507327868805524,-5232,349170,-0.0149841051636739
2022,"ARIZONA",7,126418,69444,195862,"RAÚL M GRIJALVA","LUIS POZZOLO","Democrat",0.645444241353606,56974,195862,0.290888482707212
2022,"ARKANSAS",1,54598,153774,208372,"MONTE HODGES","ERIC A “RICK” CRAWFORD","Republican",0.737978231240282,-99176,208372,-0.475956462480564
2022,"ARKANSAS",2,86887,147975,246446,"QUINTESSA HATHAWAY","J FRENCH HILL","Republican",0.600435795265494,-61088,234862,-0.260101676729313
2022,"ARKANSAS",3,73541,142401,223588,"LAUREN MALLETT-HAYS","STEVE WOMACK","Republican",0.636890172996762,-68860,215942,-0.318881921997573
2022,"ARKANSAS",4,56745,153850,216696,"JOHN WHITE","BRUCE WESTERMAN","Republican",0.709980802599033,-97105,210595,-0.461098316674185
2022,"CALIFORNIA",1,93386,152839,246225,"MAX STEINER","DOUG LAMALFA","Republican",0.620729008021119,-59453,246225,-0.241458016042238
2022,"CALIFORNIA",2,229720,79029,308749,"JARED HUFFMAN","DOUGLAS BROWER","Democrat",0.744034798493274,150691,308749,0.488069596986549
2022,"CALIFORNIA",3,156761,181438,338199,"KERMIT JONES","KEVIN KILEY","Republican",0.536482958258303,-24677,338199,-0.0729659165166071
2022,"CALIFORNIA",4,176900,84007,260907,"MIKE THOMPSON","MATT BROCK","Democrat",0.678019370886944,92893,260907,0.356038741773889
2022,"CALIFORNIA",5,109506,173524,283030,"MICHAEL J “MIKE” BARKLEY","TOM MCCLINTOCK","Republican",0.613094018301947,-64018,283030,-0.226188036603894
2022,"CALIFORNIA",6,121058,95325,216383,"AMI BERA","TAMIKA HAMILTON","Democrat",0.559461695234838,25733,216383,0.118923390469676
2022,"CALIFORNIA",7,150618,70033,220651,"DORIS O MATSUI","MAX SEMENENKO","Democrat",0.682607375448106,80585,220651,0.365214750896212
2022,"CALIFORNIA",8,145501,46634,192135,"JOHN GARAMENDI","RUDY RECILE","Democrat",0.757285242147448,98867,192135,0.514570484294897
2022,"CALIFORNIA",9,95598,78802,174400,"JOSH HARDER","TOM PATTI","Democrat",0.548153669724771,16796,174400,0.0963073394495413
2022,"CALIFORNIA",11,220848,42217,263065,"NANCY PELOSI","JOHN DENNIS","Democrat",0.839518750118792,178631,263065,0.679037500237584
2022,"CALIFORNIA",12,217110,22859,239969,"BARBARA LEE","STEPHEN SLAUSON","Democrat",0.904741862490572,194251,239969,0.809483724981143
2022,"CALIFORNIA",13,66496,67060,133556,"ADAM GRAY","JOHN DUARTE","Republican",0.502111473838689,-564,133556,-0.00422294767737878
2022,"CALIFORNIA",14,137612,60852,198464,"ERIC SWALWELL","ALISON HAYDEN","Democrat",0.693385198323122,76760,198464,0.386770396646243
2022,"CALIFORNIA",17,127853,52400,180253,"RO KHANNA","RITESH TANDON","Democrat",0.709297487420459,75453,180253,0.418594974840918
2022,"CALIFORNIA",18,99776,51737,151513,"ZOE LOFGREN","PETER HERNANDEZ","Democrat",0.658530951139506,48039,151513,0.317061902279012
2022,"CALIFORNIA",19,194494,88816,283310,"JIMMY PANETTA","JEFF GORMAN","Democrat",0.686505947548622,105678,283310,0.373011895097243
2022,"CALIFORNIA",20,74934,153847,228781,"MARISA WOOD","KEVIN MCCARTHY","Republican",0.672464059515432,-78913,228781,-0.344928119030864
2022,"CALIFORNIA",21,68074,57573,125647,"JIM COSTA","MICHAEL MAHER","Democrat",0.541787706829451,10501,125647,0.0835754136589015
2022,"CALIFORNIA",22,49862,52994,102856,"RUDY SALAS","DAVID G VALADAO","Republican",0.515225169168546,-3132,102856,-0.0304503383370926
2022,"CALIFORNIA",23,65908,103197,169105,"DEREK MARSHALL","JAY OBERNOLTE","Republican",0.610253984210993,-37289,169105,-0.220507968421986
2022,"CALIFORNIA",24,159019,103533,262552,"SALUD O CARBAJAL","BRAD ALLEN","Democrat",0.605666686980103,55486,262552,0.211333373960206
2022,"CALIFORNIA",25,87641,65101,152742,"RAUL RUIZ","BRIAN E HAWKINS","Democrat",0.57378455172775,22540,152742,0.1475691034555
2022,"CALIFORNIA",26,134575,112214,246789,"JULIA BROWNLEY","MATT JACOBS","Democrat",0.545303883074205,22361,246789,0.0906077661484102
2022,"CALIFORNIA",27,91892,104624,196516,"CHRISTY SMITH","MIKE GARCIA","Republican",0.532394308860347,-12732,196516,-0.0647886177206945
2022,"CALIFORNIA",28,150062,76495,226557,"JUDY CHU","WES HALLMAN","Democrat",0.662358700018097,73567,226557,0.324717400036194
2022,"CALIFORNIA",31,91472,62153,153625,"GRACE F NAPOLITANO","DANIEL BOCIC MARTINEZ","Democrat",0.595423921887714,29319,153625,0.190847843775427
2022,"CALIFORNIA",32,167411,74618,242029,"BRAD SHERMAN","LUCIE LAPOINTE VOLOTZKY","Democrat",0.691698102293527,92793,242029,0.383396204587054
2022,"CALIFORNIA",33,76588,56119,132707,"PETE AGUILAR","JOHN MARK PORTER","Democrat",0.577121026019728,20469,132707,0.154242052039455
2022,"CALIFORNIA",35,75121,55832,130953,"NORMA J TORRES","MIKE CARGILE","Democrat",0.573648560934076,19289,130953,0.147297121868151
2022,"CALIFORNIA",36,194299,84264,278563,"TED LIEU","JOE E COLLINS III","Democrat",0.697504693731759,110035,278563,0.395009387463518
2022,"CALIFORNIA",38,101260,73051,174311,"LINDA T SÁNCHEZ","ERIC J CHING","Democrat",0.580915719604615,28209,174311,0.161831439209229
2022,"CALIFORNIA",39,75896,55701,131597,"MARK TAKANO","AJA SMITH","Democrat",0.576730472579162,20195,131597,0.153460945158324
2022,"CALIFORNIA",40,122722,161589,284311,"ASIF MAHMOOD","YOUNG KIM","Republican",0.568352965590498,-38867,284311,-0.136705931180995
2022,"CALIFORNIA",41,112769,123869,236638,"WILL ROLLINS","KEN CALVERT","Republican",0.523453545077291,-11100,236638,-0.0469070901545821
2022,"CALIFORNIA",42,99217,45903,145120,"ROBERT GARCIA","JOHN BRISCOE","Democrat",0.683689360529217,53314,145120,0.367378721058434
2022,"CALIFORNIA",43,95462,27985,123447,"MAXINE WATERS","OMAR NAVARRO","Democrat",0.773303522969371,67477,123447,0.546607045938743
2022,"CALIFORNIA",44,100160,38554,138714,"NANETTE DIAZ BARRAGÁN","PAUL JONES","Democrat",0.722061219487579,61606,138714,0.444122438975158
2022,"CALIFORNIA",45,103466,113960,217426,"JAY F CHEN","MICHELLE STEEL","Republican",0.524132348477183,-10494,217426,-0.0482646969543661
2022,"CALIFORNIA",46,78041,48257,126298,"J LUIS CORREA","CHRISTOPHER J GONZALES","Democrat",0.617911605884495,29784,126298,0.235823211768991
2022,"CALIFORNIA",47,137374,128261,265635,"KATIE PORTER","SCOTT BAUGH","Democrat",0.517153236584034,9113,265635,0.034306473168069
2022,"CALIFORNIA",48,101900,155171,257071,"STEPHEN HOULAHAN","DARRELL ISSA","Republican",0.603611453645102,-53271,257071,-0.207222907290204
2022,"CALIFORNIA",49,153541,138194,291735,"MIKE LEVIN","BRIAN MARYOTT","Democrat",0.526302980444582,15347,291735,0.0526059608891631
2022,"CALIFORNIA",50,168816,99819,268635,"SCOTT H PETERS","COREY GUSTAFSON","Democrat",0.628421464068346,68997,268635,0.256842928136691
2022,"CALIFORNIA",51,144186,88886,233072,"SARA JACOBS","STAN CAPLAN","Democrat",0.618632868813071,55300,233072,0.237265737626141
2022,"CALIFORNIA",52,100686,50330,151016,"JUAN VARGAS","TYLER GEFFENEY","Democrat",0.666724055729194,50356,151016,0.333448111458389
2022,"COLORADO",1,226929,49530,282616,"DIANA DEGETTE","JENNIFER QUALTERI","Democrat",0.802958785065248,177399,276459,0.641682853515349
2022,"COLORADO",2,244107,97700,348839,"JOE NEGUSE","MARSHALL DAWSON","Democrat",0.69976980784832,146407,341807,0.428332363000173
2022,"COLORADO",3,163293,163839,327285,"ADAM FRISCH","LAUREN BOEBERT","Republican",0.500600394151886,-546,327132,-0.0016690510252742
2022,"COLORADO",4,129619,216024,354513,"IKE MCCORKLE","KEN BUCK","Republican",0.609354240888204,-86405,345643,-0.249983364338349
2022,"COLORADO",5,111978,155528,277964,"DAVID TORRES","DOUG LAMBORN","Republican",0.559525693974759,-43550,267506,-0.162800086727027
2022,"COLORADO",6,170140,105084,280755,"JASON CROW","STEVEN MONAHAN","Democrat",0.606008797706185,65056,275224,0.236374734761503
2022,"COLORADO",7,204984,150510,363601,"BRITTANY PETTERSEN","ERIK AADLAND","Democrat",0.563760825740303,54474,355494,0.15323465374943
2022,"COLORADO",8,114377,112745,236501,"YADIRA CARAVEO","BARBARA KIRKMEYER","Democrat",0.483621633735164,1632,227122,0.00718556546701773
2022,"CONNECTICUT",1,144873,91506,243913,"JOHN B LARSON","LARRY LAZOR","Democrat",0.593953581809908,53367,236379,0.225768786567335
2022,"CONNECTICUT",2,165946,114506,285031,"JOE COURTNEY","MIKE FRANCE","Democrat",0.582203339285902,51440,280452,0.183418196340194
2022,"CONNECTICUT",3,137924,98704,242651,"ROSA L DELAURO","LESLEY DENARDIS","Democrat",0.568404828333697,39220,236628,0.165745389387562
2022,"CONNECTICUT",4,140262,93329,236084,"JAMES A HIMES","JAYME STEVENSON","Democrat",0.594119042374748,46933,233591,0.200919555976044
2022,"CONNECTICUT",5,123818,123342,253672,"JAHANA HAYES","GEORGE LOGAN","Democrat",0.488102746854205,476,247160,0.00192587797378217
2022,"DELAWARE",0,178416,138201,321649,"LISA BLUNT ROCHESTER","LEE MURPHY","Democrat",0.554691604823892,40215,316617,0.127014658088479
2022,"FLORIDA",1,93467,197349,290816,"REBEKAH JONES","MATT GAETZ","Republican",0.678604340889085,-103882,290816,-0.357208681778169
2022,"FLORIDA",2,121153,180236,301389,"AL LAWSON, JR","NEAL P DUNN","Republican",0.598017844048721,-59083,301389,-0.196035688097442
2022,"FLORIDA",3,103382,178101,284893,"DANIELLE HAWK","KAT CAMMACK","Republican",0.62515049509816,-74719,281483,-0.265447646927168
2022,"FLORIDA",4,108402,165696,274103,"LASHONDA “LJ” HOLLOWAY","AARON BEAN","Republican",0.604502686946148,-57294,274098,-0.209027428146138
2022,"FLORIDA",7,126079,177966,304055,"KAREN GREEN","CORY MILLS","Republican",0.585308579039976,-51887,304045,-0.170655659524084
2022,"FLORIDA",8,120080,222128,342208,"JOANNE TERRY","BILL POSEY","Republican",0.649102300355339,-102048,342208,-0.298204600710679
2022,"FLORIDA",9,108541,93827,202368,"DARREN SOTO","SCOTTY MOORE","Democrat",0.536354561986085,14714,202368,0.0727091239721695
2022,"FLORIDA",10,117955,78844,199910,"MAXWELL ALEJANDRO FROST","CALVIN B WIMBISH","Democrat",0.590040518233205,39111,196799,0.19873576593377
2022,"FLORIDA",11,115647,205995,326609,"SHANTE MUNNS","DANIEL WEBSTER","Republican",0.63070827809399,-90348,321642,-0.28089615162199
2022,"FLORIDA",12,95390,226601,321995,"KIMBERLY WALKER","GUS M BILIRAKIS","Republican",0.703740741315859,-131211,321991,-0.407498967362442
2022,"FLORIDA",13,153876,181487,341546,"ERIC LYNN","ANNA PAULINA LUNA","Republican",0.531369127438178,-27611,335363,-0.0823316823859519
2022,"FLORIDA",14,149737,113427,263164,"KATHY CASTOR","JAMES JUDGE","Democrat",0.568987399492332,36310,263164,0.137974798984664
2022,"FLORIDA",15,102835,145219,248054,"ALAN M COHN","LAUREL LEE","Republican",0.585433010554154,-42384,248054,-0.170866021108307
2022,"FLORIDA",16,115575,189762,305358,"JAN SCHNEIDER","VERN BUCHANAN","Republican",0.621441062621579,-74187,305337,-0.242967606284204
2022,"FLORIDA",17,123798,222483,348506,"ANDREA DORIA KALE","W GREGORY STEUBE","Republican",0.638390730719127,-98685,346281,-0.284985315394145
2022,"FLORIDA",19,100226,213035,313274,"CINDY BANYAI","BYRON DONALDS","Republican",0.680027707374375,-112809,313261,-0.36011185560922
2022,"FLORIDA",20,136215,52151,188366,"SHEILA CHERFILUS-MCCORMICK","DREW MONTEZ CLARK","Democrat",0.723140057122835,84064,188366,0.446280114245671
2022,"FLORIDA",21,119891,208614,328505,"CORINNA BALDERRAMOS ROBINSON","BRIAN J MAST","Republican",0.635040562548515,-88723,328505,-0.27008112509703
2022,"FLORIDA",22,150010,122194,272204,"LOIS FRANKEL","DAN FRANZESE","Democrat",0.551094032416864,27816,272204,0.102188064833728
2022,"FLORIDA",23,143951,130681,279049,"JARED MOSKOWITZ","JOE BUDD","Democrat",0.515862805457106,13270,274632,0.0483192053365959
2022,"FLORIDA",24,133442,52449,185891,"FREDERICA S WILSON","JESUS G NAVARRO","Democrat",0.717850783523678,80993,185891,0.435701567047356
2022,"FLORIDA",25,129113,105239,234352,"DEBBIE WASSERMAN SCHULTZ","CARLA SPALDING","Democrat",0.55093619853895,23874,234352,0.1018723970779
2022,"FLORIDA",26,58868,143240,202108,"CHRISTINE ALEXANDRIA OLIVO","MARIO DIAZ-BALART","Republican",0.708729985948107,-84372,202108,-0.417459971896214
2022,"FLORIDA",27,101404,136038,237442,"ANNETTE TADDEO","MARIA ELVIRA SALAZAR","Republican",0.572931494849268,-34634,237442,-0.145862989698537
2022,"FLORIDA",28,76665,134457,211150,"ROBERT ASENCIO","CARLOS A GIMENEZ","Republican",0.63678427658063,-57792,211122,-0.273737459857334
2022,"GEORGIA",1,107837,156128,263965,"WADE HERRING","EARL L “BUDDY” CARTER","Republican",0.591472354289394,-48291,263965,-0.182944708578789
2022,"GEORGIA",2,132675,108665,241340,"SANFORD D BISHOP, JR","CHRIS WEST","Democrat",0.549743101019309,24010,241340,0.0994862020386177
2022,"GEORGIA",3,97057,213524,310581,"VAL ALMONORD","A DREW FERGUSON IV","Republican",0.687498591349761,-116467,310581,-0.374997182699521
2022,"GEORGIA",4,216332,59302,275634,"HENRY C “HANK” JOHNSON, JR","JONATHAN CHAVEZ","Democrat",0.784852376702439,157030,275634,0.569704753404877
2022,"GEORGIA",5,243687,51769,295456,"NIKEMA WILLIAMS","CHRISTIAN ZIMM","Democrat",0.824782708762049,191918,295456,0.649565417524098
2022,"GEORGIA",6,125612,206886,332498,"BOB CHRISTIAN","RICH MCCORMICK","Republican",0.622217276494896,-81274,332498,-0.244434552989792
2022,"GEORGIA",7,143063,91962,235039,"LUCY MCBATH","MARK GONSALVES","Democrat",0.608677708805773,51101,235025,0.217427933198596
2022,"GEORGIA",8,81886,178700,260586,"DARRIUS BUTLER","AUSTIN SCOTT","Republican",0.68576209005856,-96814,260586,-0.371524180117121
2022,"GEORGIA",9,81318,212820,294138,"MICHAEL “MIKE” FORD","ANDREW S CLYDE","Republican",0.723537931175163,-131502,294138,-0.447075862350325
2022,"GEORGIA",10,109107,198523,307630,"TABITHA JOHNSON-GREEN","MIKE COLLINS","Republican",0.645330429411956,-89416,307630,-0.290660858823912
2022,"GEORGIA",11,113571,190086,303657,"ANTONIO DAZA","BARRY LOUDERMILK","Republican",0.625989191752537,-76515,303657,-0.251978383505073
2022,"GEORGIA",12,107148,158047,265195,"ELIZABETH “LIZ” JOHNSON","RICK W ALLEN","Republican",0.595965233130338,-50899,265195,-0.191930466260676
2022,"GEORGIA",13,216388,48228,264616,"DAVID SCOTT","CAESAR GONZALES","Democrat",0.817743447108263,168160,264616,0.635486894216525
2022,"GEORGIA",14,88189,170162,258351,"MARCUS FLOWERS","MARJORIE TAYLOR GREENE","Republican",0.658646569976505,-81973,258351,-0.31729313995301
2022,"HAWAII",1,143546,51217,202378,"ED CASE","CONRAD KRESS","Democrat",0.709296465030784,92329,194763,0.47405821434256
2022,"HAWAII",2,128407,72874,216985,"JILL N TOKUDA","JOE AKANA","Democrat",0.591778233518446,55533,201281,0.275897874116285
2022,"IDAHO",1,82261,222901,312442,"KAYLEE PETERSON","RUSS FULCHER","Republican",0.713415609937204,-140640,305162,-0.460869964150189
2022,"IDAHO",2,98736,172450,271186,"WENDY NORMAN","MICHAEL K SIMPSON","Republican",0.635910408354414,-73714,271186,-0.271820816708827
2022,"ILLINOIS",1,159142,78258,237425,"JONATHAN L JACKSON","ERIC CARLSON","Democrat",0.670283247341266,80884,237400,0.340707666385847
2022,"ILLINOIS",2,140414,68761,209175,"ROBIN L KELLY","THOMAS LYNCH","Democrat",0.671275247998088,71653,209175,0.342550495996175
2022,"ILLINOIS",3,121764,55995,177759,"DELIA RAMIREZ","JUSTIN BURAU","Democrat",0.684994852581304,65769,177759,0.369989705162608
2022,"ILLINOIS",4,91036,37352,133047,"JESÚS G “CHUY” GARCÍA","JAMES FALAKOS","Democrat",0.684239404120348,53684,128388,0.418138766862947
2022,"ILLINOIS",5,190999,79112,274550,"MIKE QUIGLEY","TOMMY HANSON","Democrat",0.695680203970133,111887,270111,0.414226003383794
2022,"ILLINOIS",6,150496,126351,276859,"SEAN CASTEN","KEITH PEKAU","Democrat",0.543583556973044,24145,276847,0.0872142374669041
2022,"ILLINOIS",8,117880,89335,207215,"RAJA KRISHNAMOORTHI","CHRIS DARGIS","Democrat",0.568877735685158,28545,207215,0.137755471370316
2022,"ILLINOIS",9,179615,70915,250530,"JANICE D SCHAKOWSKY","MAXWELL “MAX” RICE","Democrat",0.716940087015527,108700,250530,0.433880174031054
2022,"ILLINOIS",10,152566,89599,242165,"BRADLEY SCOTT SCHNEIDER","JOSEPH SEVERINO","Democrat",0.630008465302583,62967,242165,0.260016930605166
2022,"ILLINOIS",11,149172,115069,264241,"BILL FOSTER","CATALINA LAUF","Democrat",0.564530106985668,34103,264241,0.129060213971337
2022,"ILLINOIS",12,72791,218379,291171,"HOMER “CHIP” MARKEL","MIKE BOST","Republican",0.75000257580597,-145588,291170,-0.500010303259264
2022,"ILLINOIS",13,141788,108646,250450,"NIKKI BUDZINSKI","REGAN DEERING","Democrat",0.566132960670793,33142,250434,0.132338260779287
2022,"ILLINOIS",14,128141,108451,236600,"LAUREN UNDERWOOD","SCOTT R GRYDER","Democrat",0.541593406593407,19690,236592,0.0832234395076757
2022,"ILLINOIS",15,86396,213007,299403,"PAUL J LANGE","MARY E MILLER","Republican",0.711439097136635,-126611,299403,-0.422878194273271
2022,"ILLINOIS",16,100325,197621,297946,"ELIZABETH “LISA” HADERLEIN","DARIN LAHOOD","Republican",0.663277909419828,-97296,297946,-0.326555818839656
2022,"ILLINOIS",17,121186,111931,233123,"ERIC SORENSEN","ESTHER JOY KING","Democrat",0.51983716750385,9255,233117,0.039701094300287
2022,"INDIANA",1,112656,100542,213207,"FRANK J MRVAN","JENNIFER-RUTH GREEN","Democrat",0.528387904712322,12114,213198,0.0568204204542256
2022,"INDIANA",2,62891,125313,194073,"PAUL D STEURY","RUDOLPH “RUDY” YAKYM III","Republican",0.645700329257547,-62422,188204,-0.331672015472572
2022,"INDIANA",3,60577,131579,201542,"GARY L SNYDER","JIM BANKS","Republican",0.652861438310625,-71002,192156,-0.369501863069589
2022,"INDIANA",4,62834,134864,197698,"ROGER D DAY","JAMES R BAIRD","Republican",0.682171797387935,-72030,197698,-0.36434359477587
2022,"INDIANA",5,93434,146575,240009,"JEANNINE LEE LAKE","VICTORIA SPARTZ","Republican",0.610706265181722,-53141,240009,-0.221412530363445
2022,"INDIANA",6,62838,130686,193524,"CYNTHIA “CINDE” WIRTH","GREG PENCE","Republican",0.675296087307001,-67848,193524,-0.350592174614001
2022,"INDIANA",7,117309,53631,175180,"ANDRÉ CARSON","ANGELA GRABOVSKY","Democrat",0.669648361685124,63678,170940,0.372516672516673
2022,"INDIANA",8,68109,141995,216040,"RAY MCCORMICK","LARRY BUCSHON","Republican",0.657262543973338,-73886,210104,-0.351663937859346
2022,"INDIANA",9,75700,143166,225276,"MATTHEW FYFE","ERIN HOUCHIN","Republican",0.635513769775742,-67466,218866,-0.308252538082662
2022,"IOWA",1,142173,162947,309736,"CHRISTINA BOHANNAN","MARIANNETTE MILLER-MEEKS","Republican",0.526083503370612,-20774,305120,-0.0680846879916099
2022,"IOWA",2,145940,172181,321507,"LIZ MATHIS","ASHLEY HINSON","Republican",0.535543549596121,-26241,318121,-0.0824874811785453
2022,"IOWA",3,154117,156262,315039,"CYNTHIA AXNE","ZACH NUNN","Republican",0.49600843070223,-2145,310379,-0.00691090569916135
2022,"IOWA",4,84230,186467,284134,"RYAN MELTON","RANDY FEENSTRA","Republican",0.656264297831305,-102237,270697,-0.37768058013203
2022,"KANSAS",1,77092,161333,238425,"JAMES “JIMMY” BEARD","TRACEY MANN","Republican",0.67666142392786,-84241,238425,-0.35332284785572
2022,"KANSAS",2,98852,134506,233358,"PATRICK SCHMIDT","JAKE LATURNER","Republican",0.576393352702714,-35654,233358,-0.152786705405429
2022,"KANSAS",3,165527,128839,301294,"SHARICE DAVIDS","AMANDA L ADKINS","Democrat",0.549386977503701,36688,294366,0.124633959084949
2022,"KANSAS",4,83851,144889,228740,"BOB HERNANDEZ","RON ESTES","Republican",0.633422226108245,-61038,228740,-0.26684445221649
2022,"KENTUCKY",1,61701,184157,245858,"JIMMY C AUSBROOKS","JAMES COMER","Republican",0.749038062621513,-122456,245858,-0.498076125243026
2022,"KENTUCKY",2,66769,170487,237256,"HANK LINDERMAN","BRETT GUTHRIE","Republican",0.718578244596554,-103718,237256,-0.437156489193108
2022,"KENTUCKY",3,160920,98637,259587,"MORGAN MCGARVEY","STUART N RAY","Democrat",0.619907776583573,62283,259557,0.239958852968712
2022,"KENTUCKY",4,79977,167541,257629,"MATTHEW LEHMAN","THOMAS MASSIE","Republican",0.650318869381941,-87564,247518,-0.353768210796791
2022,"KENTUCKY",5,38549,177712,216270,"CONOR HALBLEIB","HAROLD ROGERS","Republican",0.821713598742313,-139163,216261,-0.643495590975719
2022,"KENTUCKY",6,83005,154762,246818,"GEOFFREY M “GEOFF” YOUNG","ANDY BARR","Republican",0.627028822857328,-71757,237767,-0.301795455214559
2022,"LOUISIANA",1,61467,177670,244044,"KATIE DARLING","STEVE SCALISE","Republican",0.728024454606546,-116203,239137,-0.48592647729126
2022,"LOUISIANA",2,158120,46927,205047,"TROY A CARTER","“DAN” LUX","Democrat",0.771140275156428,111193,205047,0.542280550312855
2022,"LOUISIANA",3,44813,174864,224552,"LESSIE OLIVIA LEBLANC","CLAY HIGGINS","Republican",0.778723859061598,-130051,219677,-0.592010087537612
2022,"LOUISIANA",5,54532,169021,223553,"OSCAR “OMAR” DANTZLER","JULIA LETLOW","Republican",0.756066794004106,-114489,223553,-0.512133588008213
2022,"MAINE",1,219753,129263,358138,"CHELLIE PINGREE","EDWIN THELANDER","Democrat",0.613598668669619,90490,349016,0.25927178123639
2022,"MAINE",2,1165136,1146142,2656104,"JARED F GOLDEN","BRUCE POLIQUIN","Democrat",0.438663546306922,18994,2311278,0.00821796426046542
2022,"MARYLAND",1,126511,159673,293358,"HEATHER R MIZEUR","ANDY HARRIS","Republican",0.544294002549786,-33162,286184,-0.115876499035586
2022,"MARYLAND",2,158998,109075,268434,"C A DUTCH RUPPERSBERGER","NICOLEE AMBROSE","Democrat",0.59231691961525,49923,268073,0.18622912415648
2022,"MARYLAND",3,175514,115801,291602,"JOHN P SARBANES","YURIPZY MORGAN","Democrat",0.601895734597156,59713,291315,0.204977429929801
2022,"MARYLAND",4,144168,15441,160009,"GLENN F IVEY","JEFF WARNER","Democrat",0.900999318788318,128727,159609,0.806514670225363
2022,"MARYLAND",5,182478,94000,276920,"STENY H HOYER","CHRIS PALOMBI","Democrat",0.658955655062834,88478,276478,0.320018229298534
2022,"MARYLAND",6,140295,115771,256398,"DAVID J TRONE","NEIL C PARROTT","Democrat",0.547176655044111,24524,256066,0.0957721837338811
2022,"MARYLAND",7,151640,32737,184801,"KWEISI MFUME","SCOTT M COLLIER","Democrat",0.820558330312065,118903,184377,0.644890631694843
2022,"MARYLAND",8,211842,47965,264206,"JAMIE RASKIN","GREGORY THOMAS COLL","Democrat",0.80180616640046,163877,259807,0.63076437509382
2022,"MASSACHUSETTS",1,157635,98386,263651,"RICHARD E NEAL","DEAN JAMES MARTILLI","Democrat",0.597892668717357,59249,256021,0.231422422379414
2022,"MASSACHUSETTS",2,180639,91956,280071,"JAMES P MCGOVERN","JEFFREY A SOSSA-PAQUETTE","Democrat",0.644975738294932,88683,272595,0.325328784460463
2022,"MASSACHUSETTS",3,154496,88585,251389,"LORI TRAHAN","DEAN A TRAN","Democrat",0.614569452123999,65911,243081,0.271148300360785
2022,"MASSACHUSETTS",5,203994,71491,284881,"KATHERINE M CLARK","CAROLINE COLARUSSO","Democrat",0.716067410603024,132503,275485,0.480980815652395
2022,"MASSACHUSETTS",6,198119,110770,323032,"SETH MOULTON","BOB MAY","Democrat",0.613310755590777,87349,308889,0.282784430653083
2022,"MASSACHUSETTS",7,151825,27129,189830,"AYANNA PRESSLEY","DONNIE DIONICIO PALMER, JR","Democrat",0.799794553021124,124696,178954,0.696804765470456
2022,"MASSACHUSETTS",8,189987,82126,284583,"STEPHEN F LYNCH","ROBERT G BURKE","Democrat",0.667597853701732,107861,272113,0.396383120247838
2022,"MASSACHUSETTS",9,197823,136347,342455,"WILLIAM R KEATING","JESSE G BROWN","Democrat",0.577661298564775,61476,334170,0.183966244725738
2022,"MICHIGAN",1,145403,233094,388599,"BOB LORINSER","JACK BERGMAN","Republican",0.599831703118124,-87691,378497,-0.231682153359208
2022,"MICHIGAN",2,116452,216222,339521,"JERRY HILLIARD","JOHN R MOOLENAAR","Republican",0.63684426000159,-99770,332674,-0.299903208546505
2022,"MICHIGAN",3,185989,142229,338988,"HILLARY SCHOLTEN","JOHN GIBBS","Democrat",0.548659539570722,43760,328218,0.133326021120109
2022,"MICHIGAN",4,143690,183936,338348,"JOSEPH ALFONSO","BILL HUIZENGA","Republican",0.543629635759632,-40246,327626,-0.122841288542423
2022,"MICHIGAN",5,110946,198020,317258,"BART GOLDBERG","TIM WALBERG","Republican",0.624160777663605,-87074,308966,-0.281823890007315
2022,"MICHIGAN",6,241759,125167,366927,"DEBBIE DINGELL","WHITTNEY WILLIAMS","Democrat",0.658874926075214,116592,366926,0.317753443473616
2022,"MICHIGAN",7,192809,172624,372708,"ELISSA SLOTKIN","TOM BARRETT","Democrat",0.517319188211683,20185,365433,0.0552358435061968
2022,"MICHIGAN",8,178322,143850,335829,"DANIEL T KILDEE","PAUL JUNGE","Democrat",0.530990474318775,34472,322172,0.106998746011447
2022,"MICHIGAN",9,123702,238300,372922,"BRIAN JAYE","LISA MCCLAIN","Republican",0.639007620896595,-114598,362002,-0.316567311782808
2022,"MICHIGAN",10,157602,159202,326237,"CARL J MARLINGA","JOHN JAMES","Republican",0.487994923935666,-1600,316804,-0.00505044128230704
2022,"MICHIGAN",11,224537,141642,366179,"HALEY M STEVENS","MARK AMBROSE","Democrat",0.613189177970337,82895,366179,0.226378355940674
2022,"MICHIGAN",12,196643,72888,277577,"RASHIDA TLAIB","STEVEN ELLIOTT","Democrat",0.708426850927851,123755,269531,0.459149411384961
2022,"MICHIGAN",13,166650,56187,234444,"SHRI THANEDAR","MARTELL D BIVINGS","Democrat",0.710830731432666,110463,222837,0.495712112440932
2022,"MINNESOTA",2,165583,148576,325472,"ANGIE CRAIG","TYLER KISTNER","Democrat",0.508747296234392,17007,314159,0.0541350080691624
2022,"MINNESOTA",3,198883,134797,333921,"DEAN PHILLIPS","TOM WEILER","Democrat",0.595598959035221,64086,333680,0.192058259410213
2022,"MINNESOTA",4,200055,95493,295973,"BETTY MCCOLLUM","MAY LOR XIONG","Democrat",0.67592314163792,104562,295548,0.353790247269479
2022,"MINNESOTA",5,214224,70702,288206,"ILHAN OMAR","CICELY DAVIS","Democrat",0.743301666169337,143522,284926,0.503716754525736
2022,"MISSISSIPPI",1,45238,122151,167389,"DIANNE BLACK","TRENT KELLY","Republican",0.729743292570002,-76913,167389,-0.459486585140003
2022,"MISSISSIPPI",2,108285,71884,180169,"BENNIE G THOMPSON","BRIAN FLOWERS","Democrat",0.601019043231633,36401,180169,0.202038086463265
2022,"MISSISSIPPI",3,54803,132481,187284,"SHUWASKI A YOUNG","MICHAEL GUEST","Republican",0.707380235364473,-77678,187284,-0.414760470728946
2022,"MISSISSIPPI",4,42876,127813,174258,"JOHNNY L DUPREE","MIKE EZELL","Republican",0.733469912428698,-84937,170689,-0.497612617098934
2022,"MISSOURI",1,160999,53767,220958,"CORI BUSH","ANDREW JONES","Democrat",0.728640737153667,107232,214766,0.499296909194193
2022,"MISSOURI",2,135895,173277,315666,"TRISH GUNBY","ANN WAGNER","Republican",0.548925129725723,-37382,309172,-0.120910043600326
2022,"MISSOURI",3,96851,180746,277597,"BETHANY MANN","BLAINE LUETKEMEYER","Republican",0.651109341959747,-83895,277597,-0.302218683919495
2022,"MISSOURI",4,67069,181890,255079,"JACK TRUMAN","MARK ALFORD","Republican",0.713073204771855,-114821,248959,-0.461204455352086
2022,"MISSOURI",5,140688,84008,230555,"EMANUEL CLEAVER","JACOB TURK","Democrat",0.610214482444536,56680,224696,0.252251931498558
2022,"MISSOURI",6,72253,184865,262892,"HENRY MARTIN","SAM GRAVES","Republican",0.703197510764877,-112612,257118,-0.437977893418586
2022,"MISSOURI",7,67485,178592,251947,"KRISTEN RADAKER-SHEAFER","ERIC BURLISON","Republican",0.708847495703461,-111107,246077,-0.451513144259724
2022,"MISSOURI",8,53738,186472,245395,"RANDI MCCALLIAN","JASON SMITH","Republican",0.759885083233155,-132734,240210,-0.552574830356771
2022,"MONTANA",1,115265,123102,247960,"MONICA TRANEL","RYAN K ZINKE","Republican",0.496459106307469,-7837,238367,-0.0328778731955346
2022,"MONTANA",2,43480,121979,215672,"PENNY RONNING","MATTHEW M ROSENDALE, SR","Republican",0.565576430876516,-78499,165459,-0.474431732332481
2022,"NEBRASKA",1,93929,129236,223165,"PATTY PANSING BROOKS","MIKE FLOOD","Republican",0.579105146416329,-35307,223165,-0.158210292832657
2022,"NEBRASKA",2,106807,112663,219470,"TONY VARGAS","DON BACON","Republican",0.513341231147765,-5856,219470,-0.0266824622955301
2022,"NEBRASKA",3,34836,172700,220552,"DAVID J ELSE","ADRIAN SMITH","Republican",0.783035293264174,-137864,207536,-0.664289569038625
2022,"NEVADA",1,115700,103115,224349,"DINA TITUS","MARK ROBERTSON","Democrat",0.515714355758216,12585,218815,0.0575143385965313
2022,"NEVADA",2,117371,185467,310498,"ELIZABETH MERCEDES KRAUSE","MARK E AMODEI","Republican",0.597321077752514,-68096,302838,-0.224859495836058
2022,"NEVADA",3,131086,121083,252169,"SUSIE LEE","APRIL BECKER","Democrat",0.519833920902252,10003,252169,0.0396678418045041
2022,"NEVADA",4,116617,105870,222487,"STEVEN HORSFORD","SAM PETERS","Democrat",0.524151972924261,10747,222487,0.0483039458485215
2022,"NEW HAMPSHIRE",1,167391,142229,309962,"CHRIS PAPPAS","KAROLINE LEAVITT","Democrat",0.540037165846136,25162,309620,0.0812673599896648
2022,"NEW HAMPSHIRE",2,171636,135579,307584,"ANN M KUSTER","ROBERT BURNS","Democrat",0.558013420724095,36057,307215,0.117367316049021
2022,"NEW JERSEY",1,139559,78794,223884,"DONALD NORCROSS","CLAIRE GUSTAFSON","Democrat",0.623354058351646,60765,218353,0.27828790994399
2022,"NEW JERSEY",2,94522,139217,236484,"TIM ALEXANDER","JEFFERSON VAN DREW","Republican",0.588695218281152,-44695,233739,-0.191217554622891
2022,"NEW JERSEY",3,150498,118415,271376,"ANDY KIM","BOB HEALEY","Democrat",0.554573727964153,32083,268913,0.119306244026879
2022,"NEW JERSEY",4,81233,173288,258962,"MATTHEW JENKINS","CHRISTOPHER H SMITH","Republican",0.669163815540504,-92055,254521,-0.361679389912817
2022,"NEW JERSEY",5,145559,117873,265943,"JOSH GOTTHEIMER","FRANK T PALLOTTA","Democrat",0.547331571050939,27686,263432,0.105097330620426
2022,"NEW JERSEY",6,106238,75839,184919,"FRANK PALLONE, JR","SUSAN M KILEY","Democrat",0.574511002114439,30399,182077,0.166956836942612
2022,"NEW JERSEY",7,150701,159392,310093,"TOM MALINOWSKI","THOMAS H KEAN, JR","Republican",0.514013537874122,-8691,310093,-0.0280270757482433
2022,"NEW JERSEY",8,78382,24957,106473,"ROBERT J MENENDEZ","MARCOS ARROYO","Democrat",0.736167854761301,53425,103339,0.516987778089589
2022,"NEW JERSEY",9,82457,65365,149984,"BILL PASCRELL, JR","BILLY PREMPEH","Democrat",0.549771975677406,17092,147822,0.115625549647549
2022,"NEW JERSEY",10,100710,25993,129707,"DONALD M PAYNE, JR","DAVID H PINCKNEY","Democrat",0.776442289159413,74717,126703,0.589701901296733
2022,"NEW JERSEY",11,161436,109952,273664,"MIKIE SHERRILL","PAUL DEGROOT","Democrat",0.589905869971936,51484,271388,0.189706250829071
2022,"NEW JERSEY",12,125127,71175,198227,"BONNIE WATSON COLEMAN","DARIUS MAYFIELD","Democrat",0.631230861587977,53952,196302,0.274841825350735
2022,"NEW MEXICO",1,156462,124151,280671,"MELANIE A STANSBURY","MICHELLE GARCIA HOLMES","Democrat",0.557456951377235,32311,280613,0.115144344702491
2022,"NEW MEXICO",2,96986,95636,192673,"GABRIEL VASQUEZ","YVETTE HERRELL","Democrat",0.503370996455134,1350,192622,0.00700854523367009
2022,"NEW MEXICO",3,134217,96565,230782,"TERESA LEGER FERNANDEZ","ALEXIS MARTINEZ JOHNSON","Democrat",0.581574819526653,37652,230782,0.163149639053306
2022,"NEW YORK",1,135170,154046,327052,"BRIDGET FLEMING","NICHOLAS J LALOTA","Republican",0.471013783740812,-18876,289216,-0.0652660986944014
2022,"NEW YORK",2,93299,130798,256117,"JACKIE GORDON","ANDREW R GARBARINO","Republican",0.510696283339255,-37499,224097,-0.167333788493376
2022,"NEW YORK",3,120045,133859,279772,"ROBERT P ZIMMERMAN","GEORGE A D SANTOS","Republican",0.478457458215976,-13814,253904,-0.0544063898166236
2022,"NEW YORK",4,130871,129353,278548,"LAURA A GILLEN","ANTHONY P D’ESPOSITO","Democrat",0.469832847480506,1518,260224,0.00583343580914904
2022,"NEW YORK",5,104396,31405,144316,"GREGORY W MEEKS","PAUL KING","Democrat",0.723384794478783,72991,135801,0.537484996428598
2022,"NEW YORK",6,85049,44264,137692,"GRACE MENG","THOMAS J ZMICH","Democrat",0.617675681956831,40785,129313,0.315397523837511
2022,"NEW YORK",7,95645,26351,153557,"NYDIA M VELÁZQUEZ","JUAN PAGAN","Democrat",0.622863171330516,69294,121996,0.568002229581298
2022,"NEW YORK",8,99079,36776,144476,"HAKEEM S JEFFRIES","YURI DASHEVSKY","Democrat",0.685781721531604,62303,135855,0.458599241838725
2022,"NEW YORK",10,160582,26711,202131,"DANIEL GOLDMAN","BENINE A HAMDAN","Democrat",0.794445186537444,133871,187293,0.714767770285061
2022,"NEW YORK",11,71801,107989,191083,"MAX N ROSE","NICOLE MALLIOTAKIS","Republican",0.565141849353422,-36188,179790,-0.201279270259747
2022,"NEW YORK",12,184872,40994,251078,"JERROLD NADLER","MICHAEL K ZUMBLUSKAS","Democrat",0.73631301826524,143878,225866,0.63700601241444
2022,"NEW YORK",14,74050,31935,122582,"ALEXANDRIA OCASIO-CORTEZ","TINA FORTE","Democrat",0.604085428529474,42115,105985,0.397367552012077
2022,"NEW YORK",15,76406,15882,101732,"RITCHIE TORRES","STYLO A SAPASKIS","Democrat",0.751051783116424,60524,92288,0.655816574202497
2022,"NEW YORK",16,127024,74156,221597,"JAMAAL BOWMAN","MIRIAM L FLISSER","Democrat",0.57322075659869,52868,201180,0.262789541703947
2022,"NEW YORK",17,133457,125738,291308,"SEAN PATRICK MALONEY","MICHAEL V LAWLER","Democrat",0.458130226427012,7719,259195,0.0297806670653369
2022,"NEW YORK",18,123168,116972,272617,"PATRICK RYAN","COLIN J SCHMITT","Democrat",0.451798677265174,6196,240140,0.0258016157241609
2022,"NEW YORK",19,124396,129960,292577,"JOSH RILEY","MARCUS MOLINARO","Republican",0.444190760039238,-5564,254356,-0.0218748525688405
2022,"NEW YORK",20,145928,110903,295722,"PAUL TONKO","ELIZABETH L JOY","Democrat",0.493463455542706,35025,256831,0.136373724355705
2022,"NEW YORK",21,112645,150595,289617,"MATT CASTELLI","ELISE M STEFANIK","Republican",0.519979835437837,-37950,263240,-0.1441650205136
2022,"NEW YORK",22,132913,116529,273981,"FRANCIS CONOLE","BRANDON M WILLIAMS","Democrat",0.485117581146138,16384,249442,0.0656826035711709
2022,"NEW YORK",23,104114,163000,306126,"MAX H DELLA PIA","NICK LANGWORTHY","Republican",0.532460490124981,-58886,267114,-0.220452690611499
2022,"NEW YORK",24,95028,156347,285525,"STEVEN HOLDEN","CLAUDIA TENNEY","Republican",0.547577269941336,-61319,251375,-0.243934361014421
2022,"NEW YORK",25,139875,108010,284990,"JOSEPH D MORELLE","LA’RON D SINGLETARY","Democrat",0.490806694971753,31865,247885,0.128547511951106
2022,"NEW YORK",26,141942,70547,251300,"BRIAN HIGGINS","STEVEN L SAMS II","Democrat",0.56483087942698,71395,212489,0.335993863211743
2022,"NORTH CAROLINA",1,134996,122780,257776,"DON DAVIS","SANDY SMITH","Democrat",0.523694990999938,12216,257776,0.0473899819998759
2022,"NORTH CAROLINA",2,190714,104155,294869,"DEBORAH K ROSS","CHRISTINE E VILLAVERDE","Democrat",0.646775347696774,86559,294869,0.293550695393548
2022,"NORTH CAROLINA",3,82378,166520,248898,"BARBARA D GASKINS","GREGORY F MURPHY","Republican",0.669029080185457,-84142,248898,-0.338058160370915
2022,"NORTH CAROLINA",4,194983,96442,291425,"VALERIE P FOUSHEE","COURTNEY GEELS","Democrat",0.669067513082268,98541,291425,0.338135026164536
2022,"NORTH CAROLINA",5,102269,175279,277548,"KYLE PARRISH","VIRGINIA FOXX","Republican",0.631526798968106,-73010,277548,-0.263053597936213
2022,"NORTH CAROLINA",6,139553,116635,258998,"KATHY E MANNING","CHRISTIAN CASTELLI","Democrat",0.538818832577858,22918,256188,0.0894577419707402
2022,"NORTH CAROLINA",7,120222,164047,284269,"CHARLES GRAHAM","DAVID ROUZER","Republican",0.577083677784071,-43825,284269,-0.154167355568141
2022,"NORTH CAROLINA",8,79192,183998,263190,"SCOTT HUFFMAN","DAN BISHOP","Republican",0.69910710893271,-104806,263190,-0.39821421786542
2022,"NORTH CAROLINA",9,101202,131453,232655,"BEN CLARK","RICHARD HUDSON","Republican",0.565012572263652,-30251,232655,-0.130025144527304
2022,"NORTH CAROLINA",10,73174,194681,268207,"PAM GENANT","PATRICK T MCHENRY","Republican",0.725860995425175,-121507,267855,-0.453629762371432
2022,"NORTH CAROLINA",11,144165,174232,323912,"JASMINE BEACH-FERRARA","CHUCK EDWARDS","Republican",0.537899182494011,-30067,318397,-0.0944324224160404
2022,"NORTH CAROLINA",12,140494,83414,223908,"ALMA S ADAMS","TYLER LEE","Democrat",0.627463065187488,57080,223908,0.254926130374975
2022,"NORTH CAROLINA",13,143090,134256,277346,"WILEY NICKEL","BO HINES","Democrat",0.515925955304926,8834,277346,0.031851910609852
2022,"NORTH CAROLINA",14,148738,109014,257752,"JEFF JACKSON","PAT HARRIGAN","Democrat",0.577058567925758,39724,257752,0.154117135851516
2022,"OHIO",1,156416,140058,296474,"GREG LANDSMAN","STEVE CHABOT","Democrat",0.527587579349285,16358,296474,0.0551751586985705
2022,"OHIO",2,65745,192117,257862,"SAMANTHA MEADOWS","BRAD R WENSTRUP","Republican",0.745038043604719,-126372,257862,-0.490076087209438
2022,"OHIO",3,182324,76455,258797,"JOYCE BEATTY","LEE R STAHLEY","Democrat",0.704505848213078,105869,258779,0.409109703646741
2022,"OHIO",4,89383,200773,290156,"TAMIE WILSON","JIM JORDAN","Republican",0.691948469099381,-111390,290156,-0.383896938198762
2022,"OHIO",5,92634,187303,279937,"CRAIG SWARTZ","ROBERT E LATTA","Republican",0.669089830926244,-94669,279937,-0.338179661852488
2022,"OHIO",6,90500,189883,280383,"LOUIS G LYRAS","BILL JOHNSON","Republican",0.677227221336529,-99383,280383,-0.354454442673058
2022,"OHIO",7,135485,168002,303573,"MATTHEW DIEMER","MAX MILLER","Republican",0.553415488202179,-32517,303487,-0.107144622339672
2022,"OHIO",8,98629,180287,278916,"VANESSA ENOCH","WARREN DAVIDSON","Republican",0.646384574567253,-81658,278916,-0.292769149134506
2022,"OHIO",9,150655,115362,266017,"MARCY KAPTUR","J R MAJEWSKI","Democrat",0.566335986046005,35293,266017,0.132671972092009
2022,"OHIO",10,104634,168327,272961,"DAVID ESRATI","MICHAEL R TURNER","Republican",0.616670513370042,-63693,272961,-0.233341026740084
2022,"OHIO",11,167722,47988,215710,"SHONTEL M BROWN","ERIC J BREWER","Democrat",0.777534653006351,119734,215710,0.555069306012702
2022,"OHIO",12,84893,191344,276237,"AMY RIPPEL-ELTON","TROY BALDERSON","Republican",0.692680560533165,-106451,276237,-0.385361121066331
2022,"OHIO",13,149816,134593,284409,"EMILIA SYKES","MADISON GESIOTTO GILBERT","Democrat",0.526762514547711,15223,284409,0.0535250290954224
2022,"OHIO",14,113639,183389,297028,"MATT KILBOY","DAVID P JOYCE","Republican",0.617413173168859,-69750,297028,-0.234826346337719
2022,"OHIO",15,108139,143112,251251,"GARY JOSEPHSON","MIKE CAREY","Republican",0.569597732944346,-34973,251251,-0.139195465888693
2022,"OKLAHOMA",1,80974,142800,233495,"ADAM MARTIN","KEVIN HERN","Republican",0.611576265016382,-61826,223774,-0.276287683108851
2022,"OKLAHOMA",2,54194,167843,231672,"NAOMI ANDREWS","JOSH BRECHEEN","Republican",0.724485479470976,-113649,222037,-0.511847124578336
2022,"OKLAHOMA",3,50354,147418,197772,"JEREMIAH A ROSS","FRANK D LUCAS","Republican",0.745393685658233,-97064,197772,-0.490787371316465
2022,"OKLAHOMA",4,74667,149879,224546,"MARY BRANNON","TOM COLE","Republican",0.667475706536745,-75212,224546,-0.334951413073491
2022,"OKLAHOMA",5,96799,152699,258826,"JOSHUA HARRIS-TILL","STEPHANIE I BICE","Republican",0.589967777580305,-55900,249498,-0.224049892183504
2022,"OREGON",1,210682,99042,310243,"SUZANNE BONAMICI","CHRISTOPHER A MANN","Democrat",0.679087038224875,111640,309724,0.36044994898684
2022,"OREGON",2,99882,208369,308676,"JOE YETTER","CLIFF BENTZ","Republican",0.675041143464345,-108487,308251,-0.351943708211814
2022,"OREGON",3,212119,79766,303334,"EARL BLUMENAUER","JOANNA HARBOUR","Democrat",0.699291869688198,132353,291885,0.453442280350138
2022,"OREGON",4,171372,146055,339077,"VAL HOYLE","ALEK SKARLATOS","Democrat",0.505407326359499,25317,317427,0.0797569204888053
2022,"OREGON",5,171514,178813,351233,"JAMIE MCLEOD-SKINNER","LORI CHAVEZ-DEREMER","Republican",0.509100796337474,-7299,350327,-0.020834820039563
2022,"OREGON",6,147156,139946,294377,"ANDREA SALINAS","MIKE ERICKSON","Democrat",0.499889597353054,7210,287102,0.0251130260325599
2022,"PENNSYLVANIA",1,165809,201571,367380,"ASHLEY EHASZ","BRIAN K FITZPATRICK","Republican",0.548671675104796,-35762,367380,-0.0973433502095922
2022,"PENNSYLVANIA",2,141229,45454,186683,"BRENDAN F BOYLE","AARON BASHIR","Democrat",0.756517733269767,95775,186683,0.513035466539535
2022,"PENNSYLVANIA",4,224799,141986,366785,"MADELEINE DEAN","CHRISTIAN NASCIMENTO","Democrat",0.612890385375629,82813,366785,0.225780770751258
2022,"PENNSYLVANIA",5,205128,110058,315186,"MARY GAY SCANLON","DAVID GALLUCH","Democrat",0.650815708819554,95070,315186,0.301631417639108
2022,"PENNSYLVANIA",6,190386,136097,326483,"CHRISSY HOULAHAN","GUY CIARROCCHI","Democrat",0.583142154415391,54289,326483,0.166284308830781
2022,"PENNSYLVANIA",7,151364,145527,296891,"SUSAN WILD","LISA SCHELLER","Democrat",0.509830207045683,5837,296891,0.0196604140913669
2022,"PENNSYLVANIA",8,146956,139930,286886,"MATT CARTWRIGHT","JIM BOGNET","Democrat",0.512245282098116,7026,286886,0.0244905641962313
2022,"PENNSYLVANIA",9,92622,209185,301807,"AMANDA R WALDMAN","DANIEL MEUSER","Republican",0.693108509742981,-116563,301807,-0.386217019485963
2022,"PENNSYLVANIA",10,145215,169331,314546,"SHAMAINE DANIELS","SCOTT PERRY","Republican",0.538334615604713,-24116,314546,-0.0766692312094256
2022,"PENNSYLVANIA",11,121835,194991,316826,"BOB HOLLISTER","LLOYD SMUCKER","Republican",0.61545138340919,-73156,316826,-0.23090276681838
2022,"PENNSYLVANIA",12,184674,143946,328620,"SUMMER LEE","MIKE DOYLE","Democrat",0.561968230783276,40728,328620,0.123936461566551
2022,"PENNSYLVANIA",15,91729,213417,305146,"MIKE MOLESEVICH","GLENN THOMPSON","Republican",0.699393077412124,-121688,305146,-0.398786154824248
2022,"PENNSYLVANIA",16,130443,190546,320989,"DAN PASTORE","MIKE KELLY","Republican",0.593621588278726,-60103,320989,-0.187243176557452
2022,"PENNSYLVANIA",17,193615,169013,362628,"CHRIS DELUZIO","JEREMY SHAFFER","Democrat",0.533921815193532,24602,362628,0.0678436303870633
2022,"RHODE ISLAND",1,100318,56055,156734,"DAVID N CICILLINE","ALLEN R WATERS","Democrat",0.640052573149412,44263,156373,0.2830603748729
2022,"RHODE ISLAND",2,101432,93969,201089,"SETH M MAGAZINER","ALLAN W FUNG","Democrat",0.504413468663129,7463,195401,0.0381932538728052
2022,"SOUTH CAROLINA",1,115796,153757,272681,"ANNIE ANDREWS","NANCY MACE","Republican",0.563871336836817,-37961,269553,-0.14082944727011
2022,"SOUTH CAROLINA",2,98081,147699,246126,"JUDD LARKINS","JOE WILSON","Republican",0.600095073255162,-49618,245780,-0.201879729839694
2022,"SOUTH CAROLINA",5,83299,154725,241707,"EVANGELINE HUNDLEY","RALPH NORMAN","Republican",0.640134543062468,-71426,238024,-0.300078983631903
2022,"SOUTH CAROLINA",6,130923,79879,211028,"JAMES E CLYBURN","DUKE BUCKNER","Democrat",0.620405822923972,51044,210802,0.242141915162095
2022,"SOUTH CAROLINA",7,89030,164440,253865,"DARYL W SCOTT","RUSSELL FRY","Republican",0.647745849171804,-75410,253470,-0.297510553517182
2022,"TENNESSEE",1,37049,147241,188003,"CAMERON PARSONS","DIANA HARSHBARGER","Republican",0.783184310888656,-110192,184290,-0.597927179988062
2022,"TENNESSEE",2,66673,141089,207762,"MARK HARMON","TIM BURCHETT","Republican",0.679089535141171,-74416,207762,-0.358179070282342
2022,"TENNESSEE",3,60334,136639,199830,"MEG GORMAN","CHARLES J “CHUCK” FLEISCHMANN","Republican",0.683776209778312,-76305,196973,-0.387388119183848
2022,"TENNESSEE",4,44648,122401,173437,"WAYNE STEELE","SCOTT DESJARLAIS","Republican",0.705737530054141,-77753,167049,-0.465450257110189
2022,"TENNESSEE",5,93648,123558,221275,"HEIDI CAMPBELL","ANDY OGLES","Republican",0.558391142243814,-29910,217206,-0.137703378359714
2022,"TENNESSEE",6,65675,129388,195063,"RANDAL COOPER","JOHN W ROSE","Republican",0.663313903713159,-63713,195063,-0.326627807426319
2022,"TENNESSEE",7,68973,108421,180822,"ODESSA KELLY","MARK E GREEN","Republican",0.599600712302707,-39448,177394,-0.222375052143815
2022,"TENNESSEE",8,51102,155602,210315,"LYNNETTE P WILLIAMS","DAVID KUSTOFF","Republican",0.739852126572047,-104500,206704,-0.505553835436179
2022,"TENNESSEE",9,93800,35123,133918,"STEVE COHEN","CHARLOTTE BERGMANN","Democrat",0.700428620499111,58677,128923,0.455132133133731
2022,"TEXAS",1,51438,183224,234662,"JRMAR “JJ” JEFFERSON","NATHANIEL MORAN","Republican",0.780799618174225,-131786,234662,-0.56159923634845
2022,"TEXAS",2,78496,151791,230287,"ROBIN FULFORD","DAN CRENSHAW","Republican",0.659138379500363,-73295,230287,-0.318276759000725
2022,"TEXAS",3,100121,164240,271256,"SANDEEP SRIVASTAVA","KEITH SELF","Republican",0.605479694458371,-64119,264361,-0.242543340356558
2022,"TEXAS",4,79179,170781,256009,"IRO OMERE","PAT FALLON","Republican",0.667089828873204,-91602,249960,-0.366466634661546
2022,"TEXAS",5,71930,135595,211965,"TARTISHA HILL","LANCE GOODEN","Republican",0.639704668223527,-63665,207525,-0.306782315383689
2022,"TEXAS",7,115994,65835,181829,"LIZZIE FLETCHER","JOHNNY TEAGUE","Democrat",0.637929043221928,50159,181829,0.275858086443857
2022,"TEXAS",8,68715,153127,224968,"LAURA JONES","MORGAN LUTTRELL","Republican",0.680661249599943,-84412,221842,-0.380505044130507
2022,"TEXAS",9,125446,38161,163607,"AL GREEN","JIMMY I LEON","Democrat",0.766752033837183,87285,163607,0.533504067674366
2022,"TEXAS",10,86404,159469,251937,"LINDA NUNO","MICHAEL T MCCAUL","Republican",0.632971734997241,-73065,245873,-0.297165609888032
2022,"TEXAS",12,85026,152953,237979,"TREY J HUNT","KAY GRANGER","Republican",0.642716374133852,-67927,237979,-0.285432748267704
2022,"TEXAS",13,52910,161767,214677,"KATHLEEN BROWN","RONNY JACKSON","Republican",0.753536708636696,-108857,214677,-0.507073417273392
2022,"TEXAS",14,63606,149543,213149,"MIKAL WILLIAMS","RANDY K WEBER, SR","Republican",0.701589029270604,-85937,213149,-0.403178058541208
2022,"TEXAS",15,68097,80978,151889,"MICHELLE VALLEJO","MONICA DE LA CRUZ","Republican",0.533139332012193,-12881,149075,-0.0864061713902398
2022,"TEXAS",16,95510,54986,150496,"VERONICA ESCOBAR","IRENE ARMENDARIZ JACKSON","Democrat",0.634634807569636,40524,150496,0.269269615139273
2022,"TEXAS",17,72801,144408,217209,"MARY JO WOODS","PETE SESSIONS","Republican",0.664834330069196,-71607,217209,-0.329668660138392
2022,"TEXAS",18,110511,40941,156268,"SHEILA JACKSON LEE","CARMEN MARIA MONTIEL","Democrat",0.707188931835053,69570,151452,0.459353458521512
2022,"TEXAS",20,115352,53226,168599,"JOAQUIN CASTRO","KYLE SINCLAIR","Democrat",0.684179621468692,62126,168578,0.368529701384522
2022,"TEXAS",21,122655,207426,330081,"CLAUDIA ANDREANA ZAPATA","CHIP ROY","Republican",0.628409390422351,-84771,330081,-0.256818780844702
2022,"TEXAS",22,85653,150014,241215,"JAMIE KAYE JORDAN","TROY E NEHLS","Republican",0.621909914391725,-64361,235667,-0.273101452473193
2022,"TEXAS",23,80947,116649,208776,"JOHN LIRA","TONY GONZALES","Republican",0.558728014714335,-35702,197596,-0.18068179517804
2022,"TEXAS",24,119878,177947,297825,"JAN MCDOWELL","BETH VAN DUYNE","Republican",0.597488457987073,-58069,297825,-0.194976915974146
2022,"TEXAS",27,73611,133416,207027,"MACLOVIO PEREZ, JR","MICHAEL CLOUD","Republican",0.644437682041473,-59805,207027,-0.288875364082946
2022,"TEXAS",28,93803,71778,165581,"HENRY CUELLAR","CASSY GARCIA","Democrat",0.566508234640448,22025,165581,0.133016469280896
2022,"TEXAS",29,71837,28765,100602,"SYLVIA R GARCIA","ROBERT SCHAFRANEK","Democrat",0.714071290829208,43072,100602,0.428142581658416
2022,"TEXAS",30,134876,39209,180513,"JASMINE CROCKETT","JAMES RODGERS","Democrat",0.747181643427343,95667,174085,0.549541890455812
2022,"TEXAS",32,116005,61494,177499,"COLIN Z ALLRED","ANTONIO SWAD","Democrat",0.653552977763255,54511,177499,0.30710595552651
2022,"TEXAS",33,82081,29203,114030,"MARC A VEASEY","PATRICK DAVID GILLESPIE","Democrat",0.719819345786197,52878,111284,0.47516264692139
2022,"TEXAS",34,70896,59464,134439,"VICENTE GONZALEZ","MAYRA FLORES","Democrat",0.527346975208087,11432,130360,0.0876956121509666
2022,"TEXAS",35,129599,48969,178568,"GREG CASAR","DAN MCQUEEN","Democrat",0.725768334752027,80630,178568,0.451536669504054
2022,"TEXAS",36,64016,145599,209615,"JON HAIRE","BRIAN BABIN","Republican",0.694602008444052,-81583,209615,-0.389204016888104
2022,"TEXAS",37,219358,59923,285789,"LLOYD DOGGETT","JENNY GARCIA SHARON","Democrat",0.767552285077452,159435,279281,0.570876643953581
2022,"TEXAS",38,92302,163597,259869,"DUNCAN F KLUSSMANN","WESLEY HUNT","Republican",0.629536420273292,-71295,255899,-0.27860601252838
2022,"UTAH",1,87986,178434,266420,"RICK EDWIN JONES","BLAKE D MOORE","Republican",0.669747015989791,-90448,266420,-0.339494031979581
2022,"UTAH",2,88224,154883,259399,"NICK MITCHELL","CHRIS STEWART","Republican",0.597084028851306,-66659,243107,-0.274196135857873
2022,"UTAH",3,83687,182497,283380,"GLENN J WRIGHT","JOHN R CURTIS","Republican",0.644000988072553,-98810,266184,-0.371209388994079
2022,"UTAH",4,82181,155110,254059,"DARLENE MCDONALD","BURGESS OWENS","Republican",0.610527475901267,-72929,237291,-0.307339932825097
2022,"VERMONT",0,176494,78397,291955,"BECCA BALINT","LIAM MADDEN","Democrat",0.604524669897758,98097,254891,0.384858625843988
2022,"VIRGINIA",1,147229,191828,342742,"HERBERT C “HERB” JONES, JR","ROBERT J WITTMAN","Republican",0.559686294647286,-44599,339057,-0.131538354907877
2022,"VIRGINIA",2,143219,153328,296996,"ELAINE G LURIA","JEN A KIGGANS","Republican",0.516262845290846,-10109,296547,-0.0340890314182912
2022,"VIRGINIA",3,139659,67668,207850,"ROBERT C “BOBBY” SCOTT","TERRY T NAMKUNG","Democrat",0.671922059177291,71991,207327,0.347234079497605
2022,"VIRGINIA",4,159044,85503,244978,"A DONALD MCEACHIN","LEON BENJAMIN, SR","Democrat",0.649217480753374,73541,244547,0.300723378328092
2022,"VIRGINIA",5,129996,177191,307790,"JOSHUA M THRONEBURG","BOB GOOD","Republican",0.57568796906982,-47195,307187,-0.153636058817593
2022,"VIRGINIA",6,95410,173352,269234,"JENNIFER LYNN LEWIS","BEN CLINE","Republican",0.643871130689289,-77942,268762,-0.290003795179378
2022,"VIRGINIA",7,143357,130586,274590,"ABIGAIL DAVIS SPANBERGER","YESLI I VEGA","Democrat",0.522076550493463,12771,273943,0.0466191872031773
2022,"VIRGINIA",8,197760,66589,268936,"DONALD S BEYER, JR","KARINA A LIPSMAN","Democrat",0.735342237558378,131171,264349,0.49620388198934
2022,"VIRGINIA",9,66027,182207,248792,"TAYSHA LEE DEVAUGHAN","H MORGAN GRIFFITH","Republican",0.732366796360012,-116180,248234,-0.468026136629148
2022,"VIRGINIA",10,157405,138163,296145,"JENNIFER WEXTON","HUNG CAO","Democrat",0.531513278968073,19242,295568,0.0651017701510312
2022,"VIRGINIA",11,193190,95634,289676,"GERALD E CONNOLLY","JAMES G “JIM” MYLES","Democrat",0.666917521644872,97556,288824,0.337769714428164
2022,"WASHINGTON",1,181992,104329,286684,"SUZAN K DELBENE","VINCENT J CAVELERI","Democrat",0.634817429643789,77663,286321,0.271244512278177
2022,"WASHINGTON",2,202980,134335,337923,"RICK LARSEN","DAN MATTHEWS","Democrat",0.600669383261867,68645,337315,0.203504143011725
2022,"WASHINGTON",3,160314,157685,319759,"MARIE GLUESENKAMP PEREZ","JOE KENT","Democrat",0.501358835873267,2629,317999,0.00826732159535093
2022,"WASHINGTON",4,70710,150619,226647,"DOUG WHITE","DAN NEWHOUSE","Republican",0.6645532480024,-79909,221329,-0.361041707141857
2022,"WASHINGTON",5,127585,188648,317006,"NATASHA HILL","CATHY MCMORRIS RODGERS","Republican",0.595092837359545,-61063,316233,-0.193094964788621
2022,"WASHINGTON",6,208710,138754,347873,"DEREK KILMER","ELIZABETH KREISELMAIER","Democrat",0.599960330350444,69956,347464,0.201333087744342
2022,"WASHINGTON",7,295998,49207,346647,"PRAMILA JAYAPAL","CLIFF MOON","Democrat",0.853888826385343,246791,345205,0.714911429440477
2022,"WASHINGTON",8,179003,155976,336038,"KIM SCHRIER","MATT LARKIN","Democrat",0.532686779471369,23027,334979,0.0687416226091785
2022,"WASHINGTON",9,171746,67631,239848,"ADAM SMITH","DOUG BASLER","Democrat",0.716061839164804,104115,239377,0.434941535736516
2022,"WASHINGTON",10,152544,114777,267748,"MARILYN STRICKLAND","KEITH R SWANK","Democrat",0.569729745880455,37767,267321,0.141279585217772
2022,"WEST VIRGINIA",1,65428,151511,227196,"LACY WATSON","CAROL D MILLER","Republican",0.666873536505924,-86083,216939,-0.396807397471179
2022,"WEST VIRGINIA",2,84278,160493,244886,"BARRY LEE WENDELL","ALEXANDER X MOONEY","Republican",0.655378420979558,-76215,244771,-0.311372670782078
2022,"WISCONSIN",1,135825,162610,300867,"ANN ROE","BRYAN STEIL","Republican",0.540471371070938,-26785,298435,-0.0897515371856518
2022,"WISCONSIN",2,268740,101890,378537,"MARK POCAN","ERIK OLSEN","Democrat",0.709943809984229,166850,370630,0.450179424223619
2022,"WISCONSIN",3,152977,164743,317922,"BRAD PFAFF","DERRICK VAN ORDEN","Republican",0.51818685086279,-11766,317720,-0.0370326073272063
2022,"WISCONSIN",4,191955,57660,255012,"GWEN MOORE","TIM ROGERS","Democrat",0.752729283327843,134295,249615,0.538008533141037
2022,"WISCONSIN",5,134581,243741,378523,"MIKE VAN SOMEREN","SCOTT FITZGERALD","Republican",0.64392652494036,-109160,378322,-0.288537277768673
2022,"WISCONSIN",7,128877,209224,338268,"RICHARD DICK AUSMAN","THOMAS P TIFFANY","Republican",0.618515496588504,-80347,338101,-0.237642006382708
2022,"WYOMING",0,47250,132206,198198,"LYNNETTE GREYBULL","HARRIET HAGEMAN","Republican",0.667040030676394,-84956,179456,-0.473408523537803
